Team,Year_From,Year_To,Position_Group,Players_Year1,Players_Year2,Players_Retained,Players_Departed,Players_New,Retention_Rate_Pct,Departure_Rate_Pct,New_Player_Rate_Pct,Net_Change,Analysis_Date,Source_File,Combined_Date,Files_Combined
ATL,2011,2012,DB,8,10,4,4,6,50.0,50.0,60.0,2,2025-08-15 16:41:32,atl_roster_turnover_detailed.csv,2025-08-17 08:45:20,32
ATL,2011,2012,DL,4,5,1,3,4,25.0,75.0,80.0,1,2025-08-15 16:41:32,atl_roster_turnover_detailed.csv,2025-08-17 08:45:20,32
ATL,2011,2012,LB,6,3,3,3,0,50.0,50.0,0.0,-3,2025-08-15 16:41:32,atl_roster_turnover_detailed.csv,2025-08-17 08:45:20,32
ATL,2011,2012,OL,5,4,2,3,2,40.0,60.0,50.0,-1,2025-08-15 16:41:32,atl_roster_turnover_detailed.csv,2025-08-17 08:45:20,32
ATL,2011,2012,OTHER,14,15,10,4,5,71.43,28.57,33.33,1,2025-08-15 16:41:32,atl_roster_turnover_detailed.csv,2025-08-17 08:45:20,32
ATL,2011,2012,QB,2,2,1,1,1,50.0,50.0,50.0,0,2025-08-15 16:41:32,atl_roster_turnover_detailed.csv,2025-08-17 08:45:20,32
ATL,2011,2012,RB,6,6,5,1,1,83.33,16.67,16.67,0,2025-08-15 16:41:32,atl_roster_turnover_detailed.csv,2025-08-17 08:45:20,32
ATL,2011,2012,ST,3,2,2,1,0,66.67,33.33,0.0,-1,2025-08-15 16:41:32,atl_roster_turnover_detailed.csv,2025-08-17 08:45:20,32
ATL,2011,2012,TE,3,4,2,1,2,66.67,33.33,50.0,1,2025-08-15 16:41:32,atl_roster_turnover_detailed.csv,2025-08-17 08:45:20,32
ATL,2011,2012,WR,6,5,4,2,1,66.67,33.33,20.0,-1,2025-08-15 16:41:32,atl_roster_turnover_detailed.csv,2025-08-17 08:45:20,32
ATL,2012,2013,DB,10,8,4,6,4,40.0,60.0,50.0,-2,2025-08-15 16:41:32,atl_roster_turnover_detailed.csv,2025-08-17 08:45:20,32
ATL,2012,2013,DL,5,5,3,2,2,60.0,40.0,40.0,0,2025-08-15 16:41:32,atl_roster_turnover_detailed.csv,2025-08-17 08:45:20,32
ATL,2012,2013,LB,3,6,1,2,5,33.33,66.67,83.33,3,2025-08-15 16:41:32,atl_roster_turnover_detailed.csv,2025-08-17 08:45:20,32
ATL,2012,2013,OL,4,5,1,3,4,25.0,75.0,80.0,1,2025-08-15 16:41:32,atl_roster_turnover_detailed.csv,2025-08-17 08:45:20,32
ATL,2012,2013,OTHER,15,14,7,8,7,46.67,53.33,50.0,-1,2025-08-15 16:41:32,atl_roster_turnover_detailed.csv,2025-08-17 08:45:20,32
ATL,2012,2013,QB,2,2,1,1,1,50.0,50.0,50.0,0,2025-08-15 16:41:32,atl_roster_turnover_detailed.csv,2025-08-17 08:45:20,32
ATL,2012,2013,RB,6,7,3,3,4,50.0,50.0,57.14,1,2025-08-15 16:41:32,atl_roster_turnover_detailed.csv,2025-08-17 08:45:20,32
ATL,2012,2013,ST,2,2,2,0,0,100.0,0.0,0.0,0,2025-08-15 16:41:32,atl_roster_turnover_detailed.csv,2025-08-17 08:45:20,32
ATL,2012,2013,TE,4,3,2,2,1,50.0,50.0,33.33,-1,2025-08-15 16:41:32,atl_roster_turnover_detailed.csv,2025-08-17 08:45:20,32
ATL,2012,2013,WR,5,7,5,0,2,100.0,0.0,28.57,2,2025-08-15 16:41:32,atl_roster_turnover_detailed.csv,2025-08-17 08:45:20,32
ATL,2013,2014,DB,8,9,3,5,6,37.5,62.5,66.67,1,2025-08-15 16:41:32,atl_roster_turnover_detailed.csv,2025-08-17 08:45:20,32
ATL,2013,2014,DL,5,6,3,2,3,60.0,40.0,50.0,1,2025-08-15 16:41:32,atl_roster_turnover_detailed.csv,2025-08-17 08:45:20,32
ATL,2013,2014,LB,6,3,0,6,3,0.0,100.0,100.0,-3,2025-08-15 16:41:32,atl_roster_turnover_detailed.csv,2025-08-17 08:45:20,32
ATL,2013,2014,OL,5,6,3,2,3,60.0,40.0,50.0,1,2025-08-15 16:41:32,atl_roster_turnover_detailed.csv,2025-08-17 08:45:20,32
ATL,2013,2014,OTHER,14,14,5,9,9,35.71,64.29,64.29,0,2025-08-15 16:41:32,atl_roster_turnover_detailed.csv,2025-08-17 08:45:20,32
ATL,2013,2014,QB,2,2,1,1,1,50.0,50.0,50.0,0,2025-08-15 16:41:32,atl_roster_turnover_detailed.csv,2025-08-17 08:45:20,32
ATL,2013,2014,RB,7,6,4,3,2,57.14,42.86,33.33,-1,2025-08-15 16:41:32,atl_roster_turnover_detailed.csv,2025-08-17 08:45:20,32
ATL,2013,2014,ST,2,2,2,0,0,100.0,0.0,0.0,0,2025-08-15 16:41:32,atl_roster_turnover_detailed.csv,2025-08-17 08:45:20,32
ATL,2013,2014,TE,3,2,1,2,1,33.33,66.67,50.0,-1,2025-08-15 16:41:32,atl_roster_turnover_detailed.csv,2025-08-17 08:45:20,32
ATL,2013,2014,WR,7,8,4,3,4,57.14,42.86,50.0,1,2025-08-15 16:41:32,atl_roster_turnover_detailed.csv,2025-08-17 08:45:20,32
ATL,2014,2015,DB,9,10,5,4,5,55.56,44.44,50.0,1,2025-08-15 16:41:32,atl_roster_turnover_detailed.csv,2025-08-17 08:45:20,32
ATL,2014,2015,DL,6,6,1,5,5,16.67,83.33,83.33,0,2025-08-15 16:41:32,atl_roster_turnover_detailed.csv,2025-08-17 08:45:20,32
ATL,2014,2015,LB,3,5,2,1,3,66.67,33.33,60.0,2,2025-08-15 16:41:32,atl_roster_turnover_detailed.csv,2025-08-17 08:45:20,32
ATL,2014,2015,OL,6,6,1,5,5,16.67,83.33,83.33,0,2025-08-15 16:41:32,atl_roster_turnover_detailed.csv,2025-08-17 08:45:20,32
ATL,2014,2015,OTHER,14,13,7,7,6,50.0,50.0,46.15,-1,2025-08-15 16:41:32,atl_roster_turnover_detailed.csv,2025-08-17 08:45:20,32
ATL,2014,2015,QB,2,2,1,1,1,50.0,50.0,50.0,0,2025-08-15 16:41:32,atl_roster_turnover_detailed.csv,2025-08-17 08:45:20,32
ATL,2014,2015,RB,6,5,2,4,3,33.33,66.67,60.0,-1,2025-08-15 16:41:32,atl_roster_turnover_detailed.csv,2025-08-17 08:45:20,32
ATL,2014,2015,ST,2,3,2,0,1,100.0,0.0,33.33,1,2025-08-15 16:41:32,atl_roster_turnover_detailed.csv,2025-08-17 08:45:20,32
ATL,2014,2015,TE,2,4,1,1,3,50.0,50.0,75.0,2,2025-08-15 16:41:32,atl_roster_turnover_detailed.csv,2025-08-17 08:45:20,32
ATL,2014,2015,WR,8,7,4,4,3,50.0,50.0,42.86,-1,2025-08-15 16:41:32,atl_roster_turnover_detailed.csv,2025-08-17 08:45:20,32
ATL,2015,2016,DB,10,11,4,6,7,40.0,60.0,63.64,1,2025-08-15 16:41:32,atl_roster_turnover_detailed.csv,2025-08-17 08:45:20,32
ATL,2015,2016,DL,6,8,3,3,5,50.0,50.0,62.5,2,2025-08-15 16:41:32,atl_roster_turnover_detailed.csv,2025-08-17 08:45:20,32
ATL,2015,2016,LB,5,8,1,4,7,20.0,80.0,87.5,3,2025-08-15 16:41:32,atl_roster_turnover_detailed.csv,2025-08-17 08:45:20,32
ATL,2015,2016,OL,6,2,0,6,2,0.0,100.0,100.0,-4,2025-08-15 16:41:32,atl_roster_turnover_detailed.csv,2025-08-17 08:45:20,32
ATL,2015,2016,OTHER,13,14,9,4,5,69.23,30.77,35.71,1,2025-08-15 16:41:32,atl_roster_turnover_detailed.csv,2025-08-17 08:45:20,32
ATL,2015,2016,QB,2,2,1,1,1,50.0,50.0,50.0,0,2025-08-15 16:41:32,atl_roster_turnover_detailed.csv,2025-08-17 08:45:20,32
ATL,2015,2016,RB,5,5,4,1,1,80.0,20.0,20.0,0,2025-08-15 16:41:32,atl_roster_turnover_detailed.csv,2025-08-17 08:45:20,32
ATL,2015,2016,ST,3,3,2,1,1,66.67,33.33,33.33,0,2025-08-15 16:41:32,atl_roster_turnover_detailed.csv,2025-08-17 08:45:20,32
ATL,2015,2016,TE,4,5,2,2,3,50.0,50.0,60.0,1,2025-08-15 16:41:32,atl_roster_turnover_detailed.csv,2025-08-17 08:45:20,32
ATL,2015,2016,WR,7,7,4,3,3,57.14,42.86,42.86,0,2025-08-15 16:41:32,atl_roster_turnover_detailed.csv,2025-08-17 08:45:20,32
ATL,2016,2017,DB,11,10,9,2,1,81.82,18.18,10.0,-1,2025-08-15 16:41:32,atl_roster_turnover_detailed.csv,2025-08-17 08:45:20,32
ATL,2016,2017,DL,8,7,2,6,5,25.0,75.0,71.43,-1,2025-08-15 16:41:32,atl_roster_turnover_detailed.csv,2025-08-17 08:45:20,32
ATL,2016,2017,LB,8,7,3,5,4,37.5,62.5,57.14,-1,2025-08-15 16:41:32,atl_roster_turnover_detailed.csv,2025-08-17 08:45:20,32
ATL,2016,2017,OL,2,3,1,1,2,50.0,50.0,66.67,1,2025-08-15 16:41:32,atl_roster_turnover_detailed.csv,2025-08-17 08:45:20,32
ATL,2016,2017,OTHER,14,12,9,5,3,64.29,35.71,25.0,-2,2025-08-15 16:41:32,atl_roster_turnover_detailed.csv,2025-08-17 08:45:20,32
ATL,2016,2017,QB,2,1,1,1,0,50.0,50.0,0.0,-1,2025-08-15 16:41:32,atl_roster_turnover_detailed.csv,2025-08-17 08:45:20,32
ATL,2016,2017,RB,5,6,3,2,3,60.0,40.0,50.0,1,2025-08-15 16:41:32,atl_roster_turnover_detailed.csv,2025-08-17 08:45:20,32
ATL,2016,2017,ST,3,2,2,1,0,66.67,33.33,0.0,-1,2025-08-15 16:41:32,atl_roster_turnover_detailed.csv,2025-08-17 08:45:20,32
ATL,2016,2017,TE,5,3,2,3,1,40.0,60.0,33.33,-2,2025-08-15 16:41:32,atl_roster_turnover_detailed.csv,2025-08-17 08:45:20,32
ATL,2016,2017,WR,7,7,5,2,2,71.43,28.57,28.57,0,2025-08-15 16:41:32,atl_roster_turnover_detailed.csv,2025-08-17 08:45:20,32
ATL,2017,2018,DB,10,12,7,3,5,70.0,30.0,41.67,2,2025-08-15 16:41:32,atl_roster_turnover_detailed.csv,2025-08-17 08:45:20,32
ATL,2017,2018,DL,7,7,1,6,6,14.29,85.71,85.71,0,2025-08-15 16:41:32,atl_roster_turnover_detailed.csv,2025-08-17 08:45:20,32
ATL,2017,2018,LB,7,5,0,7,5,0.0,100.0,100.0,-2,2025-08-15 16:41:32,atl_roster_turnover_detailed.csv,2025-08-17 08:45:20,32
ATL,2017,2018,OL,3,4,2,1,2,66.67,33.33,50.0,1,2025-08-15 16:41:32,atl_roster_turnover_detailed.csv,2025-08-17 08:45:20,32
ATL,2017,2018,OTHER,12,16,8,4,8,66.67,33.33,50.0,4,2025-08-15 16:41:32,atl_roster_turnover_detailed.csv,2025-08-17 08:45:20,32
ATL,2017,2018,QB,1,2,1,0,1,100.0,0.0,50.0,1,2025-08-15 16:41:32,atl_roster_turnover_detailed.csv,2025-08-17 08:45:20,32
ATL,2017,2018,RB,6,6,3,3,3,50.0,50.0,50.0,0,2025-08-15 16:41:32,atl_roster_turnover_detailed.csv,2025-08-17 08:45:20,32
ATL,2017,2018,ST,2,4,2,0,2,100.0,0.0,50.0,2,2025-08-15 16:41:32,atl_roster_turnover_detailed.csv,2025-08-17 08:45:20,32
ATL,2017,2018,TE,3,3,2,1,1,66.67,33.33,33.33,0,2025-08-15 16:41:32,atl_roster_turnover_detailed.csv,2025-08-17 08:45:20,32
ATL,2017,2018,WR,7,7,4,3,3,57.14,42.86,42.86,0,2025-08-15 16:41:32,atl_roster_turnover_detailed.csv,2025-08-17 08:45:20,32
ATL,2018,2019,DB,12,14,7,5,7,58.33,41.67,50.0,2,2025-08-15 16:41:32,atl_roster_turnover_detailed.csv,2025-08-17 08:45:20,32
ATL,2018,2019,DL,7,6,1,6,5,14.29,85.71,83.33,-1,2025-08-15 16:41:32,atl_roster_turnover_detailed.csv,2025-08-17 08:45:20,32
ATL,2018,2019,LB,5,4,1,4,3,20.0,80.0,75.0,-1,2025-08-15 16:41:32,atl_roster_turnover_detailed.csv,2025-08-17 08:45:20,32
ATL,2018,2019,OL,4,5,2,2,3,50.0,50.0,60.0,1,2025-08-15 16:41:32,atl_roster_turnover_detailed.csv,2025-08-17 08:45:20,32
ATL,2018,2019,OTHER,16,14,6,10,8,37.5,62.5,57.14,-2,2025-08-15 16:41:32,atl_roster_turnover_detailed.csv,2025-08-17 08:45:20,32
ATL,2018,2019,QB,2,2,2,0,0,100.0,0.0,0.0,0,2025-08-15 16:41:32,atl_roster_turnover_detailed.csv,2025-08-17 08:45:20,32
ATL,2018,2019,RB,6,6,3,3,3,50.0,50.0,50.0,0,2025-08-15 16:41:32,atl_roster_turnover_detailed.csv,2025-08-17 08:45:20,32
ATL,2018,2019,ST,4,6,2,2,4,50.0,50.0,66.67,2,2025-08-15 16:41:32,atl_roster_turnover_detailed.csv,2025-08-17 08:45:20,32
ATL,2018,2019,TE,3,4,1,2,3,33.33,66.67,75.0,1,2025-08-15 16:41:32,atl_roster_turnover_detailed.csv,2025-08-17 08:45:20,32
ATL,2018,2019,WR,7,7,5,2,2,71.43,28.57,28.57,0,2025-08-15 16:41:32,atl_roster_turnover_detailed.csv,2025-08-17 08:45:20,32
ATL,2019,2020,DB,14,13,8,6,5,57.14,42.86,38.46,-1,2025-08-15 16:41:32,atl_roster_turnover_detailed.csv,2025-08-17 08:45:20,32
ATL,2019,2020,DL,6,8,3,3,5,50.0,50.0,62.5,2,2025-08-15 16:41:32,atl_roster_turnover_detailed.csv,2025-08-17 08:45:20,32
ATL,2019,2020,LB,4,4,1,3,3,25.0,75.0,75.0,0,2025-08-15 16:41:32,atl_roster_turnover_detailed.csv,2025-08-17 08:45:20,32
ATL,2019,2020,OL,5,5,3,2,2,60.0,40.0,40.0,0,2025-08-15 16:41:32,atl_roster_turnover_detailed.csv,2025-08-17 08:45:20,32
ATL,2019,2020,OTHER,14,13,7,7,6,50.0,50.0,46.15,-1,2025-08-15 16:41:32,atl_roster_turnover_detailed.csv,2025-08-17 08:45:20,32
ATL,2019,2020,QB,2,2,2,0,0,100.0,0.0,0.0,0,2025-08-15 16:41:32,atl_roster_turnover_detailed.csv,2025-08-17 08:45:20,32
ATL,2019,2020,RB,6,6,4,2,2,66.67,33.33,33.33,0,2025-08-15 16:41:32,atl_roster_turnover_detailed.csv,2025-08-17 08:45:20,32
ATL,2019,2020,ST,6,3,1,5,2,16.67,83.33,66.67,-3,2025-08-15 16:41:32,atl_roster_turnover_detailed.csv,2025-08-17 08:45:20,32
ATL,2019,2020,TE,4,3,2,2,1,50.0,50.0,33.33,-1,2025-08-15 16:41:32,atl_roster_turnover_detailed.csv,2025-08-17 08:45:20,32
ATL,2019,2020,WR,7,8,5,2,3,71.43,28.57,37.5,1,2025-08-15 16:41:32,atl_roster_turnover_detailed.csv,2025-08-17 08:45:20,32
ATL,2020,2021,DB,13,13,3,10,10,23.08,76.92,76.92,0,2025-08-15 16:41:32,atl_roster_turnover_detailed.csv,2025-08-17 08:45:20,32
ATL,2020,2021,DL,8,9,3,5,6,37.5,62.5,66.67,1,2025-08-15 16:41:32,atl_roster_turnover_detailed.csv,2025-08-17 08:45:20,32
ATL,2020,2021,LB,4,6,0,4,6,0.0,100.0,100.0,2,2025-08-15 16:41:32,atl_roster_turnover_detailed.csv,2025-08-17 08:45:20,32
ATL,2020,2021,OL,5,6,1,4,5,20.0,80.0,83.33,1,2025-08-15 16:41:32,atl_roster_turnover_detailed.csv,2025-08-17 08:45:20,32
ATL,2020,2021,OTHER,13,13,8,5,5,61.54,38.46,38.46,0,2025-08-15 16:41:32,atl_roster_turnover_detailed.csv,2025-08-17 08:45:20,32
ATL,2020,2021,QB,2,3,1,1,2,50.0,50.0,66.67,1,2025-08-15 16:41:32,atl_roster_turnover_detailed.csv,2025-08-17 08:45:20,32
ATL,2020,2021,RB,6,5,2,4,3,33.33,66.67,60.0,-1,2025-08-15 16:41:32,atl_roster_turnover_detailed.csv,2025-08-17 08:45:20,32
ATL,2020,2021,ST,3,4,1,2,3,33.33,66.67,75.0,1,2025-08-15 16:41:32,atl_roster_turnover_detailed.csv,2025-08-17 08:45:20,32
ATL,2020,2021,TE,3,3,1,2,2,33.33,66.67,66.67,0,2025-08-15 16:41:32,atl_roster_turnover_detailed.csv,2025-08-17 08:45:20,32
ATL,2020,2021,WR,8,8,4,4,4,50.0,50.0,50.0,0,2025-08-15 16:41:32,atl_roster_turnover_detailed.csv,2025-08-17 08:45:20,32
ATL,2021,2022,DB,13,9,3,10,6,23.08,76.92,66.67,-4,2025-08-15 16:41:32,atl_roster_turnover_detailed.csv,2025-08-17 08:45:20,32
ATL,2021,2022,DL,9,4,0,9,4,0.0,100.0,100.0,-5,2025-08-15 16:41:32,atl_roster_turnover_detailed.csv,2025-08-17 08:45:20,32
ATL,2021,2022,LB,6,7,1,5,6,16.67,83.33,85.71,1,2025-08-15 16:41:32,atl_roster_turnover_detailed.csv,2025-08-17 08:45:20,32
ATL,2021,2022,OL,6,6,3,3,3,50.0,50.0,50.0,0,2025-08-15 16:41:32,atl_roster_turnover_detailed.csv,2025-08-17 08:45:20,32
ATL,2021,2022,OTHER,13,15,7,6,8,53.85,46.15,53.33,2,2025-08-15 16:41:32,atl_roster_turnover_detailed.csv,2025-08-17 08:45:20,32
ATL,2021,2022,QB,3,4,1,2,3,33.33,66.67,75.0,1,2025-08-15 16:41:32,atl_roster_turnover_detailed.csv,2025-08-17 08:45:20,32
ATL,2021,2022,RB,5,6,1,4,5,20.0,80.0,83.33,1,2025-08-15 16:41:32,atl_roster_turnover_detailed.csv,2025-08-17 08:45:20,32
ATL,2021,2022,ST,4,3,1,3,2,25.0,75.0,66.67,-1,2025-08-15 16:41:32,atl_roster_turnover_detailed.csv,2025-08-17 08:45:20,32
ATL,2021,2022,TE,3,3,1,2,2,33.33,66.67,66.67,0,2025-08-15 16:41:32,atl_roster_turnover_detailed.csv,2025-08-17 08:45:20,32
ATL,2021,2022,WR,8,9,2,6,7,25.0,75.0,77.78,1,2025-08-15 16:41:32,atl_roster_turnover_detailed.csv,2025-08-17 08:45:20,32
ATL,2022,2023,DB,9,10,3,6,7,33.33,66.67,70.0,1,2025-08-15 16:41:32,atl_roster_turnover_detailed.csv,2025-08-17 08:45:20,32
ATL,2022,2023,DL,4,12,1,3,11,25.0,75.0,91.67,8,2025-08-15 16:41:32,atl_roster_turnover_detailed.csv,2025-08-17 08:45:20,32
ATL,2022,2023,LB,7,10,4,3,6,57.14,42.86,60.0,3,2025-08-15 16:41:32,atl_roster_turnover_detailed.csv,2025-08-17 08:45:20,32
ATL,2022,2023,OL,6,12,2,4,10,33.33,66.67,83.33,6,2025-08-15 16:41:32,atl_roster_turnover_detailed.csv,2025-08-17 08:45:20,32
ATL,2022,2023,OTHER,15,1,0,15,1,0.0,100.0,100.0,-14,2025-08-15 16:41:32,atl_roster_turnover_detailed.csv,2025-08-17 08:45:20,32
ATL,2022,2023,QB,4,3,2,2,1,50.0,50.0,33.33,-1,2025-08-15 16:41:32,atl_roster_turnover_detailed.csv,2025-08-17 08:45:20,32
ATL,2022,2023,RB,6,5,2,4,3,33.33,66.67,60.0,-1,2025-08-15 16:41:32,atl_roster_turnover_detailed.csv,2025-08-17 08:45:20,32
ATL,2022,2023,ST,3,3,3,0,0,100.0,0.0,0.0,0,2025-08-15 16:41:32,atl_roster_turnover_detailed.csv,2025-08-17 08:45:20,32
ATL,2022,2023,TE,3,6,3,0,3,100.0,0.0,50.0,3,2025-08-15 16:41:32,atl_roster_turnover_detailed.csv,2025-08-17 08:45:20,32
ATL,2022,2023,WR,9,8,4,5,4,44.44,55.56,50.0,-1,2025-08-15 16:41:32,atl_roster_turnover_detailed.csv,2025-08-17 08:45:20,32
ATL,2023,2024,DB,10,11,5,5,6,50.0,50.0,54.55,1,2025-08-15 16:41:32,atl_roster_turnover_detailed.csv,2025-08-17 08:45:20,32
ATL,2023,2024,DL,12,8,3,9,5,25.0,75.0,62.5,-4,2025-08-15 16:41:32,atl_roster_turnover_detailed.csv,2025-08-17 08:45:20,32
ATL,2023,2024,LB,10,8,4,6,4,40.0,60.0,50.0,-2,2025-08-15 16:41:32,atl_roster_turnover_detailed.csv,2025-08-17 08:45:20,32
ATL,2023,2024,OL,12,7,5,7,2,41.67,58.33,28.57,-5,2025-08-15 16:41:32,atl_roster_turnover_detailed.csv,2025-08-17 08:45:20,32
ATL,2023,2024,OTHER,1,11,0,1,11,0.0,100.0,100.0,10,2025-08-15 16:41:32,atl_roster_turnover_detailed.csv,2025-08-17 08:45:20,32
ATL,2023,2024,QB,3,2,0,3,2,0.0,100.0,100.0,-1,2025-08-15 16:41:32,atl_roster_turnover_detailed.csv,2025-08-17 08:45:20,32
ATL,2023,2024,RB,5,5,2,3,3,40.0,60.0,60.0,0,2025-08-15 16:41:32,atl_roster_turnover_detailed.csv,2025-08-17 08:45:20,32
ATL,2023,2024,ST,3,4,3,0,1,100.0,0.0,25.0,1,2025-08-15 16:41:32,atl_roster_turnover_detailed.csv,2025-08-17 08:45:20,32
ATL,2023,2024,TE,6,3,1,5,2,16.67,83.33,66.67,-3,2025-08-15 16:41:32,atl_roster_turnover_detailed.csv,2025-08-17 08:45:20,32
ATL,2023,2024,WR,8,6,3,5,3,37.5,62.5,50.0,-2,2025-08-15 16:41:32,atl_roster_turnover_detailed.csv,2025-08-17 08:45:20,32
BUF,2011,2012,DB,5,10,4,1,6,80.0,20.0,60.0,5,2025-08-15 16:41:29,buf_roster_turnover_detailed.csv,2025-08-17 08:45:20,32
BUF,2011,2012,DL,7,5,0,7,5,0.0,100.0,100.0,-2,2025-08-15 16:41:29,buf_roster_turnover_detailed.csv,2025-08-17 08:45:20,32
BUF,2011,2012,LB,7,7,4,3,3,57.14,42.86,42.86,0,2025-08-15 16:41:29,buf_roster_turnover_detailed.csv,2025-08-17 08:45:20,32
BUF,2011,2012,OL,3,7,3,0,4,100.0,0.0,57.14,4,2025-08-15 16:41:29,buf_roster_turnover_detailed.csv,2025-08-17 08:45:20,32
BUF,2011,2012,OTHER,17,13,6,11,7,35.29,64.71,53.85,-4,2025-08-15 16:41:29,buf_roster_turnover_detailed.csv,2025-08-17 08:45:20,32
BUF,2011,2012,QB,2,2,2,0,0,100.0,0.0,0.0,0,2025-08-15 16:41:29,buf_roster_turnover_detailed.csv,2025-08-17 08:45:20,32
BUF,2011,2012,RB,5,5,5,0,0,100.0,0.0,0.0,0,2025-08-15 16:41:29,buf_roster_turnover_detailed.csv,2025-08-17 08:45:20,32
BUF,2011,2012,ST,5,5,3,2,2,60.0,40.0,40.0,0,2025-08-15 16:41:29,buf_roster_turnover_detailed.csv,2025-08-17 08:45:20,32
BUF,2011,2012,TE,6,3,1,5,2,16.67,83.33,66.67,-3,2025-08-15 16:41:29,buf_roster_turnover_detailed.csv,2025-08-17 08:45:20,32
BUF,2011,2012,WR,8,7,4,4,3,50.0,50.0,42.86,-1,2025-08-15 16:41:29,buf_roster_turnover_detailed.csv,2025-08-17 08:45:20,32
BUF,2012,2013,DB,10,10,3,7,7,30.0,70.0,70.0,0,2025-08-15 16:41:29,buf_roster_turnover_detailed.csv,2025-08-17 08:45:20,32
BUF,2012,2013,DL,5,7,2,3,5,40.0,60.0,71.43,2,2025-08-15 16:41:29,buf_roster_turnover_detailed.csv,2025-08-17 08:45:20,32
BUF,2012,2013,LB,7,3,0,7,3,0.0,100.0,100.0,-4,2025-08-15 16:41:29,buf_roster_turnover_detailed.csv,2025-08-17 08:45:20,32
BUF,2012,2013,OL,7,5,3,4,2,42.86,57.14,40.0,-2,2025-08-15 16:41:29,buf_roster_turnover_detailed.csv,2025-08-17 08:45:20,32
BUF,2012,2013,OTHER,13,14,7,6,7,53.85,46.15,50.0,1,2025-08-15 16:41:29,buf_roster_turnover_detailed.csv,2025-08-17 08:45:20,32
BUF,2012,2013,QB,2,3,0,2,3,0.0,100.0,100.0,1,2025-08-15 16:41:29,buf_roster_turnover_detailed.csv,2025-08-17 08:45:20,32
BUF,2012,2013,RB,5,5,3,2,2,60.0,40.0,40.0,0,2025-08-15 16:41:29,buf_roster_turnover_detailed.csv,2025-08-17 08:45:20,32
BUF,2012,2013,ST,5,4,3,2,1,60.0,40.0,25.0,-1,2025-08-15 16:41:29,buf_roster_turnover_detailed.csv,2025-08-17 08:45:20,32
BUF,2012,2013,TE,3,5,1,2,4,33.33,66.67,80.0,2,2025-08-15 16:41:29,buf_roster_turnover_detailed.csv,2025-08-17 08:45:20,32
BUF,2012,2013,WR,7,8,3,4,5,42.86,57.14,62.5,1,2025-08-15 16:41:29,buf_roster_turnover_detailed.csv,2025-08-17 08:45:20,32
BUF,2013,2014,DB,10,8,5,5,3,50.0,50.0,37.5,-2,2025-08-15 16:41:29,buf_roster_turnover_detailed.csv,2025-08-17 08:45:20,32
BUF,2013,2014,DL,7,4,3,4,1,42.86,57.14,25.0,-3,2025-08-15 16:41:29,buf_roster_turnover_detailed.csv,2025-08-17 08:45:20,32
BUF,2013,2014,LB,3,5,0,3,5,0.0,100.0,100.0,2,2025-08-15 16:41:29,buf_roster_turnover_detailed.csv,2025-08-17 08:45:20,32
BUF,2013,2014,OL,5,5,1,4,4,20.0,80.0,80.0,0,2025-08-15 16:41:29,buf_roster_turnover_detailed.csv,2025-08-17 08:45:20,32
BUF,2013,2014,OTHER,14,13,8,6,5,57.14,42.86,38.46,-1,2025-08-15 16:41:29,buf_roster_turnover_detailed.csv,2025-08-17 08:45:20,32
BUF,2013,2014,QB,3,2,1,2,1,33.33,66.67,50.0,-1,2025-08-15 16:41:29,buf_roster_turnover_detailed.csv,2025-08-17 08:45:20,32
BUF,2013,2014,RB,5,6,3,2,3,60.0,40.0,50.0,1,2025-08-15 16:41:29,buf_roster_turnover_detailed.csv,2025-08-17 08:45:20,32
BUF,2013,2014,ST,4,4,2,2,2,50.0,50.0,50.0,0,2025-08-15 16:41:29,buf_roster_turnover_detailed.csv,2025-08-17 08:45:20,32
BUF,2013,2014,TE,5,4,3,2,1,60.0,40.0,25.0,-1,2025-08-15 16:41:29,buf_roster_turnover_detailed.csv,2025-08-17 08:45:20,32
BUF,2013,2014,WR,8,7,4,4,3,50.0,50.0,42.86,-1,2025-08-15 16:41:29,buf_roster_turnover_detailed.csv,2025-08-17 08:45:20,32
BUF,2014,2015,DB,8,9,5,3,4,62.5,37.5,44.44,1,2025-08-15 16:41:29,buf_roster_turnover_detailed.csv,2025-08-17 08:45:20,32
BUF,2014,2015,DL,4,5,1,3,4,25.0,75.0,80.0,1,2025-08-15 16:41:29,buf_roster_turnover_detailed.csv,2025-08-17 08:45:20,32
BUF,2014,2015,LB,5,5,1,4,4,20.0,80.0,80.0,0,2025-08-15 16:41:29,buf_roster_turnover_detailed.csv,2025-08-17 08:45:20,32
BUF,2014,2015,OL,5,5,2,3,3,40.0,60.0,60.0,0,2025-08-15 16:41:29,buf_roster_turnover_detailed.csv,2025-08-17 08:45:20,32
BUF,2014,2015,OTHER,13,15,9,4,6,69.23,30.77,40.0,2,2025-08-15 16:41:29,buf_roster_turnover_detailed.csv,2025-08-17 08:45:20,32
BUF,2014,2015,QB,2,3,1,1,2,50.0,50.0,66.67,1,2025-08-15 16:41:29,buf_roster_turnover_detailed.csv,2025-08-17 08:45:20,32
BUF,2014,2015,RB,6,8,2,4,6,33.33,66.67,75.0,2,2025-08-15 16:41:29,buf_roster_turnover_detailed.csv,2025-08-17 08:45:20,32
BUF,2014,2015,ST,4,5,4,0,1,100.0,0.0,20.0,1,2025-08-15 16:41:29,buf_roster_turnover_detailed.csv,2025-08-17 08:45:20,32
BUF,2014,2015,TE,4,5,2,2,3,50.0,50.0,60.0,1,2025-08-15 16:41:29,buf_roster_turnover_detailed.csv,2025-08-17 08:45:20,32
BUF,2014,2015,WR,7,11,5,2,6,71.43,28.57,54.55,4,2025-08-15 16:41:29,buf_roster_turnover_detailed.csv,2025-08-17 08:45:20,32
BUF,2015,2016,DB,9,13,5,4,8,55.56,44.44,61.54,4,2025-08-15 16:41:29,buf_roster_turnover_detailed.csv,2025-08-17 08:45:20,32
BUF,2015,2016,DL,5,7,1,4,6,20.0,80.0,85.71,2,2025-08-15 16:41:29,buf_roster_turnover_detailed.csv,2025-08-17 08:45:20,32
BUF,2015,2016,LB,5,3,0,5,3,0.0,100.0,100.0,-2,2025-08-15 16:41:29,buf_roster_turnover_detailed.csv,2025-08-17 08:45:20,32
BUF,2015,2016,OL,5,6,3,2,3,60.0,40.0,50.0,1,2025-08-15 16:41:29,buf_roster_turnover_detailed.csv,2025-08-17 08:45:20,32
BUF,2015,2016,OTHER,15,13,8,7,5,53.33,46.67,38.46,-2,2025-08-15 16:41:29,buf_roster_turnover_detailed.csv,2025-08-17 08:45:20,32
BUF,2015,2016,QB,3,3,2,1,1,66.67,33.33,33.33,0,2025-08-15 16:41:29,buf_roster_turnover_detailed.csv,2025-08-17 08:45:20,32
BUF,2015,2016,RB,8,7,3,5,4,37.5,62.5,57.14,-1,2025-08-15 16:41:29,buf_roster_turnover_detailed.csv,2025-08-17 08:45:20,32
BUF,2015,2016,ST,5,4,4,1,0,80.0,20.0,0.0,-1,2025-08-15 16:41:29,buf_roster_turnover_detailed.csv,2025-08-17 08:45:20,32
BUF,2015,2016,TE,5,3,1,4,2,20.0,80.0,66.67,-2,2025-08-15 16:41:29,buf_roster_turnover_detailed.csv,2025-08-17 08:45:20,32
BUF,2015,2016,WR,11,9,7,4,2,63.64,36.36,22.22,-2,2025-08-15 16:41:29,buf_roster_turnover_detailed.csv,2025-08-17 08:45:20,32
BUF,2016,2017,DB,13,9,2,11,7,15.38,84.62,77.78,-4,2025-08-15 16:41:29,buf_roster_turnover_detailed.csv,2025-08-17 08:45:20,32
BUF,2016,2017,DL,7,6,3,4,3,42.86,57.14,50.0,-1,2025-08-15 16:41:29,buf_roster_turnover_detailed.csv,2025-08-17 08:45:20,32
BUF,2016,2017,LB,3,5,0,3,5,0.0,100.0,100.0,2,2025-08-15 16:41:29,buf_roster_turnover_detailed.csv,2025-08-17 08:45:20,32
BUF,2016,2017,OL,6,5,3,3,2,50.0,50.0,40.0,-1,2025-08-15 16:41:29,buf_roster_turnover_detailed.csv,2025-08-17 08:45:20,32
BUF,2016,2017,OTHER,13,16,7,6,9,53.85,46.15,56.25,3,2025-08-15 16:41:29,buf_roster_turnover_detailed.csv,2025-08-17 08:45:20,32
BUF,2016,2017,QB,3,2,1,2,1,33.33,66.67,50.0,-1,2025-08-15 16:41:29,buf_roster_turnover_detailed.csv,2025-08-17 08:45:20,32
BUF,2016,2017,RB,7,7,1,6,6,14.29,85.71,85.71,0,2025-08-15 16:41:29,buf_roster_turnover_detailed.csv,2025-08-17 08:45:20,32
BUF,2016,2017,ST,4,3,1,3,2,25.0,75.0,66.67,-1,2025-08-15 16:41:29,buf_roster_turnover_detailed.csv,2025-08-17 08:45:20,32
BUF,2016,2017,TE,3,4,1,2,3,33.33,66.67,75.0,1,2025-08-15 16:41:29,buf_roster_turnover_detailed.csv,2025-08-17 08:45:20,32
BUF,2016,2017,WR,9,8,1,8,7,11.11,88.89,87.5,-1,2025-08-15 16:41:29,buf_roster_turnover_detailed.csv,2025-08-17 08:45:20,32
BUF,2017,2018,DB,9,11,3,6,8,33.33,66.67,72.73,2,2025-08-15 16:41:29,buf_roster_turnover_detailed.csv,2025-08-17 08:45:20,32
BUF,2017,2018,DL,6,7,0,6,7,0.0,100.0,100.0,1,2025-08-15 16:41:29,buf_roster_turnover_detailed.csv,2025-08-17 08:45:20,32
BUF,2017,2018,LB,5,5,1,4,4,20.0,80.0,80.0,0,2025-08-15 16:41:29,buf_roster_turnover_detailed.csv,2025-08-17 08:45:20,32
BUF,2017,2018,OL,5,5,2,3,3,40.0,60.0,60.0,0,2025-08-15 16:41:29,buf_roster_turnover_detailed.csv,2025-08-17 08:45:20,32
BUF,2017,2018,OTHER,16,15,9,7,6,56.25,43.75,40.0,-1,2025-08-15 16:41:29,buf_roster_turnover_detailed.csv,2025-08-17 08:45:20,32
BUF,2017,2018,QB,2,4,1,1,3,50.0,50.0,75.0,2,2025-08-15 16:41:29,buf_roster_turnover_detailed.csv,2025-08-17 08:45:20,32
BUF,2017,2018,RB,7,6,4,3,2,57.14,42.86,33.33,-1,2025-08-15 16:41:29,buf_roster_turnover_detailed.csv,2025-08-17 08:45:20,32
BUF,2017,2018,ST,3,5,3,0,2,100.0,0.0,40.0,2,2025-08-15 16:41:29,buf_roster_turnover_detailed.csv,2025-08-17 08:45:20,32
BUF,2017,2018,TE,4,5,3,1,2,75.0,25.0,40.0,1,2025-08-15 16:41:29,buf_roster_turnover_detailed.csv,2025-08-17 08:45:20,32
BUF,2017,2018,WR,8,12,4,4,8,50.0,50.0,66.67,4,2025-08-15 16:41:29,buf_roster_turnover_detailed.csv,2025-08-17 08:45:20,32
BUF,2018,2019,DB,11,9,5,6,4,45.45,54.55,44.44,-2,2025-08-15 16:41:29,buf_roster_turnover_detailed.csv,2025-08-17 08:45:20,32
BUF,2018,2019,DL,7,6,1,6,5,14.29,85.71,83.33,-1,2025-08-15 16:41:29,buf_roster_turnover_detailed.csv,2025-08-17 08:45:20,32
BUF,2018,2019,LB,5,3,3,2,0,60.0,40.0,0.0,-2,2025-08-15 16:41:29,buf_roster_turnover_detailed.csv,2025-08-17 08:45:20,32
BUF,2018,2019,OL,5,5,1,4,4,20.0,80.0,80.0,0,2025-08-15 16:41:29,buf_roster_turnover_detailed.csv,2025-08-17 08:45:20,32
BUF,2018,2019,OTHER,15,13,8,7,5,53.33,46.67,38.46,-2,2025-08-15 16:41:29,buf_roster_turnover_detailed.csv,2025-08-17 08:45:20,32
BUF,2018,2019,QB,4,2,2,2,0,50.0,50.0,0.0,-2,2025-08-15 16:41:29,buf_roster_turnover_detailed.csv,2025-08-17 08:45:20,32
BUF,2018,2019,RB,6,5,1,5,4,16.67,83.33,80.0,-1,2025-08-15 16:41:29,buf_roster_turnover_detailed.csv,2025-08-17 08:45:20,32
BUF,2018,2019,ST,5,3,3,2,0,60.0,40.0,0.0,-2,2025-08-15 16:41:29,buf_roster_turnover_detailed.csv,2025-08-17 08:45:20,32
BUF,2018,2019,TE,5,3,0,5,3,0.0,100.0,100.0,-2,2025-08-15 16:41:29,buf_roster_turnover_detailed.csv,2025-08-17 08:45:20,32
BUF,2018,2019,WR,12,8,3,9,5,25.0,75.0,62.5,-4,2025-08-15 16:41:29,buf_roster_turnover_detailed.csv,2025-08-17 08:45:20,32
BUF,2019,2020,DB,9,11,6,3,5,66.67,33.33,45.45,2,2025-08-15 16:41:29,buf_roster_turnover_detailed.csv,2025-08-17 08:45:20,32
BUF,2019,2020,DL,6,8,2,4,6,33.33,66.67,75.0,2,2025-08-15 16:41:29,buf_roster_turnover_detailed.csv,2025-08-17 08:45:20,32
BUF,2019,2020,LB,3,7,1,2,6,33.33,66.67,85.71,4,2025-08-15 16:41:29,buf_roster_turnover_detailed.csv,2025-08-17 08:45:20,32
BUF,2019,2020,OL,5,5,3,2,2,60.0,40.0,40.0,0,2025-08-15 16:41:29,buf_roster_turnover_detailed.csv,2025-08-17 08:45:20,32
BUF,2019,2020,OTHER,13,15,9,4,6,69.23,30.77,40.0,2,2025-08-15 16:41:29,buf_roster_turnover_detailed.csv,2025-08-17 08:45:20,32
BUF,2019,2020,QB,2,2,2,0,0,100.0,0.0,0.0,0,2025-08-15 16:41:29,buf_roster_turnover_detailed.csv,2025-08-17 08:45:20,32
BUF,2019,2020,RB,5,6,2,3,4,40.0,60.0,66.67,1,2025-08-15 16:41:29,buf_roster_turnover_detailed.csv,2025-08-17 08:45:20,32
BUF,2019,2020,ST,3,3,2,1,1,66.67,33.33,33.33,0,2025-08-15 16:41:29,buf_roster_turnover_detailed.csv,2025-08-17 08:45:20,32
BUF,2019,2020,TE,3,4,2,1,2,66.67,33.33,50.0,1,2025-08-15 16:41:29,buf_roster_turnover_detailed.csv,2025-08-17 08:45:20,32
BUF,2019,2020,WR,8,8,5,3,3,62.5,37.5,37.5,0,2025-08-15 16:41:29,buf_roster_turnover_detailed.csv,2025-08-17 08:45:20,32
BUF,2020,2021,DB,11,6,5,6,1,45.45,54.55,16.67,-5,2025-08-15 16:41:29,buf_roster_turnover_detailed.csv,2025-08-17 08:45:20,32
BUF,2020,2021,DL,8,8,3,5,5,37.5,62.5,62.5,0,2025-08-15 16:41:29,buf_roster_turnover_detailed.csv,2025-08-17 08:45:20,32
BUF,2020,2021,LB,7,6,4,3,2,57.14,42.86,33.33,-1,2025-08-15 16:41:29,buf_roster_turnover_detailed.csv,2025-08-17 08:45:20,32
BUF,2020,2021,OL,5,5,2,3,3,40.0,60.0,60.0,0,2025-08-15 16:41:29,buf_roster_turnover_detailed.csv,2025-08-17 08:45:20,32
BUF,2020,2021,OTHER,15,16,10,5,6,66.67,33.33,37.5,1,2025-08-15 16:41:29,buf_roster_turnover_detailed.csv,2025-08-17 08:45:20,32
BUF,2020,2021,QB,2,3,1,1,2,50.0,50.0,66.67,1,2025-08-15 16:41:29,buf_roster_turnover_detailed.csv,2025-08-17 08:45:20,32
BUF,2020,2021,RB,6,5,4,2,1,66.67,33.33,20.0,-1,2025-08-15 16:41:29,buf_roster_turnover_detailed.csv,2025-08-17 08:45:20,32
BUF,2020,2021,ST,3,3,2,1,1,66.67,33.33,33.33,0,2025-08-15 16:41:29,buf_roster_turnover_detailed.csv,2025-08-17 08:45:20,32
BUF,2020,2021,TE,4,3,1,3,2,25.0,75.0,66.67,-1,2025-08-15 16:41:29,buf_roster_turnover_detailed.csv,2025-08-17 08:45:20,32
BUF,2020,2021,WR,8,8,5,3,3,62.5,37.5,37.5,0,2025-08-15 16:41:29,buf_roster_turnover_detailed.csv,2025-08-17 08:45:20,32
BUF,2021,2022,DB,6,9,6,0,3,100.0,0.0,33.33,3,2025-08-15 16:41:29,buf_roster_turnover_detailed.csv,2025-08-17 08:45:20,32
BUF,2021,2022,DL,8,10,4,4,6,50.0,50.0,60.0,2,2025-08-15 16:41:29,buf_roster_turnover_detailed.csv,2025-08-17 08:45:20,32
BUF,2021,2022,LB,6,7,5,1,2,83.33,16.67,28.57,1,2025-08-15 16:41:29,buf_roster_turnover_detailed.csv,2025-08-17 08:45:20,32
BUF,2021,2022,OL,5,8,3,2,5,60.0,40.0,62.5,3,2025-08-15 16:41:29,buf_roster_turnover_detailed.csv,2025-08-17 08:45:20,32
BUF,2021,2022,OTHER,16,15,8,8,7,50.0,50.0,46.67,-1,2025-08-15 16:41:29,buf_roster_turnover_detailed.csv,2025-08-17 08:45:20,32
BUF,2021,2022,QB,3,2,1,2,1,33.33,66.67,50.0,-1,2025-08-15 16:41:29,buf_roster_turnover_detailed.csv,2025-08-17 08:45:20,32
BUF,2021,2022,RB,5,7,4,1,3,80.0,20.0,42.86,2,2025-08-15 16:41:29,buf_roster_turnover_detailed.csv,2025-08-17 08:45:20,32
BUF,2021,2022,ST,3,3,2,1,1,66.67,33.33,33.33,0,2025-08-15 16:41:29,buf_roster_turnover_detailed.csv,2025-08-17 08:45:20,32
BUF,2021,2022,TE,3,3,2,1,1,66.67,33.33,33.33,0,2025-08-15 16:41:29,buf_roster_turnover_detailed.csv,2025-08-17 08:45:20,32
BUF,2021,2022,WR,8,10,6,2,4,75.0,25.0,40.0,2,2025-08-15 16:41:29,buf_roster_turnover_detailed.csv,2025-08-17 08:45:20,32
BUF,2022,2023,DB,9,14,6,3,8,66.67,33.33,57.14,5,2025-08-15 16:41:29,buf_roster_turnover_detailed.csv,2025-08-17 08:45:20,32
BUF,2022,2023,DL,10,11,4,6,7,40.0,60.0,63.64,1,2025-08-15 16:41:29,buf_roster_turnover_detailed.csv,2025-08-17 08:45:20,32
BUF,2022,2023,LB,7,8,5,2,3,71.43,28.57,37.5,1,2025-08-15 16:41:29,buf_roster_turnover_detailed.csv,2025-08-17 08:45:20,32
BUF,2022,2023,OL,8,8,1,7,7,12.5,87.5,87.5,0,2025-08-15 16:41:29,buf_roster_turnover_detailed.csv,2025-08-17 08:45:20,32
BUF,2022,2023,OTHER,15,1,0,15,1,0.0,100.0,100.0,-14,2025-08-15 16:41:29,buf_roster_turnover_detailed.csv,2025-08-17 08:45:20,32
BUF,2022,2023,QB,2,2,1,1,1,50.0,50.0,50.0,0,2025-08-15 16:41:29,buf_roster_turnover_detailed.csv,2025-08-17 08:45:20,32
BUF,2022,2023,RB,7,6,2,5,4,28.57,71.43,66.67,-1,2025-08-15 16:41:29,buf_roster_turnover_detailed.csv,2025-08-17 08:45:20,32
BUF,2022,2023,ST,3,3,3,0,0,100.0,0.0,0.0,0,2025-08-15 16:41:29,buf_roster_turnover_detailed.csv,2025-08-17 08:45:20,32
BUF,2022,2023,TE,3,3,2,1,1,66.67,33.33,33.33,0,2025-08-15 16:41:29,buf_roster_turnover_detailed.csv,2025-08-17 08:45:20,32
BUF,2022,2023,WR,10,6,3,7,3,30.0,70.0,50.0,-4,2025-08-15 16:41:29,buf_roster_turnover_detailed.csv,2025-08-17 08:45:20,32
BUF,2023,2024,DB,14,11,6,8,5,42.86,57.14,45.45,-3,2025-08-15 16:41:29,buf_roster_turnover_detailed.csv,2025-08-17 08:45:20,32
BUF,2023,2024,DL,11,12,2,9,10,18.18,81.82,83.33,1,2025-08-15 16:41:29,buf_roster_turnover_detailed.csv,2025-08-17 08:45:20,32
BUF,2023,2024,LB,8,7,4,4,3,50.0,50.0,42.86,-1,2025-08-15 16:41:29,buf_roster_turnover_detailed.csv,2025-08-17 08:45:20,32
BUF,2023,2024,OL,8,7,2,6,5,25.0,75.0,71.43,-1,2025-08-15 16:41:29,buf_roster_turnover_detailed.csv,2025-08-17 08:45:20,32
BUF,2023,2024,OTHER,1,11,0,1,11,0.0,100.0,100.0,10,2025-08-15 16:41:29,buf_roster_turnover_detailed.csv,2025-08-17 08:45:20,32
BUF,2023,2024,QB,2,3,1,1,2,50.0,50.0,66.67,1,2025-08-15 16:41:29,buf_roster_turnover_detailed.csv,2025-08-17 08:45:20,32
BUF,2023,2024,RB,6,4,3,3,1,50.0,50.0,25.0,-2,2025-08-15 16:41:29,buf_roster_turnover_detailed.csv,2025-08-17 08:45:20,32
BUF,2023,2024,ST,3,3,3,0,0,100.0,0.0,0.0,0,2025-08-15 16:41:29,buf_roster_turnover_detailed.csv,2025-08-17 08:45:20,32
BUF,2023,2024,TE,3,4,3,0,1,100.0,0.0,25.0,1,2025-08-15 16:41:29,buf_roster_turnover_detailed.csv,2025-08-17 08:45:20,32
BUF,2023,2024,WR,6,8,1,5,7,16.67,83.33,87.5,2,2025-08-15 16:41:29,buf_roster_turnover_detailed.csv,2025-08-17 08:45:20,32
CAR,2011,2012,DB,10,10,3,7,7,30.0,70.0,70.0,0,2025-08-15 16:41:27,car_roster_turnover_detailed.csv,2025-08-17 08:45:20,32
CAR,2011,2012,DL,7,5,2,5,3,28.57,71.43,60.0,-2,2025-08-15 16:41:27,car_roster_turnover_detailed.csv,2025-08-17 08:45:20,32
CAR,2011,2012,LB,11,9,5,6,4,45.45,54.55,44.44,-2,2025-08-15 16:41:27,car_roster_turnover_detailed.csv,2025-08-17 08:45:20,32
CAR,2011,2012,OL,6,7,1,5,6,16.67,83.33,85.71,1,2025-08-15 16:41:27,car_roster_turnover_detailed.csv,2025-08-17 08:45:20,32
CAR,2011,2012,OTHER,12,14,6,6,8,50.0,50.0,57.14,2,2025-08-15 16:41:27,car_roster_turnover_detailed.csv,2025-08-17 08:45:20,32
CAR,2011,2012,QB,3,3,3,0,0,100.0,0.0,0.0,0,2025-08-15 16:41:27,car_roster_turnover_detailed.csv,2025-08-17 08:45:20,32
CAR,2011,2012,RB,5,4,2,3,2,40.0,60.0,50.0,-1,2025-08-15 16:41:27,car_roster_turnover_detailed.csv,2025-08-17 08:45:20,32
CAR,2011,2012,ST,3,4,1,2,3,33.33,66.67,75.0,1,2025-08-15 16:41:27,car_roster_turnover_detailed.csv,2025-08-17 08:45:20,32
CAR,2011,2012,TE,4,4,3,1,1,75.0,25.0,25.0,0,2025-08-15 16:41:27,car_roster_turnover_detailed.csv,2025-08-17 08:45:20,32
CAR,2011,2012,WR,6,6,3,3,3,50.0,50.0,50.0,0,2025-08-15 16:41:27,car_roster_turnover_detailed.csv,2025-08-17 08:45:20,32
CAR,2012,2013,DB,10,9,3,7,6,30.0,70.0,66.67,-1,2025-08-15 16:41:27,car_roster_turnover_detailed.csv,2025-08-17 08:45:20,32
CAR,2012,2013,DL,5,6,2,3,4,40.0,60.0,66.67,1,2025-08-15 16:41:27,car_roster_turnover_detailed.csv,2025-08-17 08:45:20,32
CAR,2012,2013,LB,9,6,4,5,2,44.44,55.56,33.33,-3,2025-08-15 16:41:27,car_roster_turnover_detailed.csv,2025-08-17 08:45:20,32
CAR,2012,2013,OL,7,7,2,5,5,28.57,71.43,71.43,0,2025-08-15 16:41:27,car_roster_turnover_detailed.csv,2025-08-17 08:45:20,32
CAR,2012,2013,OTHER,14,14,6,8,8,42.86,57.14,57.14,0,2025-08-15 16:41:27,car_roster_turnover_detailed.csv,2025-08-17 08:45:20,32
CAR,2012,2013,QB,3,3,3,0,0,100.0,0.0,0.0,0,2025-08-15 16:41:27,car_roster_turnover_detailed.csv,2025-08-17 08:45:20,32
CAR,2012,2013,RB,4,5,4,0,1,100.0,0.0,20.0,1,2025-08-15 16:41:27,car_roster_turnover_detailed.csv,2025-08-17 08:45:20,32
CAR,2012,2013,ST,4,3,3,1,0,75.0,25.0,0.0,-1,2025-08-15 16:41:27,car_roster_turnover_detailed.csv,2025-08-17 08:45:20,32
CAR,2012,2013,TE,4,4,3,1,1,75.0,25.0,25.0,0,2025-08-15 16:41:27,car_roster_turnover_detailed.csv,2025-08-17 08:45:20,32
CAR,2012,2013,WR,6,5,2,4,3,33.33,66.67,60.0,-1,2025-08-15 16:41:27,car_roster_turnover_detailed.csv,2025-08-17 08:45:20,32
CAR,2013,2014,DB,9,8,4,5,4,44.44,55.56,50.0,-1,2025-08-15 16:41:27,car_roster_turnover_detailed.csv,2025-08-17 08:45:20,32
CAR,2013,2014,DL,6,6,3,3,3,50.0,50.0,50.0,0,2025-08-15 16:41:27,car_roster_turnover_detailed.csv,2025-08-17 08:45:20,32
CAR,2013,2014,LB,6,7,2,4,5,33.33,66.67,71.43,1,2025-08-15 16:41:27,car_roster_turnover_detailed.csv,2025-08-17 08:45:20,32
CAR,2013,2014,OL,7,5,3,4,2,42.86,57.14,40.0,-2,2025-08-15 16:41:27,car_roster_turnover_detailed.csv,2025-08-17 08:45:20,32
CAR,2013,2014,OTHER,14,18,7,7,11,50.0,50.0,61.11,4,2025-08-15 16:41:27,car_roster_turnover_detailed.csv,2025-08-17 08:45:20,32
CAR,2013,2014,QB,3,3,2,1,1,66.67,33.33,33.33,0,2025-08-15 16:41:27,car_roster_turnover_detailed.csv,2025-08-17 08:45:20,32
CAR,2013,2014,RB,5,7,3,2,4,60.0,40.0,57.14,2,2025-08-15 16:41:27,car_roster_turnover_detailed.csv,2025-08-17 08:45:20,32
CAR,2013,2014,ST,3,3,3,0,0,100.0,0.0,0.0,0,2025-08-15 16:41:27,car_roster_turnover_detailed.csv,2025-08-17 08:45:20,32
CAR,2013,2014,TE,4,4,3,1,1,75.0,25.0,25.0,0,2025-08-15 16:41:27,car_roster_turnover_detailed.csv,2025-08-17 08:45:20,32
CAR,2013,2014,WR,5,6,0,5,6,0.0,100.0,100.0,1,2025-08-15 16:41:27,car_roster_turnover_detailed.csv,2025-08-17 08:45:20,32
CAR,2014,2015,DB,8,9,3,5,6,37.5,62.5,66.67,1,2025-08-15 16:41:27,car_roster_turnover_detailed.csv,2025-08-17 08:45:20,32
CAR,2014,2015,DL,6,6,3,3,3,50.0,50.0,50.0,0,2025-08-15 16:41:27,car_roster_turnover_detailed.csv,2025-08-17 08:45:20,32
CAR,2014,2015,LB,7,4,2,5,2,28.57,71.43,50.0,-3,2025-08-15 16:41:27,car_roster_turnover_detailed.csv,2025-08-17 08:45:20,32
CAR,2014,2015,OL,5,5,2,3,3,40.0,60.0,60.0,0,2025-08-15 16:41:27,car_roster_turnover_detailed.csv,2025-08-17 08:45:20,32
CAR,2014,2015,OTHER,18,13,8,10,5,44.44,55.56,38.46,-5,2025-08-15 16:41:27,car_roster_turnover_detailed.csv,2025-08-17 08:45:20,32
CAR,2014,2015,QB,3,2,2,1,0,66.67,33.33,0.0,-1,2025-08-15 16:41:27,car_roster_turnover_detailed.csv,2025-08-17 08:45:20,32
CAR,2014,2015,RB,7,5,3,4,2,42.86,57.14,40.0,-2,2025-08-15 16:41:27,car_roster_turnover_detailed.csv,2025-08-17 08:45:20,32
CAR,2014,2015,ST,3,3,3,0,0,100.0,0.0,0.0,0,2025-08-15 16:41:27,car_roster_turnover_detailed.csv,2025-08-17 08:45:20,32
CAR,2014,2015,TE,4,5,4,0,1,100.0,0.0,20.0,1,2025-08-15 16:41:27,car_roster_turnover_detailed.csv,2025-08-17 08:45:20,32
CAR,2014,2015,WR,6,7,4,2,3,66.67,33.33,42.86,1,2025-08-15 16:41:27,car_roster_turnover_detailed.csv,2025-08-17 08:45:20,32
CAR,2015,2016,DB,9,14,7,2,7,77.78,22.22,50.0,5,2025-08-15 16:41:27,car_roster_turnover_detailed.csv,2025-08-17 08:45:20,32
CAR,2015,2016,DL,6,7,3,3,4,50.0,50.0,57.14,1,2025-08-15 16:41:27,car_roster_turnover_detailed.csv,2025-08-17 08:45:20,32
CAR,2015,2016,LB,4,5,4,0,1,100.0,0.0,20.0,1,2025-08-15 16:41:27,car_roster_turnover_detailed.csv,2025-08-17 08:45:20,32
CAR,2015,2016,OL,5,8,2,3,6,40.0,60.0,75.0,3,2025-08-15 16:41:27,car_roster_turnover_detailed.csv,2025-08-17 08:45:20,32
CAR,2015,2016,OTHER,13,13,9,4,4,69.23,30.77,30.77,0,2025-08-15 16:41:27,car_roster_turnover_detailed.csv,2025-08-17 08:45:20,32
CAR,2015,2016,QB,2,2,2,0,0,100.0,0.0,0.0,0,2025-08-15 16:41:27,car_roster_turnover_detailed.csv,2025-08-17 08:45:20,32
CAR,2015,2016,RB,5,4,4,1,0,80.0,20.0,0.0,-1,2025-08-15 16:41:27,car_roster_turnover_detailed.csv,2025-08-17 08:45:20,32
CAR,2015,2016,ST,3,4,2,1,2,66.67,33.33,50.0,1,2025-08-15 16:41:27,car_roster_turnover_detailed.csv,2025-08-17 08:45:20,32
CAR,2015,2016,TE,5,4,3,2,1,60.0,40.0,25.0,-1,2025-08-15 16:41:27,car_roster_turnover_detailed.csv,2025-08-17 08:45:20,32
CAR,2015,2016,WR,7,7,5,2,2,71.43,28.57,28.57,0,2025-08-15 16:41:27,car_roster_turnover_detailed.csv,2025-08-17 08:45:20,32
CAR,2016,2017,DB,14,10,3,11,7,21.43,78.57,70.0,-4,2025-08-15 16:41:27,car_roster_turnover_detailed.csv,2025-08-17 08:45:20,32
CAR,2016,2017,DL,7,5,2,5,3,28.57,71.43,60.0,-2,2025-08-15 16:41:27,car_roster_turnover_detailed.csv,2025-08-17 08:45:20,32
CAR,2016,2017,LB,5,6,4,1,2,80.0,20.0,33.33,1,2025-08-15 16:41:27,car_roster_turnover_detailed.csv,2025-08-17 08:45:20,32
CAR,2016,2017,OL,8,5,2,6,3,25.0,75.0,60.0,-3,2025-08-15 16:41:27,car_roster_turnover_detailed.csv,2025-08-17 08:45:20,32
CAR,2016,2017,OTHER,13,13,10,3,3,76.92,23.08,23.08,0,2025-08-15 16:41:27,car_roster_turnover_detailed.csv,2025-08-17 08:45:20,32
CAR,2016,2017,QB,2,2,2,0,0,100.0,0.0,0.0,0,2025-08-15 16:41:27,car_roster_turnover_detailed.csv,2025-08-17 08:45:20,32
CAR,2016,2017,RB,4,5,3,1,2,75.0,25.0,40.0,1,2025-08-15 16:41:27,car_roster_turnover_detailed.csv,2025-08-17 08:45:20,32
CAR,2016,2017,ST,4,3,3,1,0,75.0,25.0,0.0,-1,2025-08-15 16:41:27,car_roster_turnover_detailed.csv,2025-08-17 08:45:20,32
CAR,2016,2017,TE,4,3,3,1,0,75.0,25.0,0.0,-1,2025-08-15 16:41:27,car_roster_turnover_detailed.csv,2025-08-17 08:45:20,32
CAR,2016,2017,WR,7,8,4,3,4,57.14,42.86,50.0,1,2025-08-15 16:41:27,car_roster_turnover_detailed.csv,2025-08-17 08:45:20,32
CAR,2017,2018,DB,10,9,3,7,6,30.0,70.0,66.67,-1,2025-08-15 16:41:27,car_roster_turnover_detailed.csv,2025-08-17 08:45:20,32
CAR,2017,2018,DL,5,4,3,2,1,60.0,40.0,25.0,-1,2025-08-15 16:41:27,car_roster_turnover_detailed.csv,2025-08-17 08:45:20,32
CAR,2017,2018,LB,6,7,4,2,3,66.67,33.33,42.86,1,2025-08-15 16:41:27,car_roster_turnover_detailed.csv,2025-08-17 08:45:20,32
CAR,2017,2018,OL,5,8,3,2,5,60.0,40.0,62.5,3,2025-08-15 16:41:27,car_roster_turnover_detailed.csv,2025-08-17 08:45:20,32
CAR,2017,2018,OTHER,13,13,7,6,6,53.85,46.15,46.15,0,2025-08-15 16:41:27,car_roster_turnover_detailed.csv,2025-08-17 08:45:20,32
CAR,2017,2018,QB,2,4,1,1,3,50.0,50.0,75.0,2,2025-08-15 16:41:27,car_roster_turnover_detailed.csv,2025-08-17 08:45:20,32
CAR,2017,2018,RB,5,6,3,2,3,60.0,40.0,50.0,1,2025-08-15 16:41:27,car_roster_turnover_detailed.csv,2025-08-17 08:45:20,32
CAR,2017,2018,ST,3,4,3,0,1,100.0,0.0,25.0,1,2025-08-15 16:41:27,car_roster_turnover_detailed.csv,2025-08-17 08:45:20,32
CAR,2017,2018,TE,3,3,2,1,1,66.67,33.33,33.33,0,2025-08-15 16:41:27,car_roster_turnover_detailed.csv,2025-08-17 08:45:20,32
CAR,2017,2018,WR,8,7,4,4,3,50.0,50.0,42.86,-1,2025-08-15 16:41:27,car_roster_turnover_detailed.csv,2025-08-17 08:45:20,32
CAR,2018,2019,DB,9,9,4,5,5,44.44,55.56,55.56,0,2025-08-15 16:41:27,car_roster_turnover_detailed.csv,2025-08-17 08:45:20,32
CAR,2018,2019,DL,4,7,3,1,4,75.0,25.0,57.14,3,2025-08-15 16:41:27,car_roster_turnover_detailed.csv,2025-08-17 08:45:20,32
CAR,2018,2019,LB,7,4,2,5,2,28.57,71.43,50.0,-3,2025-08-15 16:41:27,car_roster_turnover_detailed.csv,2025-08-17 08:45:20,32
CAR,2018,2019,OL,8,7,1,7,6,12.5,87.5,85.71,-1,2025-08-15 16:41:27,car_roster_turnover_detailed.csv,2025-08-17 08:45:20,32
CAR,2018,2019,OTHER,13,16,7,6,9,53.85,46.15,56.25,3,2025-08-15 16:41:27,car_roster_turnover_detailed.csv,2025-08-17 08:45:20,32
CAR,2018,2019,QB,4,3,2,2,1,50.0,50.0,33.33,-1,2025-08-15 16:41:27,car_roster_turnover_detailed.csv,2025-08-17 08:45:20,32
CAR,2018,2019,RB,6,5,2,4,3,33.33,66.67,60.0,-1,2025-08-15 16:41:27,car_roster_turnover_detailed.csv,2025-08-17 08:45:20,32
CAR,2018,2019,ST,4,3,2,2,1,50.0,50.0,33.33,-1,2025-08-15 16:41:27,car_roster_turnover_detailed.csv,2025-08-17 08:45:20,32
CAR,2018,2019,TE,3,3,3,0,0,100.0,0.0,0.0,0,2025-08-15 16:41:27,car_roster_turnover_detailed.csv,2025-08-17 08:45:20,32
CAR,2018,2019,WR,7,9,3,4,6,42.86,57.14,66.67,2,2025-08-15 16:41:27,car_roster_turnover_detailed.csv,2025-08-17 08:45:20,32
CAR,2019,2020,DB,9,8,3,6,5,33.33,66.67,62.5,-1,2025-08-15 16:41:27,car_roster_turnover_detailed.csv,2025-08-17 08:45:20,32
CAR,2019,2020,DL,7,5,2,5,3,28.57,71.43,60.0,-2,2025-08-15 16:41:27,car_roster_turnover_detailed.csv,2025-08-17 08:45:20,32
CAR,2019,2020,LB,4,8,1,3,7,25.0,75.0,87.5,4,2025-08-15 16:41:27,car_roster_turnover_detailed.csv,2025-08-17 08:45:20,32
CAR,2019,2020,OL,7,8,3,4,5,42.86,57.14,62.5,1,2025-08-15 16:41:27,car_roster_turnover_detailed.csv,2025-08-17 08:45:20,32
CAR,2019,2020,OTHER,16,14,4,12,10,25.0,75.0,71.43,-2,2025-08-15 16:41:27,car_roster_turnover_detailed.csv,2025-08-17 08:45:20,32
CAR,2019,2020,QB,3,3,0,3,3,0.0,100.0,100.0,0,2025-08-15 16:41:27,car_roster_turnover_detailed.csv,2025-08-17 08:45:20,32
CAR,2019,2020,RB,5,6,4,1,2,80.0,20.0,33.33,1,2025-08-15 16:41:27,car_roster_turnover_detailed.csv,2025-08-17 08:45:20,32
CAR,2019,2020,ST,3,3,2,1,1,66.67,33.33,33.33,0,2025-08-15 16:41:27,car_roster_turnover_detailed.csv,2025-08-17 08:45:20,32
CAR,2019,2020,TE,3,3,2,1,1,66.67,33.33,33.33,0,2025-08-15 16:41:27,car_roster_turnover_detailed.csv,2025-08-17 08:45:20,32
CAR,2019,2020,WR,9,8,3,6,5,33.33,66.67,62.5,-1,2025-08-15 16:41:27,car_roster_turnover_detailed.csv,2025-08-17 08:45:20,32
CAR,2020,2021,DB,8,10,3,5,7,37.5,62.5,70.0,2,2025-08-15 16:41:27,car_roster_turnover_detailed.csv,2025-08-17 08:45:20,32
CAR,2020,2021,DL,5,6,0,5,6,0.0,100.0,100.0,1,2025-08-15 16:41:27,car_roster_turnover_detailed.csv,2025-08-17 08:45:20,32
CAR,2020,2021,LB,8,7,5,3,2,62.5,37.5,28.57,-1,2025-08-15 16:41:27,car_roster_turnover_detailed.csv,2025-08-17 08:45:20,32
CAR,2020,2021,OL,8,7,2,6,5,25.0,75.0,71.43,-1,2025-08-15 16:41:27,car_roster_turnover_detailed.csv,2025-08-17 08:45:20,32
CAR,2020,2021,OTHER,14,17,6,8,11,42.86,57.14,64.71,3,2025-08-15 16:41:27,car_roster_turnover_detailed.csv,2025-08-17 08:45:20,32
CAR,2020,2021,QB,3,3,1,2,2,33.33,66.67,66.67,0,2025-08-15 16:41:27,car_roster_turnover_detailed.csv,2025-08-17 08:45:20,32
CAR,2020,2021,RB,6,8,3,3,5,50.0,50.0,62.5,2,2025-08-15 16:41:27,car_roster_turnover_detailed.csv,2025-08-17 08:45:20,32
CAR,2020,2021,ST,3,7,2,1,5,66.67,33.33,71.43,4,2025-08-15 16:41:27,car_roster_turnover_detailed.csv,2025-08-17 08:45:20,32
CAR,2020,2021,TE,3,4,2,1,2,66.67,33.33,50.0,1,2025-08-15 16:41:27,car_roster_turnover_detailed.csv,2025-08-17 08:45:20,32
CAR,2020,2021,WR,8,12,4,4,8,50.0,50.0,66.67,4,2025-08-15 16:41:27,car_roster_turnover_detailed.csv,2025-08-17 08:45:20,32
CAR,2021,2022,DB,10,12,5,5,7,50.0,50.0,58.33,2,2025-08-15 16:41:27,car_roster_turnover_detailed.csv,2025-08-17 08:45:20,32
CAR,2021,2022,DL,6,7,3,3,4,50.0,50.0,57.14,1,2025-08-15 16:41:27,car_roster_turnover_detailed.csv,2025-08-17 08:45:20,32
CAR,2021,2022,LB,7,7,1,6,6,14.29,85.71,85.71,0,2025-08-15 16:41:27,car_roster_turnover_detailed.csv,2025-08-17 08:45:20,32
CAR,2021,2022,OL,7,5,1,6,4,14.29,85.71,80.0,-2,2025-08-15 16:41:27,car_roster_turnover_detailed.csv,2025-08-17 08:45:20,32
CAR,2021,2022,OTHER,17,13,7,10,6,41.18,58.82,46.15,-4,2025-08-15 16:41:27,car_roster_turnover_detailed.csv,2025-08-17 08:45:20,32
CAR,2021,2022,QB,3,4,2,1,2,66.67,33.33,50.0,1,2025-08-15 16:41:27,car_roster_turnover_detailed.csv,2025-08-17 08:45:20,32
CAR,2021,2022,RB,8,5,3,5,2,37.5,62.5,40.0,-3,2025-08-15 16:41:27,car_roster_turnover_detailed.csv,2025-08-17 08:45:20,32
CAR,2021,2022,ST,7,3,1,6,2,14.29,85.71,66.67,-4,2025-08-15 16:41:27,car_roster_turnover_detailed.csv,2025-08-17 08:45:20,32
CAR,2021,2022,TE,4,4,3,1,1,75.0,25.0,25.0,0,2025-08-15 16:41:27,car_roster_turnover_detailed.csv,2025-08-17 08:45:20,32
CAR,2021,2022,WR,12,8,4,8,4,33.33,66.67,50.0,-4,2025-08-15 16:41:27,car_roster_turnover_detailed.csv,2025-08-17 08:45:20,32
CAR,2022,2023,DB,12,18,3,9,15,25.0,75.0,83.33,6,2025-08-15 16:41:27,car_roster_turnover_detailed.csv,2025-08-17 08:45:20,32
CAR,2022,2023,DL,7,7,0,7,7,0.0,100.0,100.0,0,2025-08-15 16:41:27,car_roster_turnover_detailed.csv,2025-08-17 08:45:20,32
CAR,2022,2023,LB,7,11,2,5,9,28.57,71.43,81.82,4,2025-08-15 16:41:27,car_roster_turnover_detailed.csv,2025-08-17 08:45:20,32
CAR,2022,2023,OL,5,13,2,3,11,40.0,60.0,84.62,8,2025-08-15 16:41:27,car_roster_turnover_detailed.csv,2025-08-17 08:45:20,32
CAR,2022,2023,OTHER,13,5,2,11,3,15.38,84.62,60.0,-8,2025-08-15 16:41:27,car_roster_turnover_detailed.csv,2025-08-17 08:45:20,32
CAR,2022,2023,QB,4,2,0,4,2,0.0,100.0,100.0,-2,2025-08-15 16:41:27,car_roster_turnover_detailed.csv,2025-08-17 08:45:20,32
CAR,2022,2023,RB,5,3,2,3,1,40.0,60.0,33.33,-2,2025-08-15 16:41:27,car_roster_turnover_detailed.csv,2025-08-17 08:45:20,32
CAR,2022,2023,ST,3,4,3,0,1,100.0,0.0,25.0,1,2025-08-15 16:41:27,car_roster_turnover_detailed.csv,2025-08-17 08:45:20,32
CAR,2022,2023,TE,4,6,4,0,2,100.0,0.0,33.33,2,2025-08-15 16:41:27,car_roster_turnover_detailed.csv,2025-08-17 08:45:20,32
CAR,2022,2023,WR,8,7,2,6,5,25.0,75.0,71.43,-1,2025-08-15 16:41:27,car_roster_turnover_detailed.csv,2025-08-17 08:45:20,32
CAR,2023,2024,DB,18,15,4,14,11,22.22,77.78,73.33,-3,2025-08-15 16:41:27,car_roster_turnover_detailed.csv,2025-08-17 08:45:20,32
CAR,2023,2024,DL,7,10,4,3,6,57.14,42.86,60.0,3,2025-08-15 16:41:27,car_roster_turnover_detailed.csv,2025-08-17 08:45:20,32
CAR,2023,2024,LB,11,16,7,4,9,63.64,36.36,56.25,5,2025-08-15 16:41:27,car_roster_turnover_detailed.csv,2025-08-17 08:45:20,32
CAR,2023,2024,OL,13,8,4,9,4,30.77,69.23,50.0,-5,2025-08-15 16:41:27,car_roster_turnover_detailed.csv,2025-08-17 08:45:20,32
CAR,2023,2024,OTHER,5,12,0,5,12,0.0,100.0,100.0,7,2025-08-15 16:41:27,car_roster_turnover_detailed.csv,2025-08-17 08:45:20,32
CAR,2023,2024,QB,2,2,2,0,0,100.0,0.0,0.0,0,2025-08-15 16:41:27,car_roster_turnover_detailed.csv,2025-08-17 08:45:20,32
CAR,2023,2024,RB,3,5,3,0,2,100.0,0.0,40.0,2,2025-08-15 16:41:27,car_roster_turnover_detailed.csv,2025-08-17 08:45:20,32
CAR,2023,2024,ST,4,3,3,1,0,75.0,25.0,0.0,-1,2025-08-15 16:41:27,car_roster_turnover_detailed.csv,2025-08-17 08:45:20,32
CAR,2023,2024,TE,6,6,4,2,2,66.67,33.33,33.33,0,2025-08-15 16:41:27,car_roster_turnover_detailed.csv,2025-08-17 08:45:20,32
CAR,2023,2024,WR,7,9,2,5,7,28.57,71.43,77.78,2,2025-08-15 16:41:27,car_roster_turnover_detailed.csv,2025-08-17 08:45:20,32
CHI,2011,2012,DB,10,9,6,4,3,60.0,40.0,33.33,-1,2025-08-15 16:41:31,chi_roster_turnover_detailed.csv,2025-08-17 08:45:20,32
CHI,2011,2012,DL,7,5,1,6,4,14.29,85.71,80.0,-2,2025-08-15 16:41:31,chi_roster_turnover_detailed.csv,2025-08-17 08:45:20,32
CHI,2011,2012,LB,6,7,3,3,4,50.0,50.0,57.14,1,2025-08-15 16:41:31,chi_roster_turnover_detailed.csv,2025-08-17 08:45:20,32
CHI,2011,2012,OL,5,5,2,3,3,40.0,60.0,60.0,0,2025-08-15 16:41:31,chi_roster_turnover_detailed.csv,2025-08-17 08:45:20,32
CHI,2011,2012,OTHER,13,15,10,3,5,76.92,23.08,33.33,2,2025-08-15 16:41:31,chi_roster_turnover_detailed.csv,2025-08-17 08:45:20,32
CHI,2011,2012,QB,3,2,1,2,1,33.33,66.67,50.0,-1,2025-08-15 16:41:31,chi_roster_turnover_detailed.csv,2025-08-17 08:45:20,32
CHI,2011,2012,RB,6,4,3,3,1,50.0,50.0,25.0,-2,2025-08-15 16:41:31,chi_roster_turnover_detailed.csv,2025-08-17 08:45:20,32
CHI,2011,2012,ST,2,3,2,0,1,100.0,0.0,33.33,1,2025-08-15 16:41:31,chi_roster_turnover_detailed.csv,2025-08-17 08:45:20,32
CHI,2011,2012,TE,3,4,3,0,1,100.0,0.0,25.0,1,2025-08-15 16:41:31,chi_roster_turnover_detailed.csv,2025-08-17 08:45:20,32
CHI,2011,2012,WR,7,7,3,4,4,42.86,57.14,57.14,0,2025-08-15 16:41:31,chi_roster_turnover_detailed.csv,2025-08-17 08:45:20,32
CHI,2012,2013,DB,9,9,5,4,4,55.56,44.44,44.44,0,2025-08-15 16:41:31,chi_roster_turnover_detailed.csv,2025-08-17 08:45:20,32
CHI,2012,2013,DL,5,9,2,3,7,40.0,60.0,77.78,4,2025-08-15 16:41:31,chi_roster_turnover_detailed.csv,2025-08-17 08:45:20,32
CHI,2012,2013,LB,7,8,2,5,6,28.57,71.43,75.0,1,2025-08-15 16:41:31,chi_roster_turnover_detailed.csv,2025-08-17 08:45:20,32
CHI,2012,2013,OL,5,5,2,3,3,40.0,60.0,60.0,0,2025-08-15 16:41:31,chi_roster_turnover_detailed.csv,2025-08-17 08:45:20,32
CHI,2012,2013,OTHER,15,14,6,9,8,40.0,60.0,57.14,-1,2025-08-15 16:41:31,chi_roster_turnover_detailed.csv,2025-08-17 08:45:20,32
CHI,2012,2013,QB,2,2,1,1,1,50.0,50.0,50.0,0,2025-08-15 16:41:31,chi_roster_turnover_detailed.csv,2025-08-17 08:45:20,32
CHI,2012,2013,RB,4,4,2,2,2,50.0,50.0,50.0,0,2025-08-15 16:41:31,chi_roster_turnover_detailed.csv,2025-08-17 08:45:20,32
CHI,2012,2013,ST,3,2,2,1,0,66.67,33.33,0.0,-1,2025-08-15 16:41:31,chi_roster_turnover_detailed.csv,2025-08-17 08:45:20,32
CHI,2012,2013,TE,4,3,1,3,2,25.0,75.0,66.67,-1,2025-08-15 16:41:31,chi_roster_turnover_detailed.csv,2025-08-17 08:45:20,32
CHI,2012,2013,WR,7,6,5,2,1,71.43,28.57,16.67,-1,2025-08-15 16:41:31,chi_roster_turnover_detailed.csv,2025-08-17 08:45:20,32
CHI,2013,2014,DB,9,12,4,5,8,44.44,55.56,66.67,3,2025-08-15 16:41:31,chi_roster_turnover_detailed.csv,2025-08-17 08:45:20,32
CHI,2013,2014,DL,9,4,1,8,3,11.11,88.89,75.0,-5,2025-08-15 16:41:31,chi_roster_turnover_detailed.csv,2025-08-17 08:45:20,32
CHI,2013,2014,LB,8,8,4,4,4,50.0,50.0,50.0,0,2025-08-15 16:41:31,chi_roster_turnover_detailed.csv,2025-08-17 08:45:20,32
CHI,2013,2014,OL,5,6,3,2,3,60.0,40.0,50.0,1,2025-08-15 16:41:31,chi_roster_turnover_detailed.csv,2025-08-17 08:45:20,32
CHI,2013,2014,OTHER,14,16,8,6,8,57.14,42.86,50.0,2,2025-08-15 16:41:31,chi_roster_turnover_detailed.csv,2025-08-17 08:45:20,32
CHI,2013,2014,QB,2,2,1,1,1,50.0,50.0,50.0,0,2025-08-15 16:41:31,chi_roster_turnover_detailed.csv,2025-08-17 08:45:20,32
CHI,2013,2014,RB,4,6,2,2,4,50.0,50.0,66.67,2,2025-08-15 16:41:31,chi_roster_turnover_detailed.csv,2025-08-17 08:45:20,32
CHI,2013,2014,ST,2,3,1,1,2,50.0,50.0,66.67,1,2025-08-15 16:41:31,chi_roster_turnover_detailed.csv,2025-08-17 08:45:20,32
CHI,2013,2014,TE,3,4,2,1,2,66.67,33.33,50.0,1,2025-08-15 16:41:31,chi_roster_turnover_detailed.csv,2025-08-17 08:45:20,32
CHI,2013,2014,WR,6,10,3,3,7,50.0,50.0,70.0,4,2025-08-15 16:41:31,chi_roster_turnover_detailed.csv,2025-08-17 08:45:20,32
CHI,2014,2015,DB,12,12,3,9,9,25.0,75.0,75.0,0,2025-08-15 16:41:31,chi_roster_turnover_detailed.csv,2025-08-17 08:45:20,32
CHI,2014,2015,DL,4,12,2,2,10,50.0,50.0,83.33,8,2025-08-15 16:41:31,chi_roster_turnover_detailed.csv,2025-08-17 08:45:20,32
CHI,2014,2015,LB,8,6,1,7,5,12.5,87.5,83.33,-2,2025-08-15 16:41:31,chi_roster_turnover_detailed.csv,2025-08-17 08:45:20,32
CHI,2014,2015,OL,6,5,0,6,5,0.0,100.0,100.0,-1,2025-08-15 16:41:31,chi_roster_turnover_detailed.csv,2025-08-17 08:45:20,32
CHI,2014,2015,OTHER,16,14,6,10,8,37.5,62.5,57.14,-2,2025-08-15 16:41:31,chi_roster_turnover_detailed.csv,2025-08-17 08:45:20,32
CHI,2014,2015,QB,2,2,2,0,0,100.0,0.0,0.0,0,2025-08-15 16:41:31,chi_roster_turnover_detailed.csv,2025-08-17 08:45:20,32
CHI,2014,2015,RB,6,5,2,4,3,33.33,66.67,60.0,-1,2025-08-15 16:41:31,chi_roster_turnover_detailed.csv,2025-08-17 08:45:20,32
CHI,2014,2015,ST,3,4,2,1,2,66.67,33.33,50.0,1,2025-08-15 16:41:31,chi_roster_turnover_detailed.csv,2025-08-17 08:45:20,32
CHI,2014,2015,TE,4,4,1,3,3,25.0,75.0,75.0,0,2025-08-15 16:41:31,chi_roster_turnover_detailed.csv,2025-08-17 08:45:20,32
CHI,2014,2015,WR,10,7,4,6,3,40.0,60.0,42.86,-3,2025-08-15 16:41:31,chi_roster_turnover_detailed.csv,2025-08-17 08:45:20,32
CHI,2015,2016,DB,12,12,7,5,5,58.33,41.67,41.67,0,2025-08-15 16:41:31,chi_roster_turnover_detailed.csv,2025-08-17 08:45:20,32
CHI,2015,2016,DL,12,7,3,9,4,25.0,75.0,57.14,-5,2025-08-15 16:41:31,chi_roster_turnover_detailed.csv,2025-08-17 08:45:20,32
CHI,2015,2016,LB,6,5,3,3,2,50.0,50.0,40.0,-1,2025-08-15 16:41:31,chi_roster_turnover_detailed.csv,2025-08-17 08:45:20,32
CHI,2015,2016,OL,5,5,0,5,5,0.0,100.0,100.0,0,2025-08-15 16:41:31,chi_roster_turnover_detailed.csv,2025-08-17 08:45:20,32
CHI,2015,2016,OTHER,14,15,5,9,10,35.71,64.29,66.67,1,2025-08-15 16:41:31,chi_roster_turnover_detailed.csv,2025-08-17 08:45:20,32
CHI,2015,2016,QB,2,4,1,1,3,50.0,50.0,75.0,2,2025-08-15 16:41:31,chi_roster_turnover_detailed.csv,2025-08-17 08:45:20,32
CHI,2015,2016,RB,5,6,2,3,4,40.0,60.0,66.67,1,2025-08-15 16:41:31,chi_roster_turnover_detailed.csv,2025-08-17 08:45:20,32
CHI,2015,2016,ST,4,3,2,2,1,50.0,50.0,33.33,-1,2025-08-15 16:41:31,chi_roster_turnover_detailed.csv,2025-08-17 08:45:20,32
CHI,2015,2016,TE,4,4,1,3,3,25.0,75.0,75.0,0,2025-08-15 16:41:31,chi_roster_turnover_detailed.csv,2025-08-17 08:45:20,32
CHI,2015,2016,WR,7,10,6,1,4,85.71,14.29,40.0,3,2025-08-15 16:41:31,chi_roster_turnover_detailed.csv,2025-08-17 08:45:20,32
CHI,2016,2017,DB,12,11,7,5,4,58.33,41.67,36.36,-1,2025-08-15 16:41:31,chi_roster_turnover_detailed.csv,2025-08-17 08:45:20,32
CHI,2016,2017,DL,7,8,4,3,4,57.14,42.86,50.0,1,2025-08-15 16:41:31,chi_roster_turnover_detailed.csv,2025-08-17 08:45:20,32
CHI,2016,2017,LB,5,6,2,3,4,40.0,60.0,66.67,1,2025-08-15 16:41:31,chi_roster_turnover_detailed.csv,2025-08-17 08:45:20,32
CHI,2016,2017,OL,5,5,1,4,4,20.0,80.0,80.0,0,2025-08-15 16:41:31,chi_roster_turnover_detailed.csv,2025-08-17 08:45:20,32
CHI,2016,2017,OTHER,15,12,9,6,3,60.0,40.0,25.0,-3,2025-08-15 16:41:31,chi_roster_turnover_detailed.csv,2025-08-17 08:45:20,32
CHI,2016,2017,QB,4,2,0,4,2,0.0,100.0,100.0,-2,2025-08-15 16:41:31,chi_roster_turnover_detailed.csv,2025-08-17 08:45:20,32
CHI,2016,2017,RB,6,6,1,5,5,16.67,83.33,83.33,0,2025-08-15 16:41:31,chi_roster_turnover_detailed.csv,2025-08-17 08:45:20,32
CHI,2016,2017,ST,3,5,2,1,3,66.67,33.33,60.0,2,2025-08-15 16:41:31,chi_roster_turnover_detailed.csv,2025-08-17 08:45:20,32
CHI,2016,2017,TE,4,3,2,2,1,50.0,50.0,33.33,-1,2025-08-15 16:41:31,chi_roster_turnover_detailed.csv,2025-08-17 08:45:20,32
CHI,2016,2017,WR,10,9,4,6,5,40.0,60.0,55.56,-1,2025-08-15 16:41:31,chi_roster_turnover_detailed.csv,2025-08-17 08:45:20,32
CHI,2017,2018,DB,11,9,7,4,2,63.64,36.36,22.22,-2,2025-08-15 16:41:31,chi_roster_turnover_detailed.csv,2025-08-17 08:45:20,32
CHI,2017,2018,DL,8,5,3,5,2,37.5,62.5,40.0,-3,2025-08-15 16:41:31,chi_roster_turnover_detailed.csv,2025-08-17 08:45:20,32
CHI,2017,2018,LB,6,5,2,4,3,33.33,66.67,60.0,-1,2025-08-15 16:41:31,chi_roster_turnover_detailed.csv,2025-08-17 08:45:20,32
CHI,2017,2018,OL,5,2,2,3,0,40.0,60.0,0.0,-3,2025-08-15 16:41:31,chi_roster_turnover_detailed.csv,2025-08-17 08:45:20,32
CHI,2017,2018,OTHER,12,14,8,4,6,66.67,33.33,42.86,2,2025-08-15 16:41:31,chi_roster_turnover_detailed.csv,2025-08-17 08:45:20,32
CHI,2017,2018,QB,2,2,1,1,1,50.0,50.0,50.0,0,2025-08-15 16:41:31,chi_roster_turnover_detailed.csv,2025-08-17 08:45:20,32
CHI,2017,2018,RB,6,5,5,1,0,83.33,16.67,0.0,-1,2025-08-15 16:41:31,chi_roster_turnover_detailed.csv,2025-08-17 08:45:20,32
CHI,2017,2018,ST,5,3,1,4,2,20.0,80.0,66.67,-2,2025-08-15 16:41:31,chi_roster_turnover_detailed.csv,2025-08-17 08:45:20,32
CHI,2017,2018,TE,3,4,2,1,2,66.67,33.33,50.0,1,2025-08-15 16:41:31,chi_roster_turnover_detailed.csv,2025-08-17 08:45:20,32
CHI,2017,2018,WR,9,7,3,6,4,33.33,66.67,57.14,-2,2025-08-15 16:41:31,chi_roster_turnover_detailed.csv,2025-08-17 08:45:20,32
CHI,2018,2019,DB,9,8,5,4,3,55.56,44.44,37.5,-1,2025-08-15 16:41:31,chi_roster_turnover_detailed.csv,2025-08-17 08:45:20,32
CHI,2018,2019,DL,5,7,3,2,4,60.0,40.0,57.14,2,2025-08-15 16:41:31,chi_roster_turnover_detailed.csv,2025-08-17 08:45:20,32
CHI,2018,2019,LB,5,6,2,3,4,40.0,60.0,66.67,1,2025-08-15 16:41:31,chi_roster_turnover_detailed.csv,2025-08-17 08:45:20,32
CHI,2018,2019,OL,2,5,2,0,3,100.0,0.0,60.0,3,2025-08-15 16:41:31,chi_roster_turnover_detailed.csv,2025-08-17 08:45:20,32
CHI,2018,2019,OTHER,14,14,10,4,4,71.43,28.57,28.57,0,2025-08-15 16:41:31,chi_roster_turnover_detailed.csv,2025-08-17 08:45:20,32
CHI,2018,2019,QB,2,2,2,0,0,100.0,0.0,0.0,0,2025-08-15 16:41:31,chi_roster_turnover_detailed.csv,2025-08-17 08:45:20,32
CHI,2018,2019,RB,5,4,1,4,3,20.0,80.0,75.0,-1,2025-08-15 16:41:31,chi_roster_turnover_detailed.csv,2025-08-17 08:45:20,32
CHI,2018,2019,ST,3,3,2,1,1,66.67,33.33,33.33,0,2025-08-15 16:41:31,chi_roster_turnover_detailed.csv,2025-08-17 08:45:20,32
CHI,2018,2019,TE,4,5,3,1,2,75.0,25.0,40.0,1,2025-08-15 16:41:31,chi_roster_turnover_detailed.csv,2025-08-17 08:45:20,32
CHI,2018,2019,WR,7,7,4,3,3,57.14,42.86,42.86,0,2025-08-15 16:41:31,chi_roster_turnover_detailed.csv,2025-08-17 08:45:20,32
CHI,2019,2020,DB,8,10,6,2,4,75.0,25.0,40.0,2,2025-08-15 16:41:31,chi_roster_turnover_detailed.csv,2025-08-17 08:45:20,32
CHI,2019,2020,DL,7,7,2,5,5,28.57,71.43,71.43,0,2025-08-15 16:41:31,chi_roster_turnover_detailed.csv,2025-08-17 08:45:20,32
CHI,2019,2020,LB,6,6,4,2,2,66.67,33.33,33.33,0,2025-08-15 16:41:31,chi_roster_turnover_detailed.csv,2025-08-17 08:45:20,32
CHI,2019,2020,OL,5,6,1,4,5,20.0,80.0,83.33,1,2025-08-15 16:41:31,chi_roster_turnover_detailed.csv,2025-08-17 08:45:20,32
CHI,2019,2020,OTHER,14,13,8,6,5,57.14,42.86,38.46,-1,2025-08-15 16:41:31,chi_roster_turnover_detailed.csv,2025-08-17 08:45:20,32
CHI,2019,2020,QB,2,3,1,1,2,50.0,50.0,66.67,1,2025-08-15 16:41:31,chi_roster_turnover_detailed.csv,2025-08-17 08:45:20,32
CHI,2019,2020,RB,4,5,3,1,2,75.0,25.0,40.0,1,2025-08-15 16:41:31,chi_roster_turnover_detailed.csv,2025-08-17 08:45:20,32
CHI,2019,2020,ST,3,3,2,1,1,66.67,33.33,33.33,0,2025-08-15 16:41:31,chi_roster_turnover_detailed.csv,2025-08-17 08:45:20,32
CHI,2019,2020,TE,5,4,1,4,3,20.0,80.0,75.0,-1,2025-08-15 16:41:31,chi_roster_turnover_detailed.csv,2025-08-17 08:45:20,32
CHI,2019,2020,WR,7,9,5,2,4,71.43,28.57,44.44,2,2025-08-15 16:41:31,chi_roster_turnover_detailed.csv,2025-08-17 08:45:20,32
CHI,2020,2021,DB,10,12,7,3,5,70.0,30.0,41.67,2,2025-08-15 16:41:31,chi_roster_turnover_detailed.csv,2025-08-17 08:45:20,32
CHI,2020,2021,DL,7,9,2,5,7,28.57,71.43,77.78,2,2025-08-15 16:41:31,chi_roster_turnover_detailed.csv,2025-08-17 08:45:20,32
CHI,2020,2021,LB,6,9,2,4,7,33.33,66.67,77.78,3,2025-08-15 16:41:31,chi_roster_turnover_detailed.csv,2025-08-17 08:45:20,32
CHI,2020,2021,OL,6,6,2,4,4,33.33,66.67,66.67,0,2025-08-15 16:41:31,chi_roster_turnover_detailed.csv,2025-08-17 08:45:20,32
CHI,2020,2021,OTHER,13,15,6,7,9,46.15,53.85,60.0,2,2025-08-15 16:41:31,chi_roster_turnover_detailed.csv,2025-08-17 08:45:20,32
CHI,2020,2021,QB,3,3,1,2,2,33.33,66.67,66.67,0,2025-08-15 16:41:31,chi_roster_turnover_detailed.csv,2025-08-17 08:45:20,32
CHI,2020,2021,RB,5,5,3,2,2,60.0,40.0,40.0,0,2025-08-15 16:41:31,chi_roster_turnover_detailed.csv,2025-08-17 08:45:20,32
CHI,2020,2021,ST,3,3,3,0,0,100.0,0.0,0.0,0,2025-08-15 16:41:31,chi_roster_turnover_detailed.csv,2025-08-17 08:45:20,32
CHI,2020,2021,TE,4,4,3,1,1,75.0,25.0,25.0,0,2025-08-15 16:41:31,chi_roster_turnover_detailed.csv,2025-08-17 08:45:20,32
CHI,2020,2021,WR,9,10,2,7,8,22.22,77.78,80.0,1,2025-08-15 16:41:31,chi_roster_turnover_detailed.csv,2025-08-17 08:45:20,32
CHI,2021,2022,DB,12,15,2,10,13,16.67,83.33,86.67,3,2025-08-15 16:41:31,chi_roster_turnover_detailed.csv,2025-08-17 08:45:20,32
CHI,2021,2022,DL,9,7,0,9,7,0.0,100.0,100.0,-2,2025-08-15 16:41:31,chi_roster_turnover_detailed.csv,2025-08-17 08:45:20,32
CHI,2021,2022,LB,9,7,0,9,7,0.0,100.0,100.0,-2,2025-08-15 16:41:31,chi_roster_turnover_detailed.csv,2025-08-17 08:45:20,32
CHI,2021,2022,OL,6,5,2,4,3,33.33,66.67,60.0,-1,2025-08-15 16:41:31,chi_roster_turnover_detailed.csv,2025-08-17 08:45:20,32
CHI,2021,2022,OTHER,15,17,6,9,11,40.0,60.0,64.71,2,2025-08-15 16:41:31,chi_roster_turnover_detailed.csv,2025-08-17 08:45:20,32
CHI,2021,2022,QB,3,4,1,2,3,33.33,66.67,75.0,1,2025-08-15 16:41:31,chi_roster_turnover_detailed.csv,2025-08-17 08:45:20,32
CHI,2021,2022,RB,5,5,2,3,3,40.0,60.0,60.0,0,2025-08-15 16:41:31,chi_roster_turnover_detailed.csv,2025-08-17 08:45:20,32
CHI,2021,2022,ST,3,4,2,1,2,66.67,33.33,50.0,1,2025-08-15 16:41:31,chi_roster_turnover_detailed.csv,2025-08-17 08:45:20,32
CHI,2021,2022,TE,4,5,1,3,4,25.0,75.0,80.0,1,2025-08-15 16:41:31,chi_roster_turnover_detailed.csv,2025-08-17 08:45:20,32
CHI,2021,2022,WR,10,9,2,8,7,20.0,80.0,77.78,-1,2025-08-15 16:41:31,chi_roster_turnover_detailed.csv,2025-08-17 08:45:20,32
CHI,2022,2023,DB,15,15,7,8,8,46.67,53.33,53.33,0,2025-08-15 16:41:31,chi_roster_turnover_detailed.csv,2025-08-17 08:45:20,32
CHI,2022,2023,DL,7,9,0,7,9,0.0,100.0,100.0,2,2025-08-15 16:41:31,chi_roster_turnover_detailed.csv,2025-08-17 08:45:20,32
CHI,2022,2023,LB,7,7,2,5,5,28.57,71.43,71.43,0,2025-08-15 16:41:31,chi_roster_turnover_detailed.csv,2025-08-17 08:45:20,32
CHI,2022,2023,OL,5,10,2,3,8,40.0,60.0,80.0,5,2025-08-15 16:41:31,chi_roster_turnover_detailed.csv,2025-08-17 08:45:20,32
CHI,2022,2023,OTHER,17,2,2,15,0,11.76,88.24,0.0,-15,2025-08-15 16:41:31,chi_roster_turnover_detailed.csv,2025-08-17 08:45:20,32
CHI,2022,2023,QB,4,3,2,2,1,50.0,50.0,33.33,-1,2025-08-15 16:41:31,chi_roster_turnover_detailed.csv,2025-08-17 08:45:20,32
CHI,2022,2023,RB,5,6,3,2,3,60.0,40.0,50.0,1,2025-08-15 16:41:31,chi_roster_turnover_detailed.csv,2025-08-17 08:45:20,32
CHI,2022,2023,ST,4,3,3,1,0,75.0,25.0,0.0,-1,2025-08-15 16:41:31,chi_roster_turnover_detailed.csv,2025-08-17 08:45:20,32
CHI,2022,2023,TE,5,4,1,4,3,20.0,80.0,75.0,-1,2025-08-15 16:41:31,chi_roster_turnover_detailed.csv,2025-08-17 08:45:20,32
CHI,2022,2023,WR,9,8,4,5,4,44.44,55.56,50.0,-1,2025-08-15 16:41:31,chi_roster_turnover_detailed.csv,2025-08-17 08:45:20,32
CHI,2023,2024,DB,15,12,6,9,6,40.0,60.0,50.0,-3,2025-08-15 16:41:31,chi_roster_turnover_detailed.csv,2025-08-17 08:45:20,32
CHI,2023,2024,DL,9,9,2,7,7,22.22,77.78,77.78,0,2025-08-15 16:41:31,chi_roster_turnover_detailed.csv,2025-08-17 08:45:20,32
CHI,2023,2024,LB,7,5,3,4,2,42.86,57.14,40.0,-2,2025-08-15 16:41:31,chi_roster_turnover_detailed.csv,2025-08-17 08:45:20,32
CHI,2023,2024,OL,10,9,3,7,6,30.0,70.0,66.67,-1,2025-08-15 16:41:31,chi_roster_turnover_detailed.csv,2025-08-17 08:45:20,32
CHI,2023,2024,OTHER,2,11,0,2,11,0.0,100.0,100.0,9,2025-08-15 16:41:31,chi_roster_turnover_detailed.csv,2025-08-17 08:45:20,32
CHI,2023,2024,QB,3,2,1,2,1,33.33,66.67,50.0,-1,2025-08-15 16:41:31,chi_roster_turnover_detailed.csv,2025-08-17 08:45:20,32
CHI,2023,2024,RB,6,6,5,1,1,83.33,16.67,16.67,0,2025-08-15 16:41:31,chi_roster_turnover_detailed.csv,2025-08-17 08:45:20,32
CHI,2023,2024,ST,3,3,1,2,2,33.33,66.67,66.67,0,2025-08-15 16:41:31,chi_roster_turnover_detailed.csv,2025-08-17 08:45:20,32
CHI,2023,2024,TE,4,3,2,2,1,50.0,50.0,33.33,-1,2025-08-15 16:41:31,chi_roster_turnover_detailed.csv,2025-08-17 08:45:20,32
CHI,2023,2024,WR,8,7,4,4,3,50.0,50.0,42.86,-1,2025-08-15 16:41:31,chi_roster_turnover_detailed.csv,2025-08-17 08:45:20,32
CIN,2011,2012,DB,10,10,4,6,6,40.0,60.0,60.0,0,2025-08-15 16:41:26,cin_roster_turnover_detailed.csv,2025-08-17 08:45:20,32
CIN,2011,2012,DL,4,6,2,2,4,50.0,50.0,66.67,2,2025-08-15 16:41:26,cin_roster_turnover_detailed.csv,2025-08-17 08:45:20,32
CIN,2011,2012,LB,4,7,3,1,4,75.0,25.0,57.14,3,2025-08-15 16:41:26,cin_roster_turnover_detailed.csv,2025-08-17 08:45:20,32
CIN,2011,2012,OL,5,5,3,2,2,60.0,40.0,40.0,0,2025-08-15 16:41:26,cin_roster_turnover_detailed.csv,2025-08-17 08:45:20,32
CIN,2011,2012,OTHER,14,12,8,6,4,57.14,42.86,33.33,-2,2025-08-15 16:41:26,cin_roster_turnover_detailed.csv,2025-08-17 08:45:20,32
CIN,2011,2012,QB,2,2,2,0,0,100.0,0.0,0.0,0,2025-08-15 16:41:26,cin_roster_turnover_detailed.csv,2025-08-17 08:45:20,32
CIN,2011,2012,RB,5,7,4,1,3,80.0,20.0,42.86,2,2025-08-15 16:41:26,cin_roster_turnover_detailed.csv,2025-08-17 08:45:20,32
CIN,2011,2012,ST,2,3,2,0,1,100.0,0.0,33.33,1,2025-08-15 16:41:26,cin_roster_turnover_detailed.csv,2025-08-17 08:45:20,32
CIN,2011,2012,TE,4,3,2,2,1,50.0,50.0,33.33,-1,2025-08-15 16:41:26,cin_roster_turnover_detailed.csv,2025-08-17 08:45:20,32
CIN,2011,2012,WR,7,7,4,3,3,57.14,42.86,42.86,0,2025-08-15 16:41:26,cin_roster_turnover_detailed.csv,2025-08-17 08:45:20,32
CIN,2012,2013,DB,10,12,7,3,5,70.0,30.0,41.67,2,2025-08-15 16:41:26,cin_roster_turnover_detailed.csv,2025-08-17 08:45:20,32
CIN,2012,2013,DL,6,5,2,4,3,33.33,66.67,60.0,-1,2025-08-15 16:41:26,cin_roster_turnover_detailed.csv,2025-08-17 08:45:20,32
CIN,2012,2013,LB,7,5,2,5,3,28.57,71.43,60.0,-2,2025-08-15 16:41:26,cin_roster_turnover_detailed.csv,2025-08-17 08:45:20,32
CIN,2012,2013,OL,5,4,3,2,1,60.0,40.0,25.0,-1,2025-08-15 16:41:26,cin_roster_turnover_detailed.csv,2025-08-17 08:45:20,32
CIN,2012,2013,OTHER,12,16,10,2,6,83.33,16.67,37.5,4,2025-08-15 16:41:26,cin_roster_turnover_detailed.csv,2025-08-17 08:45:20,32
CIN,2012,2013,QB,2,2,1,1,1,50.0,50.0,50.0,0,2025-08-15 16:41:26,cin_roster_turnover_detailed.csv,2025-08-17 08:45:20,32
CIN,2012,2013,RB,7,4,2,5,2,28.57,71.43,50.0,-3,2025-08-15 16:41:26,cin_roster_turnover_detailed.csv,2025-08-17 08:45:20,32
CIN,2012,2013,ST,3,4,2,1,2,66.67,33.33,50.0,1,2025-08-15 16:41:26,cin_roster_turnover_detailed.csv,2025-08-17 08:45:20,32
CIN,2012,2013,TE,3,6,3,0,3,100.0,0.0,50.0,3,2025-08-15 16:41:26,cin_roster_turnover_detailed.csv,2025-08-17 08:45:20,32
CIN,2012,2013,WR,7,7,6,1,1,85.71,14.29,14.29,0,2025-08-15 16:41:26,cin_roster_turnover_detailed.csv,2025-08-17 08:45:20,32
CIN,2013,2014,DB,12,8,6,6,2,50.0,50.0,25.0,-4,2025-08-15 16:41:26,cin_roster_turnover_detailed.csv,2025-08-17 08:45:20,32
CIN,2013,2014,DL,5,5,3,2,2,60.0,40.0,40.0,0,2025-08-15 16:41:26,cin_roster_turnover_detailed.csv,2025-08-17 08:45:20,32
CIN,2013,2014,LB,5,7,2,3,5,40.0,60.0,71.43,2,2025-08-15 16:41:26,cin_roster_turnover_detailed.csv,2025-08-17 08:45:20,32
CIN,2013,2014,OL,4,4,1,3,3,25.0,75.0,75.0,0,2025-08-15 16:41:26,cin_roster_turnover_detailed.csv,2025-08-17 08:45:20,32
CIN,2013,2014,OTHER,16,15,11,5,4,68.75,31.25,26.67,-1,2025-08-15 16:41:26,cin_roster_turnover_detailed.csv,2025-08-17 08:45:20,32
CIN,2013,2014,QB,2,2,1,1,1,50.0,50.0,50.0,0,2025-08-15 16:41:26,cin_roster_turnover_detailed.csv,2025-08-17 08:45:20,32
CIN,2013,2014,RB,4,5,3,1,2,75.0,25.0,40.0,1,2025-08-15 16:41:26,cin_roster_turnover_detailed.csv,2025-08-17 08:45:20,32
CIN,2013,2014,ST,4,2,2,2,0,50.0,50.0,0.0,-2,2025-08-15 16:41:26,cin_roster_turnover_detailed.csv,2025-08-17 08:45:20,32
CIN,2013,2014,TE,6,6,5,1,1,83.33,16.67,16.67,0,2025-08-15 16:41:26,cin_roster_turnover_detailed.csv,2025-08-17 08:45:20,32
CIN,2013,2014,WR,7,7,4,3,3,57.14,42.86,42.86,0,2025-08-15 16:41:26,cin_roster_turnover_detailed.csv,2025-08-17 08:45:20,32
CIN,2014,2015,DB,8,9,5,3,4,62.5,37.5,44.44,1,2025-08-15 16:41:26,cin_roster_turnover_detailed.csv,2025-08-17 08:45:20,32
CIN,2014,2015,DL,5,5,3,2,2,60.0,40.0,40.0,0,2025-08-15 16:41:26,cin_roster_turnover_detailed.csv,2025-08-17 08:45:20,32
CIN,2014,2015,LB,7,5,2,5,3,28.57,71.43,60.0,-2,2025-08-15 16:41:26,cin_roster_turnover_detailed.csv,2025-08-17 08:45:20,32
CIN,2014,2015,OL,4,5,3,1,2,75.0,25.0,40.0,1,2025-08-15 16:41:26,cin_roster_turnover_detailed.csv,2025-08-17 08:45:20,32
CIN,2014,2015,OTHER,15,13,9,6,4,60.0,40.0,30.77,-2,2025-08-15 16:41:26,cin_roster_turnover_detailed.csv,2025-08-17 08:45:20,32
CIN,2014,2015,QB,2,2,1,1,1,50.0,50.0,50.0,0,2025-08-15 16:41:26,cin_roster_turnover_detailed.csv,2025-08-17 08:45:20,32
CIN,2014,2015,RB,5,4,4,1,0,80.0,20.0,0.0,-1,2025-08-15 16:41:26,cin_roster_turnover_detailed.csv,2025-08-17 08:45:20,32
CIN,2014,2015,ST,2,2,2,0,0,100.0,0.0,0.0,0,2025-08-15 16:41:26,cin_roster_turnover_detailed.csv,2025-08-17 08:45:20,32
CIN,2014,2015,TE,6,5,3,3,2,50.0,50.0,40.0,-1,2025-08-15 16:41:26,cin_roster_turnover_detailed.csv,2025-08-17 08:45:20,32
CIN,2014,2015,WR,7,5,3,4,2,42.86,57.14,40.0,-2,2025-08-15 16:41:26,cin_roster_turnover_detailed.csv,2025-08-17 08:45:20,32
CIN,2015,2016,DB,9,9,6,3,3,66.67,33.33,33.33,0,2025-08-15 16:41:26,cin_roster_turnover_detailed.csv,2025-08-17 08:45:20,32
CIN,2015,2016,DL,5,5,4,1,1,80.0,20.0,20.0,0,2025-08-15 16:41:26,cin_roster_turnover_detailed.csv,2025-08-17 08:45:20,32
CIN,2015,2016,LB,5,5,3,2,2,60.0,40.0,40.0,0,2025-08-15 16:41:26,cin_roster_turnover_detailed.csv,2025-08-17 08:45:20,32
CIN,2015,2016,OL,5,5,4,1,1,80.0,20.0,20.0,0,2025-08-15 16:41:26,cin_roster_turnover_detailed.csv,2025-08-17 08:45:20,32
CIN,2015,2016,OTHER,13,13,11,2,2,84.62,15.38,15.38,0,2025-08-15 16:41:26,cin_roster_turnover_detailed.csv,2025-08-17 08:45:20,32
CIN,2015,2016,QB,2,2,2,0,0,100.0,0.0,0.0,0,2025-08-15 16:41:26,cin_roster_turnover_detailed.csv,2025-08-17 08:45:20,32
CIN,2015,2016,RB,4,4,4,0,0,100.0,0.0,0.0,0,2025-08-15 16:41:26,cin_roster_turnover_detailed.csv,2025-08-17 08:45:20,32
CIN,2015,2016,ST,2,4,2,0,2,100.0,0.0,50.0,2,2025-08-15 16:41:26,cin_roster_turnover_detailed.csv,2025-08-17 08:45:20,32
CIN,2015,2016,TE,5,5,5,0,0,100.0,0.0,0.0,0,2025-08-15 16:41:26,cin_roster_turnover_detailed.csv,2025-08-17 08:45:20,32
CIN,2015,2016,WR,5,6,1,4,5,20.0,80.0,83.33,1,2025-08-15 16:41:26,cin_roster_turnover_detailed.csv,2025-08-17 08:45:20,32
CIN,2016,2017,DB,9,9,7,2,2,77.78,22.22,22.22,0,2025-08-15 16:41:26,cin_roster_turnover_detailed.csv,2025-08-17 08:45:20,32
CIN,2016,2017,DL,5,3,0,5,3,0.0,100.0,100.0,-2,2025-08-15 16:41:26,cin_roster_turnover_detailed.csv,2025-08-17 08:45:20,32
CIN,2016,2017,LB,5,6,0,5,6,0.0,100.0,100.0,1,2025-08-15 16:41:26,cin_roster_turnover_detailed.csv,2025-08-17 08:45:20,32
CIN,2016,2017,OL,5,6,3,2,3,60.0,40.0,50.0,1,2025-08-15 16:41:26,cin_roster_turnover_detailed.csv,2025-08-17 08:45:20,32
CIN,2016,2017,OTHER,13,15,9,4,6,69.23,30.77,40.0,2,2025-08-15 16:41:26,cin_roster_turnover_detailed.csv,2025-08-17 08:45:20,32
CIN,2016,2017,QB,2,2,2,0,0,100.0,0.0,0.0,0,2025-08-15 16:41:26,cin_roster_turnover_detailed.csv,2025-08-17 08:45:20,32
CIN,2016,2017,RB,4,6,2,2,4,50.0,50.0,66.67,2,2025-08-15 16:41:26,cin_roster_turnover_detailed.csv,2025-08-17 08:45:20,32
CIN,2016,2017,ST,4,3,2,2,1,50.0,50.0,33.33,-1,2025-08-15 16:41:26,cin_roster_turnover_detailed.csv,2025-08-17 08:45:20,32
CIN,2016,2017,TE,5,6,5,0,1,100.0,0.0,16.67,1,2025-08-15 16:41:26,cin_roster_turnover_detailed.csv,2025-08-17 08:45:20,32
CIN,2016,2017,WR,6,7,5,1,2,83.33,16.67,28.57,1,2025-08-15 16:41:26,cin_roster_turnover_detailed.csv,2025-08-17 08:45:20,32
CIN,2017,2018,DB,9,8,5,4,3,55.56,44.44,37.5,-1,2025-08-15 16:41:26,cin_roster_turnover_detailed.csv,2025-08-17 08:45:20,32
CIN,2017,2018,DL,3,6,2,1,4,66.67,33.33,66.67,3,2025-08-15 16:41:26,cin_roster_turnover_detailed.csv,2025-08-17 08:45:20,32
CIN,2017,2018,LB,6,8,4,2,4,66.67,33.33,50.0,2,2025-08-15 16:41:26,cin_roster_turnover_detailed.csv,2025-08-17 08:45:20,32
CIN,2017,2018,OL,6,7,1,5,6,16.67,83.33,85.71,1,2025-08-15 16:41:26,cin_roster_turnover_detailed.csv,2025-08-17 08:45:20,32
CIN,2017,2018,OTHER,15,13,8,7,5,53.33,46.67,38.46,-2,2025-08-15 16:41:26,cin_roster_turnover_detailed.csv,2025-08-17 08:45:20,32
CIN,2017,2018,QB,2,2,1,1,1,50.0,50.0,50.0,0,2025-08-15 16:41:26,cin_roster_turnover_detailed.csv,2025-08-17 08:45:20,32
CIN,2017,2018,RB,6,6,3,3,3,50.0,50.0,50.0,0,2025-08-15 16:41:26,cin_roster_turnover_detailed.csv,2025-08-17 08:45:20,32
CIN,2017,2018,ST,3,2,2,1,0,66.67,33.33,0.0,-1,2025-08-15 16:41:26,cin_roster_turnover_detailed.csv,2025-08-17 08:45:20,32
CIN,2017,2018,TE,6,7,4,2,3,66.67,33.33,42.86,1,2025-08-15 16:41:26,cin_roster_turnover_detailed.csv,2025-08-17 08:45:20,32
CIN,2017,2018,WR,7,7,6,1,1,85.71,14.29,14.29,0,2025-08-15 16:41:26,cin_roster_turnover_detailed.csv,2025-08-17 08:45:20,32
CIN,2018,2019,DB,8,9,6,2,3,75.0,25.0,33.33,1,2025-08-15 16:41:26,cin_roster_turnover_detailed.csv,2025-08-17 08:45:20,32
CIN,2018,2019,DL,6,9,2,4,7,33.33,66.67,77.78,3,2025-08-15 16:41:26,cin_roster_turnover_detailed.csv,2025-08-17 08:45:20,32
CIN,2018,2019,LB,8,5,2,6,3,25.0,75.0,60.0,-3,2025-08-15 16:41:26,cin_roster_turnover_detailed.csv,2025-08-17 08:45:20,32
CIN,2018,2019,OL,7,4,1,6,3,14.29,85.71,75.0,-3,2025-08-15 16:41:26,cin_roster_turnover_detailed.csv,2025-08-17 08:45:20,32
CIN,2018,2019,OTHER,13,15,6,7,9,46.15,53.85,60.0,2,2025-08-15 16:41:26,cin_roster_turnover_detailed.csv,2025-08-17 08:45:20,32
CIN,2018,2019,QB,2,2,1,1,1,50.0,50.0,50.0,0,2025-08-15 16:41:26,cin_roster_turnover_detailed.csv,2025-08-17 08:45:20,32
CIN,2018,2019,RB,6,5,3,3,2,50.0,50.0,40.0,-1,2025-08-15 16:41:26,cin_roster_turnover_detailed.csv,2025-08-17 08:45:20,32
CIN,2018,2019,ST,2,2,2,0,0,100.0,0.0,0.0,0,2025-08-15 16:41:26,cin_roster_turnover_detailed.csv,2025-08-17 08:45:20,32
CIN,2018,2019,TE,7,6,4,3,2,57.14,42.86,33.33,-1,2025-08-15 16:41:26,cin_roster_turnover_detailed.csv,2025-08-17 08:45:20,32
CIN,2018,2019,WR,7,8,4,3,4,57.14,42.86,50.0,1,2025-08-15 16:41:26,cin_roster_turnover_detailed.csv,2025-08-17 08:45:20,32
CIN,2019,2020,DB,9,6,3,6,3,33.33,66.67,50.0,-3,2025-08-15 16:41:26,cin_roster_turnover_detailed.csv,2025-08-17 08:45:20,32
CIN,2019,2020,DL,9,9,3,6,6,33.33,66.67,66.67,0,2025-08-15 16:41:26,cin_roster_turnover_detailed.csv,2025-08-17 08:45:20,32
CIN,2019,2020,LB,5,6,1,4,5,20.0,80.0,83.33,1,2025-08-15 16:41:26,cin_roster_turnover_detailed.csv,2025-08-17 08:45:20,32
CIN,2019,2020,OL,4,5,2,2,3,50.0,50.0,60.0,1,2025-08-15 16:41:26,cin_roster_turnover_detailed.csv,2025-08-17 08:45:20,32
CIN,2019,2020,OTHER,15,18,4,11,14,26.67,73.33,77.78,3,2025-08-15 16:41:26,cin_roster_turnover_detailed.csv,2025-08-17 08:45:20,32
CIN,2019,2020,QB,2,3,1,1,2,50.0,50.0,66.67,1,2025-08-15 16:41:26,cin_roster_turnover_detailed.csv,2025-08-17 08:45:20,32
CIN,2019,2020,RB,5,5,5,0,0,100.0,0.0,0.0,0,2025-08-15 16:41:26,cin_roster_turnover_detailed.csv,2025-08-17 08:45:20,32
CIN,2019,2020,ST,2,3,2,0,1,100.0,0.0,33.33,1,2025-08-15 16:41:26,cin_roster_turnover_detailed.csv,2025-08-17 08:45:20,32
CIN,2019,2020,TE,6,5,5,1,0,83.33,16.67,0.0,-1,2025-08-15 16:41:26,cin_roster_turnover_detailed.csv,2025-08-17 08:45:20,32
CIN,2019,2020,WR,8,9,6,2,3,75.0,25.0,33.33,1,2025-08-15 16:41:26,cin_roster_turnover_detailed.csv,2025-08-17 08:45:20,32
CIN,2020,2021,DB,6,13,4,2,9,66.67,33.33,69.23,7,2025-08-15 16:41:26,cin_roster_turnover_detailed.csv,2025-08-17 08:45:20,32
CIN,2020,2021,DL,9,9,1,8,8,11.11,88.89,88.89,0,2025-08-15 16:41:26,cin_roster_turnover_detailed.csv,2025-08-17 08:45:20,32
CIN,2020,2021,LB,6,11,5,1,6,83.33,16.67,54.55,5,2025-08-15 16:41:26,cin_roster_turnover_detailed.csv,2025-08-17 08:45:20,32
CIN,2020,2021,OL,5,7,2,3,5,40.0,60.0,71.43,2,2025-08-15 16:41:26,cin_roster_turnover_detailed.csv,2025-08-17 08:45:20,32
CIN,2020,2021,OTHER,18,12,5,13,7,27.78,72.22,58.33,-6,2025-08-15 16:41:26,cin_roster_turnover_detailed.csv,2025-08-17 08:45:20,32
CIN,2020,2021,QB,3,2,2,1,0,66.67,33.33,0.0,-1,2025-08-15 16:41:26,cin_roster_turnover_detailed.csv,2025-08-17 08:45:20,32
CIN,2020,2021,RB,5,6,4,1,2,80.0,20.0,33.33,1,2025-08-15 16:41:26,cin_roster_turnover_detailed.csv,2025-08-17 08:45:20,32
CIN,2020,2021,ST,3,3,1,2,2,33.33,66.67,66.67,0,2025-08-15 16:41:26,cin_roster_turnover_detailed.csv,2025-08-17 08:45:20,32
CIN,2020,2021,TE,5,5,4,1,1,80.0,20.0,20.0,0,2025-08-15 16:41:26,cin_roster_turnover_detailed.csv,2025-08-17 08:45:20,32
CIN,2020,2021,WR,9,8,6,3,2,66.67,33.33,25.0,-1,2025-08-15 16:41:26,cin_roster_turnover_detailed.csv,2025-08-17 08:45:20,32
CIN,2021,2022,DB,13,8,6,7,2,46.15,53.85,25.0,-5,2025-08-15 16:41:26,cin_roster_turnover_detailed.csv,2025-08-17 08:45:20,32
CIN,2021,2022,DL,9,6,2,7,4,22.22,77.78,66.67,-3,2025-08-15 16:41:26,cin_roster_turnover_detailed.csv,2025-08-17 08:45:20,32
CIN,2021,2022,LB,11,6,6,5,0,54.55,45.45,0.0,-5,2025-08-15 16:41:26,cin_roster_turnover_detailed.csv,2025-08-17 08:45:20,32
CIN,2021,2022,OL,7,6,2,5,4,28.57,71.43,66.67,-1,2025-08-15 16:41:26,cin_roster_turnover_detailed.csv,2025-08-17 08:45:20,32
CIN,2021,2022,OTHER,12,14,7,5,7,58.33,41.67,50.0,2,2025-08-15 16:41:26,cin_roster_turnover_detailed.csv,2025-08-17 08:45:20,32
CIN,2021,2022,QB,2,2,2,0,0,100.0,0.0,0.0,0,2025-08-15 16:41:26,cin_roster_turnover_detailed.csv,2025-08-17 08:45:20,32
CIN,2021,2022,RB,6,4,4,2,0,66.67,33.33,0.0,-2,2025-08-15 16:41:26,cin_roster_turnover_detailed.csv,2025-08-17 08:45:20,32
CIN,2021,2022,ST,3,5,2,1,3,66.67,33.33,60.0,2,2025-08-15 16:41:26,cin_roster_turnover_detailed.csv,2025-08-17 08:45:20,32
CIN,2021,2022,TE,5,4,2,3,2,40.0,60.0,50.0,-1,2025-08-15 16:41:26,cin_roster_turnover_detailed.csv,2025-08-17 08:45:20,32
CIN,2021,2022,WR,8,8,7,1,1,87.5,12.5,12.5,0,2025-08-15 16:41:26,cin_roster_turnover_detailed.csv,2025-08-17 08:45:20,32
CIN,2022,2023,DB,8,10,3,5,7,37.5,62.5,70.0,2,2025-08-15 16:41:26,cin_roster_turnover_detailed.csv,2025-08-17 08:45:20,32
CIN,2022,2023,DL,6,10,3,3,7,50.0,50.0,70.0,4,2025-08-15 16:41:26,cin_roster_turnover_detailed.csv,2025-08-17 08:45:20,32
CIN,2022,2023,LB,6,6,4,2,2,66.67,33.33,33.33,0,2025-08-15 16:41:26,cin_roster_turnover_detailed.csv,2025-08-17 08:45:20,32
CIN,2022,2023,OL,6,8,3,3,5,50.0,50.0,62.5,2,2025-08-15 16:41:26,cin_roster_turnover_detailed.csv,2025-08-17 08:45:20,32
CIN,2022,2023,OTHER,14,1,1,13,0,7.14,92.86,0.0,-13,2025-08-15 16:41:26,cin_roster_turnover_detailed.csv,2025-08-17 08:45:20,32
CIN,2022,2023,QB,2,3,1,1,2,50.0,50.0,66.67,1,2025-08-15 16:41:26,cin_roster_turnover_detailed.csv,2025-08-17 08:45:20,32
CIN,2022,2023,RB,4,4,3,1,1,75.0,25.0,25.0,0,2025-08-15 16:41:26,cin_roster_turnover_detailed.csv,2025-08-17 08:45:20,32
CIN,2022,2023,ST,5,3,2,3,1,40.0,60.0,33.33,-2,2025-08-15 16:41:26,cin_roster_turnover_detailed.csv,2025-08-17 08:45:20,32
CIN,2022,2023,TE,4,4,2,2,2,50.0,50.0,50.0,0,2025-08-15 16:41:26,cin_roster_turnover_detailed.csv,2025-08-17 08:45:20,32
CIN,2022,2023,WR,8,9,6,2,3,75.0,25.0,33.33,1,2025-08-15 16:41:26,cin_roster_turnover_detailed.csv,2025-08-17 08:45:20,32
CIN,2023,2024,DB,10,11,7,3,4,70.0,30.0,36.36,1,2025-08-15 16:41:26,cin_roster_turnover_detailed.csv,2025-08-17 08:45:20,32
CIN,2023,2024,DL,10,9,4,6,5,40.0,60.0,55.56,-1,2025-08-15 16:41:26,cin_roster_turnover_detailed.csv,2025-08-17 08:45:20,32
CIN,2023,2024,LB,6,4,2,4,2,33.33,66.67,50.0,-2,2025-08-15 16:41:26,cin_roster_turnover_detailed.csv,2025-08-17 08:45:20,32
CIN,2023,2024,OL,8,8,2,6,6,25.0,75.0,75.0,0,2025-08-15 16:41:26,cin_roster_turnover_detailed.csv,2025-08-17 08:45:20,32
CIN,2023,2024,OTHER,1,12,0,1,12,0.0,100.0,100.0,11,2025-08-15 16:41:26,cin_roster_turnover_detailed.csv,2025-08-17 08:45:20,32
CIN,2023,2024,QB,3,2,2,1,0,66.67,33.33,0.0,-1,2025-08-15 16:41:26,cin_roster_turnover_detailed.csv,2025-08-17 08:45:20,32
CIN,2023,2024,RB,4,5,2,2,3,50.0,50.0,60.0,1,2025-08-15 16:41:26,cin_roster_turnover_detailed.csv,2025-08-17 08:45:20,32
CIN,2023,2024,ST,3,4,2,1,2,66.67,33.33,50.0,1,2025-08-15 16:41:26,cin_roster_turnover_detailed.csv,2025-08-17 08:45:20,32
CIN,2023,2024,TE,4,6,2,2,4,50.0,50.0,66.67,2,2025-08-15 16:41:26,cin_roster_turnover_detailed.csv,2025-08-17 08:45:20,32
CIN,2023,2024,WR,9,8,5,4,3,55.56,44.44,37.5,-1,2025-08-15 16:41:26,cin_roster_turnover_detailed.csv,2025-08-17 08:45:20,32
CLE,2011,2012,DB,8,10,6,2,4,75.0,25.0,40.0,2,2025-08-15 16:41:29,cle_roster_turnover_detailed.csv,2025-08-17 08:45:20,32
CLE,2011,2012,DL,7,6,2,5,4,28.57,71.43,66.67,-1,2025-08-15 16:41:29,cle_roster_turnover_detailed.csv,2025-08-17 08:45:20,32
CLE,2011,2012,LB,5,5,1,4,4,20.0,80.0,80.0,0,2025-08-15 16:41:29,cle_roster_turnover_detailed.csv,2025-08-17 08:45:20,32
CLE,2011,2012,OL,5,3,2,3,1,40.0,60.0,33.33,-2,2025-08-15 16:41:29,cle_roster_turnover_detailed.csv,2025-08-17 08:45:20,32
CLE,2011,2012,OTHER,13,14,9,4,5,69.23,30.77,35.71,1,2025-08-15 16:41:29,cle_roster_turnover_detailed.csv,2025-08-17 08:45:20,32
CLE,2011,2012,QB,2,4,1,1,3,50.0,50.0,75.0,2,2025-08-15 16:41:29,cle_roster_turnover_detailed.csv,2025-08-17 08:45:20,32
CLE,2011,2012,RB,7,5,3,4,2,42.86,57.14,40.0,-2,2025-08-15 16:41:29,cle_roster_turnover_detailed.csv,2025-08-17 08:45:20,32
CLE,2011,2012,ST,5,3,2,3,1,40.0,60.0,33.33,-2,2025-08-15 16:41:29,cle_roster_turnover_detailed.csv,2025-08-17 08:45:20,32
CLE,2011,2012,TE,5,4,3,2,1,60.0,40.0,25.0,-1,2025-08-15 16:41:29,cle_roster_turnover_detailed.csv,2025-08-17 08:45:20,32
CLE,2011,2012,WR,6,7,4,2,3,66.67,33.33,42.86,1,2025-08-15 16:41:29,cle_roster_turnover_detailed.csv,2025-08-17 08:45:20,32
CLE,2012,2013,DB,10,9,3,7,6,30.0,70.0,66.67,-1,2025-08-15 16:41:29,cle_roster_turnover_detailed.csv,2025-08-17 08:45:20,32
CLE,2012,2013,DL,6,7,3,3,4,50.0,50.0,57.14,1,2025-08-15 16:41:29,cle_roster_turnover_detailed.csv,2025-08-17 08:45:20,32
CLE,2012,2013,LB,5,5,1,4,4,20.0,80.0,80.0,0,2025-08-15 16:41:29,cle_roster_turnover_detailed.csv,2025-08-17 08:45:20,32
CLE,2012,2013,OL,3,6,2,1,4,66.67,33.33,66.67,3,2025-08-15 16:41:29,cle_roster_turnover_detailed.csv,2025-08-17 08:45:20,32
CLE,2012,2013,OTHER,14,12,7,7,5,50.0,50.0,41.67,-2,2025-08-15 16:41:29,cle_roster_turnover_detailed.csv,2025-08-17 08:45:20,32
CLE,2012,2013,QB,4,4,1,3,3,25.0,75.0,75.0,0,2025-08-15 16:41:29,cle_roster_turnover_detailed.csv,2025-08-17 08:45:20,32
CLE,2012,2013,RB,5,6,2,3,4,40.0,60.0,66.67,1,2025-08-15 16:41:29,cle_roster_turnover_detailed.csv,2025-08-17 08:45:20,32
CLE,2012,2013,ST,3,3,1,2,2,33.33,66.67,66.67,0,2025-08-15 16:41:29,cle_roster_turnover_detailed.csv,2025-08-17 08:45:20,32
CLE,2012,2013,TE,4,5,1,3,4,25.0,75.0,80.0,1,2025-08-15 16:41:29,cle_roster_turnover_detailed.csv,2025-08-17 08:45:20,32
CLE,2012,2013,WR,7,7,4,3,3,57.14,42.86,42.86,0,2025-08-15 16:41:29,cle_roster_turnover_detailed.csv,2025-08-17 08:45:20,32
CLE,2013,2014,DB,9,10,3,6,7,33.33,66.67,70.0,1,2025-08-15 16:41:29,cle_roster_turnover_detailed.csv,2025-08-17 08:45:20,32
CLE,2013,2014,DL,7,9,4,3,5,57.14,42.86,55.56,2,2025-08-15 16:41:29,cle_roster_turnover_detailed.csv,2025-08-17 08:45:20,32
CLE,2013,2014,LB,5,3,2,3,1,40.0,60.0,33.33,-2,2025-08-15 16:41:29,cle_roster_turnover_detailed.csv,2025-08-17 08:45:20,32
CLE,2013,2014,OL,6,5,1,5,4,16.67,83.33,80.0,-1,2025-08-15 16:41:29,cle_roster_turnover_detailed.csv,2025-08-17 08:45:20,32
CLE,2013,2014,OTHER,12,14,9,3,5,75.0,25.0,35.71,2,2025-08-15 16:41:29,cle_roster_turnover_detailed.csv,2025-08-17 08:45:20,32
CLE,2013,2014,QB,4,3,1,3,2,25.0,75.0,66.67,-1,2025-08-15 16:41:29,cle_roster_turnover_detailed.csv,2025-08-17 08:45:20,32
CLE,2013,2014,RB,6,7,0,6,7,0.0,100.0,100.0,1,2025-08-15 16:41:29,cle_roster_turnover_detailed.csv,2025-08-17 08:45:20,32
CLE,2013,2014,ST,3,4,3,0,1,100.0,0.0,25.0,1,2025-08-15 16:41:29,cle_roster_turnover_detailed.csv,2025-08-17 08:45:20,32
CLE,2013,2014,TE,5,4,2,3,2,40.0,60.0,50.0,-1,2025-08-15 16:41:29,cle_roster_turnover_detailed.csv,2025-08-17 08:45:20,32
CLE,2013,2014,WR,7,9,2,5,7,28.57,71.43,77.78,2,2025-08-15 16:41:29,cle_roster_turnover_detailed.csv,2025-08-17 08:45:20,32
CLE,2014,2015,DB,10,10,6,4,4,60.0,40.0,40.0,0,2025-08-15 16:41:29,cle_roster_turnover_detailed.csv,2025-08-17 08:45:20,32
CLE,2014,2015,DL,9,7,4,5,3,44.44,55.56,42.86,-2,2025-08-15 16:41:29,cle_roster_turnover_detailed.csv,2025-08-17 08:45:20,32
CLE,2014,2015,LB,3,3,1,2,2,33.33,66.67,66.67,0,2025-08-15 16:41:29,cle_roster_turnover_detailed.csv,2025-08-17 08:45:20,32
CLE,2014,2015,OL,5,4,1,4,3,20.0,80.0,75.0,-1,2025-08-15 16:41:29,cle_roster_turnover_detailed.csv,2025-08-17 08:45:20,32
CLE,2014,2015,OTHER,14,14,10,4,4,71.43,28.57,28.57,0,2025-08-15 16:41:29,cle_roster_turnover_detailed.csv,2025-08-17 08:45:20,32
CLE,2014,2015,QB,3,3,1,2,2,33.33,66.67,66.67,0,2025-08-15 16:41:29,cle_roster_turnover_detailed.csv,2025-08-17 08:45:20,32
CLE,2014,2015,RB,7,7,3,4,4,42.86,57.14,57.14,0,2025-08-15 16:41:29,cle_roster_turnover_detailed.csv,2025-08-17 08:45:20,32
CLE,2014,2015,ST,4,3,0,4,3,0.0,100.0,100.0,-1,2025-08-15 16:41:29,cle_roster_turnover_detailed.csv,2025-08-17 08:45:20,32
CLE,2014,2015,TE,4,4,2,2,2,50.0,50.0,50.0,0,2025-08-15 16:41:29,cle_roster_turnover_detailed.csv,2025-08-17 08:45:20,32
CLE,2014,2015,WR,9,9,4,5,5,44.44,55.56,55.56,0,2025-08-15 16:41:29,cle_roster_turnover_detailed.csv,2025-08-17 08:45:20,32
CLE,2015,2016,DB,10,9,3,7,6,30.0,70.0,66.67,-1,2025-08-15 16:41:29,cle_roster_turnover_detailed.csv,2025-08-17 08:45:20,32
CLE,2015,2016,DL,7,9,3,4,6,42.86,57.14,66.67,2,2025-08-15 16:41:29,cle_roster_turnover_detailed.csv,2025-08-17 08:45:20,32
CLE,2015,2016,LB,3,3,1,2,2,33.33,66.67,66.67,0,2025-08-15 16:41:29,cle_roster_turnover_detailed.csv,2025-08-17 08:45:20,32
CLE,2015,2016,OL,4,5,1,3,4,25.0,75.0,80.0,1,2025-08-15 16:41:29,cle_roster_turnover_detailed.csv,2025-08-17 08:45:20,32
CLE,2015,2016,OTHER,14,15,6,8,9,42.86,57.14,60.0,1,2025-08-15 16:41:29,cle_roster_turnover_detailed.csv,2025-08-17 08:45:20,32
CLE,2015,2016,QB,3,5,1,2,4,33.33,66.67,80.0,2,2025-08-15 16:41:29,cle_roster_turnover_detailed.csv,2025-08-17 08:45:20,32
CLE,2015,2016,RB,7,4,2,5,2,28.57,71.43,50.0,-3,2025-08-15 16:41:29,cle_roster_turnover_detailed.csv,2025-08-17 08:45:20,32
CLE,2015,2016,ST,3,4,1,2,3,33.33,66.67,75.0,1,2025-08-15 16:41:29,cle_roster_turnover_detailed.csv,2025-08-17 08:45:20,32
CLE,2015,2016,TE,4,5,1,3,4,25.0,75.0,80.0,1,2025-08-15 16:41:29,cle_roster_turnover_detailed.csv,2025-08-17 08:45:20,32
CLE,2015,2016,WR,9,7,2,7,5,22.22,77.78,71.43,-2,2025-08-15 16:41:29,cle_roster_turnover_detailed.csv,2025-08-17 08:45:20,32
CLE,2016,2017,DB,9,11,3,6,8,33.33,66.67,72.73,2,2025-08-15 16:41:29,cle_roster_turnover_detailed.csv,2025-08-17 08:45:20,32
CLE,2016,2017,DL,9,7,2,7,5,22.22,77.78,71.43,-2,2025-08-15 16:41:29,cle_roster_turnover_detailed.csv,2025-08-17 08:45:20,32
CLE,2016,2017,LB,3,5,2,1,3,66.67,33.33,60.0,2,2025-08-15 16:41:29,cle_roster_turnover_detailed.csv,2025-08-17 08:45:20,32
CLE,2016,2017,OL,5,3,1,4,2,20.0,80.0,66.67,-2,2025-08-15 16:41:29,cle_roster_turnover_detailed.csv,2025-08-17 08:45:20,32
CLE,2016,2017,OTHER,15,15,7,8,8,46.67,53.33,53.33,0,2025-08-15 16:41:29,cle_roster_turnover_detailed.csv,2025-08-17 08:45:20,32
CLE,2016,2017,QB,5,3,2,3,1,40.0,60.0,33.33,-2,2025-08-15 16:41:29,cle_roster_turnover_detailed.csv,2025-08-17 08:45:20,32
CLE,2016,2017,RB,4,5,3,1,2,75.0,25.0,40.0,1,2025-08-15 16:41:29,cle_roster_turnover_detailed.csv,2025-08-17 08:45:20,32
CLE,2016,2017,ST,4,3,2,2,1,50.0,50.0,33.33,-1,2025-08-15 16:41:29,cle_roster_turnover_detailed.csv,2025-08-17 08:45:20,32
CLE,2016,2017,TE,5,4,2,3,2,40.0,60.0,50.0,-1,2025-08-15 16:41:29,cle_roster_turnover_detailed.csv,2025-08-17 08:45:20,32
CLE,2016,2017,WR,7,9,3,4,6,42.86,57.14,66.67,2,2025-08-15 16:41:29,cle_roster_turnover_detailed.csv,2025-08-17 08:45:20,32
CLE,2017,2018,DB,11,12,3,8,9,27.27,72.73,75.0,1,2025-08-15 16:41:29,cle_roster_turnover_detailed.csv,2025-08-17 08:45:20,32
CLE,2017,2018,DL,7,6,0,7,6,0.0,100.0,100.0,-1,2025-08-15 16:41:29,cle_roster_turnover_detailed.csv,2025-08-17 08:45:20,32
CLE,2017,2018,LB,5,5,1,4,4,20.0,80.0,80.0,0,2025-08-15 16:41:29,cle_roster_turnover_detailed.csv,2025-08-17 08:45:20,32
CLE,2017,2018,OL,3,4,1,2,3,33.33,66.67,75.0,1,2025-08-15 16:41:29,cle_roster_turnover_detailed.csv,2025-08-17 08:45:20,32
CLE,2017,2018,OTHER,15,15,7,8,8,46.67,53.33,53.33,0,2025-08-15 16:41:29,cle_roster_turnover_detailed.csv,2025-08-17 08:45:20,32
CLE,2017,2018,QB,3,2,0,3,2,0.0,100.0,100.0,-1,2025-08-15 16:41:29,cle_roster_turnover_detailed.csv,2025-08-17 08:45:20,32
CLE,2017,2018,RB,5,4,1,4,3,20.0,80.0,75.0,-1,2025-08-15 16:41:29,cle_roster_turnover_detailed.csv,2025-08-17 08:45:20,32
CLE,2017,2018,ST,3,4,3,0,1,100.0,0.0,25.0,1,2025-08-15 16:41:29,cle_roster_turnover_detailed.csv,2025-08-17 08:45:20,32
CLE,2017,2018,TE,4,4,2,2,2,50.0,50.0,50.0,0,2025-08-15 16:41:29,cle_roster_turnover_detailed.csv,2025-08-17 08:45:20,32
CLE,2017,2018,WR,9,8,2,7,6,22.22,77.78,75.0,-1,2025-08-15 16:41:29,cle_roster_turnover_detailed.csv,2025-08-17 08:45:20,32
CLE,2018,2019,DB,12,9,4,8,5,33.33,66.67,55.56,-3,2025-08-15 16:41:29,cle_roster_turnover_detailed.csv,2025-08-17 08:45:20,32
CLE,2018,2019,DL,6,8,2,4,6,33.33,66.67,75.0,2,2025-08-15 16:41:29,cle_roster_turnover_detailed.csv,2025-08-17 08:45:20,32
CLE,2018,2019,LB,5,10,1,4,9,20.0,80.0,90.0,5,2025-08-15 16:41:29,cle_roster_turnover_detailed.csv,2025-08-17 08:45:20,32
CLE,2018,2019,OL,4,5,2,2,3,50.0,50.0,60.0,1,2025-08-15 16:41:29,cle_roster_turnover_detailed.csv,2025-08-17 08:45:20,32
CLE,2018,2019,OTHER,15,14,7,8,7,46.67,53.33,50.0,-1,2025-08-15 16:41:29,cle_roster_turnover_detailed.csv,2025-08-17 08:45:20,32
CLE,2018,2019,QB,2,2,1,1,1,50.0,50.0,50.0,0,2025-08-15 16:41:29,cle_roster_turnover_detailed.csv,2025-08-17 08:45:20,32
CLE,2018,2019,RB,4,4,2,2,2,50.0,50.0,50.0,0,2025-08-15 16:41:29,cle_roster_turnover_detailed.csv,2025-08-17 08:45:20,32
CLE,2018,2019,ST,4,3,1,3,2,25.0,75.0,66.67,-1,2025-08-15 16:41:29,cle_roster_turnover_detailed.csv,2025-08-17 08:45:20,32
CLE,2018,2019,TE,4,4,1,3,3,25.0,75.0,75.0,0,2025-08-15 16:41:29,cle_roster_turnover_detailed.csv,2025-08-17 08:45:20,32
CLE,2018,2019,WR,8,8,4,4,4,50.0,50.0,50.0,0,2025-08-15 16:41:29,cle_roster_turnover_detailed.csv,2025-08-17 08:45:20,32
CLE,2019,2020,DB,9,11,3,6,8,33.33,66.67,72.73,2,2025-08-15 16:41:29,cle_roster_turnover_detailed.csv,2025-08-17 08:45:20,32
CLE,2019,2020,DL,8,6,1,7,5,12.5,87.5,83.33,-2,2025-08-15 16:41:29,cle_roster_turnover_detailed.csv,2025-08-17 08:45:20,32
CLE,2019,2020,LB,10,5,1,9,4,10.0,90.0,80.0,-5,2025-08-15 16:41:29,cle_roster_turnover_detailed.csv,2025-08-17 08:45:20,32
CLE,2019,2020,OL,5,9,2,3,7,40.0,60.0,77.78,4,2025-08-15 16:41:29,cle_roster_turnover_detailed.csv,2025-08-17 08:45:20,32
CLE,2019,2020,OTHER,14,14,9,5,5,64.29,35.71,35.71,0,2025-08-15 16:41:29,cle_roster_turnover_detailed.csv,2025-08-17 08:45:20,32
CLE,2019,2020,QB,2,2,1,1,1,50.0,50.0,50.0,0,2025-08-15 16:41:29,cle_roster_turnover_detailed.csv,2025-08-17 08:45:20,32
CLE,2019,2020,RB,4,6,4,0,2,100.0,0.0,33.33,2,2025-08-15 16:41:29,cle_roster_turnover_detailed.csv,2025-08-17 08:45:20,32
CLE,2019,2020,ST,3,4,3,0,1,100.0,0.0,25.0,1,2025-08-15 16:41:29,cle_roster_turnover_detailed.csv,2025-08-17 08:45:20,32
CLE,2019,2020,TE,4,4,2,2,2,50.0,50.0,50.0,0,2025-08-15 16:41:29,cle_roster_turnover_detailed.csv,2025-08-17 08:45:20,32
CLE,2019,2020,WR,8,10,5,3,5,62.5,37.5,50.0,2,2025-08-15 16:41:29,cle_roster_turnover_detailed.csv,2025-08-17 08:45:20,32
CLE,2020,2021,DB,11,13,4,7,9,36.36,63.64,69.23,2,2025-08-15 16:41:29,cle_roster_turnover_detailed.csv,2025-08-17 08:45:20,32
CLE,2020,2021,DL,6,9,3,3,6,50.0,50.0,66.67,3,2025-08-15 16:41:29,cle_roster_turnover_detailed.csv,2025-08-17 08:45:20,32
CLE,2020,2021,LB,5,7,3,2,4,60.0,40.0,57.14,2,2025-08-15 16:41:29,cle_roster_turnover_detailed.csv,2025-08-17 08:45:20,32
CLE,2020,2021,OL,9,7,4,5,3,44.44,55.56,42.86,-2,2025-08-15 16:41:29,cle_roster_turnover_detailed.csv,2025-08-17 08:45:20,32
CLE,2020,2021,OTHER,14,15,8,6,7,57.14,42.86,46.67,1,2025-08-15 16:41:29,cle_roster_turnover_detailed.csv,2025-08-17 08:45:20,32
CLE,2020,2021,QB,2,3,2,0,1,100.0,0.0,33.33,1,2025-08-15 16:41:29,cle_roster_turnover_detailed.csv,2025-08-17 08:45:20,32
CLE,2020,2021,RB,6,6,5,1,1,83.33,16.67,16.67,0,2025-08-15 16:41:29,cle_roster_turnover_detailed.csv,2025-08-17 08:45:20,32
CLE,2020,2021,ST,4,5,2,2,3,50.0,50.0,60.0,1,2025-08-15 16:41:29,cle_roster_turnover_detailed.csv,2025-08-17 08:45:20,32
CLE,2020,2021,TE,4,5,3,1,2,75.0,25.0,40.0,1,2025-08-15 16:41:29,cle_roster_turnover_detailed.csv,2025-08-17 08:45:20,32
CLE,2020,2021,WR,10,9,6,4,3,60.0,40.0,33.33,-1,2025-08-15 16:41:29,cle_roster_turnover_detailed.csv,2025-08-17 08:45:20,32
CLE,2021,2022,DB,13,11,6,7,5,46.15,53.85,45.45,-2,2025-08-15 16:41:29,cle_roster_turnover_detailed.csv,2025-08-17 08:45:20,32
CLE,2021,2022,DL,9,8,1,8,7,11.11,88.89,87.5,-1,2025-08-15 16:41:29,cle_roster_turnover_detailed.csv,2025-08-17 08:45:20,32
CLE,2021,2022,LB,7,11,2,5,9,28.57,71.43,81.82,4,2025-08-15 16:41:29,cle_roster_turnover_detailed.csv,2025-08-17 08:45:20,32
CLE,2021,2022,OL,7,7,4,3,3,57.14,42.86,42.86,0,2025-08-15 16:41:29,cle_roster_turnover_detailed.csv,2025-08-17 08:45:20,32
CLE,2021,2022,OTHER,15,12,9,6,3,60.0,40.0,25.0,-3,2025-08-15 16:41:29,cle_roster_turnover_detailed.csv,2025-08-17 08:45:20,32
CLE,2021,2022,QB,3,2,0,3,2,0.0,100.0,100.0,-1,2025-08-15 16:41:29,cle_roster_turnover_detailed.csv,2025-08-17 08:45:20,32
CLE,2021,2022,RB,6,5,4,2,1,66.67,33.33,20.0,-1,2025-08-15 16:41:29,cle_roster_turnover_detailed.csv,2025-08-17 08:45:20,32
CLE,2021,2022,ST,5,3,1,4,2,20.0,80.0,66.67,-2,2025-08-15 16:41:29,cle_roster_turnover_detailed.csv,2025-08-17 08:45:20,32
CLE,2021,2022,TE,5,5,3,2,2,60.0,40.0,40.0,0,2025-08-15 16:41:29,cle_roster_turnover_detailed.csv,2025-08-17 08:45:20,32
CLE,2021,2022,WR,9,9,3,6,6,33.33,66.67,66.67,0,2025-08-15 16:41:29,cle_roster_turnover_detailed.csv,2025-08-17 08:45:20,32
CLE,2022,2023,DB,11,14,4,7,10,36.36,63.64,71.43,3,2025-08-15 16:41:29,cle_roster_turnover_detailed.csv,2025-08-17 08:45:20,32
CLE,2022,2023,DL,8,11,1,7,10,12.5,87.5,90.91,3,2025-08-15 16:41:29,cle_roster_turnover_detailed.csv,2025-08-17 08:45:20,32
CLE,2022,2023,LB,11,8,2,9,6,18.18,81.82,75.0,-3,2025-08-15 16:41:29,cle_roster_turnover_detailed.csv,2025-08-17 08:45:20,32
CLE,2022,2023,OL,7,13,3,4,10,42.86,57.14,76.92,6,2025-08-15 16:41:29,cle_roster_turnover_detailed.csv,2025-08-17 08:45:20,32
CLE,2022,2023,OTHER,12,1,0,12,1,0.0,100.0,100.0,-11,2025-08-15 16:41:29,cle_roster_turnover_detailed.csv,2025-08-17 08:45:20,32
CLE,2022,2023,QB,2,5,1,1,4,50.0,50.0,80.0,3,2025-08-15 16:41:29,cle_roster_turnover_detailed.csv,2025-08-17 08:45:20,32
CLE,2022,2023,RB,5,6,4,1,2,80.0,20.0,33.33,1,2025-08-15 16:41:29,cle_roster_turnover_detailed.csv,2025-08-17 08:45:20,32
CLE,2022,2023,ST,3,5,2,1,3,66.67,33.33,60.0,2,2025-08-15 16:41:29,cle_roster_turnover_detailed.csv,2025-08-17 08:45:20,32
CLE,2022,2023,TE,5,3,2,3,1,40.0,60.0,33.33,-2,2025-08-15 16:41:29,cle_roster_turnover_detailed.csv,2025-08-17 08:45:20,32
CLE,2022,2023,WR,9,8,4,5,4,44.44,55.56,50.0,-1,2025-08-15 16:41:29,cle_roster_turnover_detailed.csv,2025-08-17 08:45:20,32
CLE,2023,2024,DB,14,13,8,6,5,57.14,42.86,38.46,-1,2025-08-15 16:41:29,cle_roster_turnover_detailed.csv,2025-08-17 08:45:20,32
CLE,2023,2024,DL,11,13,5,6,8,45.45,54.55,61.54,2,2025-08-15 16:41:29,cle_roster_turnover_detailed.csv,2025-08-17 08:45:20,32
CLE,2023,2024,LB,8,6,2,6,4,25.0,75.0,66.67,-2,2025-08-15 16:41:29,cle_roster_turnover_detailed.csv,2025-08-17 08:45:20,32
CLE,2023,2024,OL,13,9,7,6,2,53.85,46.15,22.22,-4,2025-08-15 16:41:29,cle_roster_turnover_detailed.csv,2025-08-17 08:45:20,32
CLE,2023,2024,OTHER,1,12,0,1,12,0.0,100.0,100.0,11,2025-08-15 16:41:29,cle_roster_turnover_detailed.csv,2025-08-17 08:45:20,32
CLE,2023,2024,QB,5,4,2,3,2,40.0,60.0,50.0,-1,2025-08-15 16:41:29,cle_roster_turnover_detailed.csv,2025-08-17 08:45:20,32
CLE,2023,2024,RB,6,6,3,3,3,50.0,50.0,50.0,0,2025-08-15 16:41:29,cle_roster_turnover_detailed.csv,2025-08-17 08:45:20,32
CLE,2023,2024,ST,5,5,4,1,1,80.0,20.0,20.0,0,2025-08-15 16:41:29,cle_roster_turnover_detailed.csv,2025-08-17 08:45:20,32
CLE,2023,2024,TE,3,5,2,1,3,66.67,33.33,60.0,2,2025-08-15 16:41:29,cle_roster_turnover_detailed.csv,2025-08-17 08:45:20,32
CLE,2023,2024,WR,8,11,6,2,5,75.0,25.0,45.45,3,2025-08-15 16:41:29,cle_roster_turnover_detailed.csv,2025-08-17 08:45:20,32
CLT,2011,2012,DB,11,10,2,9,8,18.18,81.82,80.0,-1,2025-08-15 16:41:29,clt_roster_turnover_detailed.csv,2025-08-17 08:45:20,32
CLT,2011,2012,DL,8,8,1,7,7,12.5,87.5,87.5,0,2025-08-15 16:41:29,clt_roster_turnover_detailed.csv,2025-08-17 08:45:20,32
CLT,2011,2012,LB,9,6,1,8,5,11.11,88.89,83.33,-3,2025-08-15 16:41:29,clt_roster_turnover_detailed.csv,2025-08-17 08:45:20,32
CLT,2011,2012,OL,7,6,1,6,5,14.29,85.71,83.33,-1,2025-08-15 16:41:29,clt_roster_turnover_detailed.csv,2025-08-17 08:45:20,32
CLT,2011,2012,OTHER,14,16,8,6,8,57.14,42.86,50.0,2,2025-08-15 16:41:29,clt_roster_turnover_detailed.csv,2025-08-17 08:45:20,32
CLT,2011,2012,QB,3,1,0,3,1,0.0,100.0,100.0,-2,2025-08-15 16:41:29,clt_roster_turnover_detailed.csv,2025-08-17 08:45:20,32
CLT,2011,2012,RB,7,6,2,5,4,28.57,71.43,66.67,-1,2025-08-15 16:41:29,clt_roster_turnover_detailed.csv,2025-08-17 08:45:20,32
CLT,2011,2012,ST,3,3,2,1,1,66.67,33.33,33.33,0,2025-08-15 16:41:29,clt_roster_turnover_detailed.csv,2025-08-17 08:45:20,32
CLT,2011,2012,TE,5,5,0,5,5,0.0,100.0,100.0,0,2025-08-15 16:41:29,clt_roster_turnover_detailed.csv,2025-08-17 08:45:20,32
CLT,2011,2012,WR,5,7,2,3,5,40.0,60.0,71.43,2,2025-08-15 16:41:29,clt_roster_turnover_detailed.csv,2025-08-17 08:45:20,32
CLT,2012,2013,DB,10,10,5,5,5,50.0,50.0,50.0,0,2025-08-15 16:41:29,clt_roster_turnover_detailed.csv,2025-08-17 08:45:20,32
CLT,2012,2013,DL,8,8,1,7,7,12.5,87.5,87.5,0,2025-08-15 16:41:29,clt_roster_turnover_detailed.csv,2025-08-17 08:45:20,32
CLT,2012,2013,LB,6,5,1,5,4,16.67,83.33,80.0,-1,2025-08-15 16:41:29,clt_roster_turnover_detailed.csv,2025-08-17 08:45:20,32
CLT,2012,2013,OL,6,6,1,5,5,16.67,83.33,83.33,0,2025-08-15 16:41:29,clt_roster_turnover_detailed.csv,2025-08-17 08:45:20,32
CLT,2012,2013,OTHER,16,16,8,8,8,50.0,50.0,50.0,0,2025-08-15 16:41:29,clt_roster_turnover_detailed.csv,2025-08-17 08:45:20,32
CLT,2012,2013,QB,1,2,1,0,1,100.0,0.0,50.0,1,2025-08-15 16:41:29,clt_roster_turnover_detailed.csv,2025-08-17 08:45:20,32
CLT,2012,2013,RB,6,10,3,3,7,50.0,50.0,70.0,4,2025-08-15 16:41:29,clt_roster_turnover_detailed.csv,2025-08-17 08:45:20,32
CLT,2012,2013,ST,3,3,3,0,0,100.0,0.0,0.0,0,2025-08-15 16:41:29,clt_roster_turnover_detailed.csv,2025-08-17 08:45:20,32
CLT,2012,2013,TE,5,6,4,1,2,80.0,20.0,33.33,1,2025-08-15 16:41:29,clt_roster_turnover_detailed.csv,2025-08-17 08:45:20,32
CLT,2012,2013,WR,7,7,3,4,4,42.86,57.14,57.14,0,2025-08-15 16:41:29,clt_roster_turnover_detailed.csv,2025-08-17 08:45:20,32
CLT,2013,2014,DB,10,10,4,6,6,40.0,60.0,60.0,0,2025-08-15 16:41:29,clt_roster_turnover_detailed.csv,2025-08-17 08:45:20,32
CLT,2013,2014,DL,8,5,2,6,3,25.0,75.0,60.0,-3,2025-08-15 16:41:29,clt_roster_turnover_detailed.csv,2025-08-17 08:45:20,32
CLT,2013,2014,LB,5,10,3,2,7,60.0,40.0,70.0,5,2025-08-15 16:41:29,clt_roster_turnover_detailed.csv,2025-08-17 08:45:20,32
CLT,2013,2014,OL,6,7,3,3,4,50.0,50.0,57.14,1,2025-08-15 16:41:29,clt_roster_turnover_detailed.csv,2025-08-17 08:45:20,32
CLT,2013,2014,OTHER,16,13,9,7,4,56.25,43.75,30.77,-3,2025-08-15 16:41:29,clt_roster_turnover_detailed.csv,2025-08-17 08:45:20,32
CLT,2013,2014,QB,2,2,2,0,0,100.0,0.0,0.0,0,2025-08-15 16:41:29,clt_roster_turnover_detailed.csv,2025-08-17 08:45:20,32
CLT,2013,2014,RB,10,5,3,7,2,30.0,70.0,40.0,-5,2025-08-15 16:41:29,clt_roster_turnover_detailed.csv,2025-08-17 08:45:20,32
CLT,2013,2014,ST,3,3,3,0,0,100.0,0.0,0.0,0,2025-08-15 16:41:29,clt_roster_turnover_detailed.csv,2025-08-17 08:45:20,32
CLT,2013,2014,TE,6,4,4,2,0,66.67,33.33,0.0,-2,2025-08-15 16:41:29,clt_roster_turnover_detailed.csv,2025-08-17 08:45:20,32
CLT,2013,2014,WR,7,6,3,4,3,42.86,57.14,50.0,-1,2025-08-15 16:41:29,clt_roster_turnover_detailed.csv,2025-08-17 08:45:20,32
CLT,2014,2015,DB,10,16,6,4,10,60.0,40.0,62.5,6,2025-08-15 16:41:29,clt_roster_turnover_detailed.csv,2025-08-17 08:45:20,32
CLT,2014,2015,DL,5,5,1,4,4,20.0,80.0,80.0,0,2025-08-15 16:41:29,clt_roster_turnover_detailed.csv,2025-08-17 08:45:20,32
CLT,2014,2015,LB,10,8,3,7,5,30.0,70.0,62.5,-2,2025-08-15 16:41:29,clt_roster_turnover_detailed.csv,2025-08-17 08:45:20,32
CLT,2014,2015,OL,7,5,2,5,3,28.57,71.43,60.0,-2,2025-08-15 16:41:29,clt_roster_turnover_detailed.csv,2025-08-17 08:45:20,32
CLT,2014,2015,OTHER,13,13,6,7,7,46.15,53.85,53.85,0,2025-08-15 16:41:29,clt_roster_turnover_detailed.csv,2025-08-17 08:45:20,32
CLT,2014,2015,QB,2,5,2,0,3,100.0,0.0,60.0,3,2025-08-15 16:41:29,clt_roster_turnover_detailed.csv,2025-08-17 08:45:20,32
CLT,2014,2015,RB,5,7,3,2,4,60.0,40.0,57.14,2,2025-08-15 16:41:29,clt_roster_turnover_detailed.csv,2025-08-17 08:45:20,32
CLT,2014,2015,ST,3,3,3,0,0,100.0,0.0,0.0,0,2025-08-15 16:41:29,clt_roster_turnover_detailed.csv,2025-08-17 08:45:20,32
CLT,2014,2015,TE,4,4,3,1,1,75.0,25.0,25.0,0,2025-08-15 16:41:29,clt_roster_turnover_detailed.csv,2025-08-17 08:45:20,32
CLT,2014,2015,WR,6,6,3,3,3,50.0,50.0,50.0,0,2025-08-15 16:41:29,clt_roster_turnover_detailed.csv,2025-08-17 08:45:20,32
CLT,2015,2016,DB,16,12,4,12,8,25.0,75.0,66.67,-4,2025-08-15 16:41:29,clt_roster_turnover_detailed.csv,2025-08-17 08:45:20,32
CLT,2015,2016,DL,5,5,2,3,3,40.0,60.0,60.0,0,2025-08-15 16:41:29,clt_roster_turnover_detailed.csv,2025-08-17 08:45:20,32
CLT,2015,2016,LB,8,11,2,6,9,25.0,75.0,81.82,3,2025-08-15 16:41:29,clt_roster_turnover_detailed.csv,2025-08-17 08:45:20,32
CLT,2015,2016,OL,5,5,1,4,4,20.0,80.0,80.0,0,2025-08-15 16:41:29,clt_roster_turnover_detailed.csv,2025-08-17 08:45:20,32
CLT,2015,2016,OTHER,13,15,8,5,7,61.54,38.46,46.67,2,2025-08-15 16:41:29,clt_roster_turnover_detailed.csv,2025-08-17 08:45:20,32
CLT,2015,2016,QB,5,2,1,4,1,20.0,80.0,50.0,-3,2025-08-15 16:41:29,clt_roster_turnover_detailed.csv,2025-08-17 08:45:20,32
CLT,2015,2016,RB,7,4,1,6,3,14.29,85.71,75.0,-3,2025-08-15 16:41:29,clt_roster_turnover_detailed.csv,2025-08-17 08:45:20,32
CLT,2015,2016,ST,3,3,3,0,0,100.0,0.0,0.0,0,2025-08-15 16:41:29,clt_roster_turnover_detailed.csv,2025-08-17 08:45:20,32
CLT,2015,2016,TE,4,4,3,1,1,75.0,25.0,25.0,0,2025-08-15 16:41:29,clt_roster_turnover_detailed.csv,2025-08-17 08:45:20,32
CLT,2015,2016,WR,6,7,4,2,3,66.67,33.33,42.86,1,2025-08-15 16:41:29,clt_roster_turnover_detailed.csv,2025-08-17 08:45:20,32
CLT,2016,2017,DB,12,11,5,7,6,41.67,58.33,54.55,-1,2025-08-15 16:41:29,clt_roster_turnover_detailed.csv,2025-08-17 08:45:20,32
CLT,2016,2017,DL,5,6,0,5,6,0.0,100.0,100.0,1,2025-08-15 16:41:29,clt_roster_turnover_detailed.csv,2025-08-17 08:45:20,32
CLT,2016,2017,LB,11,8,1,10,7,9.09,90.91,87.5,-3,2025-08-15 16:41:29,clt_roster_turnover_detailed.csv,2025-08-17 08:45:20,32
CLT,2016,2017,OL,5,8,1,4,7,20.0,80.0,87.5,3,2025-08-15 16:41:29,clt_roster_turnover_detailed.csv,2025-08-17 08:45:20,32
CLT,2016,2017,OTHER,15,16,5,10,11,33.33,66.67,68.75,1,2025-08-15 16:41:29,clt_roster_turnover_detailed.csv,2025-08-17 08:45:20,32
CLT,2016,2017,QB,2,2,1,1,1,50.0,50.0,50.0,0,2025-08-15 16:41:29,clt_roster_turnover_detailed.csv,2025-08-17 08:45:20,32
CLT,2016,2017,RB,4,5,3,1,2,75.0,25.0,40.0,1,2025-08-15 16:41:29,clt_roster_turnover_detailed.csv,2025-08-17 08:45:20,32
CLT,2016,2017,ST,3,2,1,2,1,33.33,66.67,50.0,-1,2025-08-15 16:41:29,clt_roster_turnover_detailed.csv,2025-08-17 08:45:20,32
CLT,2016,2017,TE,4,4,1,3,3,25.0,75.0,75.0,0,2025-08-15 16:41:29,clt_roster_turnover_detailed.csv,2025-08-17 08:45:20,32
CLT,2016,2017,WR,7,9,4,3,5,57.14,42.86,55.56,2,2025-08-15 16:41:29,clt_roster_turnover_detailed.csv,2025-08-17 08:45:20,32
CLT,2017,2018,DB,11,13,5,6,8,45.45,54.55,61.54,2,2025-08-15 16:41:29,clt_roster_turnover_detailed.csv,2025-08-17 08:45:20,32
CLT,2017,2018,DL,6,6,3,3,3,50.0,50.0,50.0,0,2025-08-15 16:41:29,clt_roster_turnover_detailed.csv,2025-08-17 08:45:20,32
CLT,2017,2018,LB,8,7,2,6,5,25.0,75.0,71.43,-1,2025-08-15 16:41:29,clt_roster_turnover_detailed.csv,2025-08-17 08:45:20,32
CLT,2017,2018,OL,8,7,2,6,5,25.0,75.0,71.43,-1,2025-08-15 16:41:29,clt_roster_turnover_detailed.csv,2025-08-17 08:45:20,32
CLT,2017,2018,OTHER,16,14,4,12,10,25.0,75.0,71.43,-2,2025-08-15 16:41:29,clt_roster_turnover_detailed.csv,2025-08-17 08:45:20,32
CLT,2017,2018,QB,2,2,1,1,1,50.0,50.0,50.0,0,2025-08-15 16:41:29,clt_roster_turnover_detailed.csv,2025-08-17 08:45:20,32
CLT,2017,2018,RB,5,6,2,3,4,40.0,60.0,66.67,1,2025-08-15 16:41:29,clt_roster_turnover_detailed.csv,2025-08-17 08:45:20,32
CLT,2017,2018,ST,2,2,2,0,0,100.0,0.0,0.0,0,2025-08-15 16:41:29,clt_roster_turnover_detailed.csv,2025-08-17 08:45:20,32
CLT,2017,2018,TE,4,5,1,3,4,25.0,75.0,80.0,1,2025-08-15 16:41:29,clt_roster_turnover_detailed.csv,2025-08-17 08:45:20,32
CLT,2017,2018,WR,9,7,2,7,5,22.22,77.78,71.43,-2,2025-08-15 16:41:29,clt_roster_turnover_detailed.csv,2025-08-17 08:45:20,32
CLT,2018,2019,DB,13,10,4,9,6,30.77,69.23,60.0,-3,2025-08-15 16:41:29,clt_roster_turnover_detailed.csv,2025-08-17 08:45:20,32
CLT,2018,2019,DL,6,5,2,4,3,33.33,66.67,60.0,-1,2025-08-15 16:41:29,clt_roster_turnover_detailed.csv,2025-08-17 08:45:20,32
CLT,2018,2019,LB,7,9,5,2,4,71.43,28.57,44.44,2,2025-08-15 16:41:29,clt_roster_turnover_detailed.csv,2025-08-17 08:45:20,32
CLT,2018,2019,OL,7,3,3,4,0,42.86,57.14,0.0,-4,2025-08-15 16:41:29,clt_roster_turnover_detailed.csv,2025-08-17 08:45:20,32
CLT,2018,2019,OTHER,14,14,10,4,4,71.43,28.57,28.57,0,2025-08-15 16:41:29,clt_roster_turnover_detailed.csv,2025-08-17 08:45:20,32
CLT,2018,2019,QB,2,2,1,1,1,50.0,50.0,50.0,0,2025-08-15 16:41:29,clt_roster_turnover_detailed.csv,2025-08-17 08:45:20,32
CLT,2018,2019,RB,6,4,3,3,1,50.0,50.0,25.0,-2,2025-08-15 16:41:29,clt_roster_turnover_detailed.csv,2025-08-17 08:45:20,32
CLT,2018,2019,ST,2,3,2,0,1,100.0,0.0,33.33,1,2025-08-15 16:41:29,clt_roster_turnover_detailed.csv,2025-08-17 08:45:20,32
CLT,2018,2019,TE,5,4,3,2,1,60.0,40.0,25.0,-1,2025-08-15 16:41:29,clt_roster_turnover_detailed.csv,2025-08-17 08:45:20,32
CLT,2018,2019,WR,7,10,5,2,5,71.43,28.57,50.0,3,2025-08-15 16:41:29,clt_roster_turnover_detailed.csv,2025-08-17 08:45:20,32
CLT,2019,2020,DB,10,9,3,7,6,30.0,70.0,66.67,-1,2025-08-15 16:41:29,clt_roster_turnover_detailed.csv,2025-08-17 08:45:20,32
CLT,2019,2020,DL,5,7,2,3,5,40.0,60.0,71.43,2,2025-08-15 16:41:29,clt_roster_turnover_detailed.csv,2025-08-17 08:45:20,32
CLT,2019,2020,LB,9,8,7,2,1,77.78,22.22,12.5,-1,2025-08-15 16:41:29,clt_roster_turnover_detailed.csv,2025-08-17 08:45:20,32
CLT,2019,2020,OL,3,9,1,2,8,33.33,66.67,88.89,6,2025-08-15 16:41:29,clt_roster_turnover_detailed.csv,2025-08-17 08:45:20,32
CLT,2019,2020,OTHER,14,13,11,3,2,78.57,21.43,15.38,-1,2025-08-15 16:41:29,clt_roster_turnover_detailed.csv,2025-08-17 08:45:20,32
CLT,2019,2020,QB,2,2,1,1,1,50.0,50.0,50.0,0,2025-08-15 16:41:29,clt_roster_turnover_detailed.csv,2025-08-17 08:45:20,32
CLT,2019,2020,RB,4,4,3,1,1,75.0,25.0,25.0,0,2025-08-15 16:41:29,clt_roster_turnover_detailed.csv,2025-08-17 08:45:20,32
CLT,2019,2020,ST,3,3,1,2,2,33.33,66.67,66.67,0,2025-08-15 16:41:29,clt_roster_turnover_detailed.csv,2025-08-17 08:45:20,32
CLT,2019,2020,TE,4,5,2,2,3,50.0,50.0,60.0,1,2025-08-15 16:41:29,clt_roster_turnover_detailed.csv,2025-08-17 08:45:20,32
CLT,2019,2020,WR,10,9,5,5,4,50.0,50.0,44.44,-1,2025-08-15 16:41:29,clt_roster_turnover_detailed.csv,2025-08-17 08:45:20,32
CLT,2020,2021,DB,9,14,6,3,8,66.67,33.33,57.14,5,2025-08-15 16:41:29,clt_roster_turnover_detailed.csv,2025-08-17 08:45:20,32
CLT,2020,2021,DL,7,8,3,4,5,42.86,57.14,62.5,1,2025-08-15 16:41:29,clt_roster_turnover_detailed.csv,2025-08-17 08:45:20,32
CLT,2020,2021,LB,8,8,6,2,2,75.0,25.0,25.0,0,2025-08-15 16:41:29,clt_roster_turnover_detailed.csv,2025-08-17 08:45:20,32
CLT,2020,2021,OL,9,4,2,7,2,22.22,77.78,50.0,-5,2025-08-15 16:41:29,clt_roster_turnover_detailed.csv,2025-08-17 08:45:20,32
CLT,2020,2021,OTHER,13,15,9,4,6,69.23,30.77,40.0,2,2025-08-15 16:41:29,clt_roster_turnover_detailed.csv,2025-08-17 08:45:20,32
CLT,2020,2021,QB,2,3,0,2,3,0.0,100.0,100.0,1,2025-08-15 16:41:29,clt_roster_turnover_detailed.csv,2025-08-17 08:45:20,32
CLT,2020,2021,RB,4,5,4,0,1,100.0,0.0,20.0,1,2025-08-15 16:41:29,clt_roster_turnover_detailed.csv,2025-08-17 08:45:20,32
CLT,2020,2021,ST,3,4,2,1,2,66.67,33.33,50.0,1,2025-08-15 16:41:29,clt_roster_turnover_detailed.csv,2025-08-17 08:45:20,32
CLT,2020,2021,TE,5,3,2,3,1,40.0,60.0,33.33,-2,2025-08-15 16:41:29,clt_roster_turnover_detailed.csv,2025-08-17 08:45:20,32
CLT,2020,2021,WR,9,9,7,2,2,77.78,22.22,22.22,0,2025-08-15 16:41:29,clt_roster_turnover_detailed.csv,2025-08-17 08:45:20,32
CLT,2021,2022,DB,14,10,2,12,8,14.29,85.71,80.0,-4,2025-08-15 16:41:29,clt_roster_turnover_detailed.csv,2025-08-17 08:45:20,32
CLT,2021,2022,DL,8,10,4,4,6,50.0,50.0,60.0,2,2025-08-15 16:41:29,clt_roster_turnover_detailed.csv,2025-08-17 08:45:20,32
CLT,2021,2022,LB,8,8,2,6,6,25.0,75.0,75.0,0,2025-08-15 16:41:29,clt_roster_turnover_detailed.csv,2025-08-17 08:45:20,32
CLT,2021,2022,OL,4,3,2,2,1,50.0,50.0,33.33,-1,2025-08-15 16:41:29,clt_roster_turnover_detailed.csv,2025-08-17 08:45:20,32
CLT,2021,2022,OTHER,15,11,6,9,5,40.0,60.0,45.45,-4,2025-08-15 16:41:29,clt_roster_turnover_detailed.csv,2025-08-17 08:45:20,32
CLT,2021,2022,QB,3,3,1,2,2,33.33,66.67,66.67,0,2025-08-15 16:41:29,clt_roster_turnover_detailed.csv,2025-08-17 08:45:20,32
CLT,2021,2022,RB,5,8,4,1,4,80.0,20.0,50.0,3,2025-08-15 16:41:29,clt_roster_turnover_detailed.csv,2025-08-17 08:45:20,32
CLT,2021,2022,ST,4,4,1,3,3,25.0,75.0,75.0,0,2025-08-15 16:41:29,clt_roster_turnover_detailed.csv,2025-08-17 08:45:20,32
CLT,2021,2022,TE,3,4,2,1,2,66.67,33.33,50.0,1,2025-08-15 16:41:29,clt_roster_turnover_detailed.csv,2025-08-17 08:45:20,32
CLT,2021,2022,WR,9,8,6,3,2,66.67,33.33,25.0,-1,2025-08-15 16:41:29,clt_roster_turnover_detailed.csv,2025-08-17 08:45:20,32
CLT,2022,2023,DB,10,12,7,3,5,70.0,30.0,41.67,2,2025-08-15 16:41:29,clt_roster_turnover_detailed.csv,2025-08-17 08:45:20,32
CLT,2022,2023,DL,10,11,5,5,6,50.0,50.0,54.55,1,2025-08-15 16:41:29,clt_roster_turnover_detailed.csv,2025-08-17 08:45:20,32
CLT,2022,2023,LB,8,8,4,4,4,50.0,50.0,50.0,0,2025-08-15 16:41:29,clt_roster_turnover_detailed.csv,2025-08-17 08:45:20,32
CLT,2022,2023,OL,3,11,1,2,10,33.33,66.67,90.91,8,2025-08-15 16:41:29,clt_roster_turnover_detailed.csv,2025-08-17 08:45:20,32
CLT,2022,2023,OTHER,11,1,0,11,1,0.0,100.0,100.0,-10,2025-08-15 16:41:29,clt_roster_turnover_detailed.csv,2025-08-17 08:45:20,32
CLT,2022,2023,QB,3,3,1,2,2,33.33,66.67,66.67,0,2025-08-15 16:41:29,clt_roster_turnover_detailed.csv,2025-08-17 08:45:20,32
CLT,2022,2023,RB,8,7,4,4,3,50.0,50.0,42.86,-1,2025-08-15 16:41:29,clt_roster_turnover_detailed.csv,2025-08-17 08:45:20,32
CLT,2022,2023,ST,4,3,1,3,2,25.0,75.0,66.67,-1,2025-08-15 16:41:29,clt_roster_turnover_detailed.csv,2025-08-17 08:45:20,32
CLT,2022,2023,TE,4,4,2,2,2,50.0,50.0,50.0,0,2025-08-15 16:41:29,clt_roster_turnover_detailed.csv,2025-08-17 08:45:20,32
CLT,2022,2023,WR,8,8,3,5,5,37.5,62.5,62.5,0,2025-08-15 16:41:29,clt_roster_turnover_detailed.csv,2025-08-17 08:45:20,32
CLT,2023,2024,DB,12,12,7,5,5,58.33,41.67,41.67,0,2025-08-15 16:41:29,clt_roster_turnover_detailed.csv,2025-08-17 08:45:20,32
CLT,2023,2024,DL,11,10,5,6,5,45.45,54.55,50.0,-1,2025-08-15 16:41:29,clt_roster_turnover_detailed.csv,2025-08-17 08:45:20,32
CLT,2023,2024,LB,8,6,5,3,1,62.5,37.5,16.67,-2,2025-08-15 16:41:29,clt_roster_turnover_detailed.csv,2025-08-17 08:45:20,32
CLT,2023,2024,OL,11,8,3,8,5,27.27,72.73,62.5,-3,2025-08-15 16:41:29,clt_roster_turnover_detailed.csv,2025-08-17 08:45:20,32
CLT,2023,2024,OTHER,1,9,0,1,9,0.0,100.0,100.0,8,2025-08-15 16:41:29,clt_roster_turnover_detailed.csv,2025-08-17 08:45:20,32
CLT,2023,2024,QB,3,2,1,2,1,33.33,66.67,50.0,-1,2025-08-15 16:41:29,clt_roster_turnover_detailed.csv,2025-08-17 08:45:20,32
CLT,2023,2024,RB,7,4,4,3,0,57.14,42.86,0.0,-3,2025-08-15 16:41:29,clt_roster_turnover_detailed.csv,2025-08-17 08:45:20,32
CLT,2023,2024,ST,3,4,3,0,1,100.0,0.0,25.0,1,2025-08-15 16:41:29,clt_roster_turnover_detailed.csv,2025-08-17 08:45:20,32
CLT,2023,2024,TE,4,4,4,0,0,100.0,0.0,0.0,0,2025-08-15 16:41:29,clt_roster_turnover_detailed.csv,2025-08-17 08:45:20,32
CLT,2023,2024,WR,8,7,3,5,4,37.5,62.5,57.14,-1,2025-08-15 16:41:29,clt_roster_turnover_detailed.csv,2025-08-17 08:45:20,32
CRD,2011,2012,DB,8,9,5,3,4,62.5,37.5,44.44,1,2025-08-15 16:41:27,crd_roster_turnover_detailed.csv,2025-08-17 08:45:20,32
CRD,2011,2012,DL,5,7,5,0,2,100.0,0.0,28.57,2,2025-08-15 16:41:27,crd_roster_turnover_detailed.csv,2025-08-17 08:45:20,32
CRD,2011,2012,LB,3,2,2,1,0,66.67,33.33,0.0,-1,2025-08-15 16:41:27,crd_roster_turnover_detailed.csv,2025-08-17 08:45:20,32
CRD,2011,2012,OL,3,5,1,2,4,33.33,66.67,80.0,2,2025-08-15 16:41:27,crd_roster_turnover_detailed.csv,2025-08-17 08:45:20,32
CRD,2011,2012,OTHER,15,14,7,8,7,46.67,53.33,50.0,-1,2025-08-15 16:41:27,crd_roster_turnover_detailed.csv,2025-08-17 08:45:20,32
CRD,2011,2012,QB,3,4,2,1,2,66.67,33.33,50.0,1,2025-08-15 16:41:27,crd_roster_turnover_detailed.csv,2025-08-17 08:45:20,32
CRD,2011,2012,RB,6,7,5,1,2,83.33,16.67,28.57,1,2025-08-15 16:41:27,crd_roster_turnover_detailed.csv,2025-08-17 08:45:20,32
CRD,2011,2012,ST,4,3,3,1,0,75.0,25.0,0.0,-1,2025-08-15 16:41:27,crd_roster_turnover_detailed.csv,2025-08-17 08:45:20,32
CRD,2011,2012,TE,4,6,4,0,2,100.0,0.0,33.33,2,2025-08-15 16:41:27,crd_roster_turnover_detailed.csv,2025-08-17 08:45:20,32
CRD,2011,2012,WR,7,5,3,4,2,42.86,57.14,40.0,-2,2025-08-15 16:41:27,crd_roster_turnover_detailed.csv,2025-08-17 08:45:20,32
CRD,2012,2013,DB,9,10,2,7,8,22.22,77.78,80.0,1,2025-08-15 16:41:27,crd_roster_turnover_detailed.csv,2025-08-17 08:45:20,32
CRD,2012,2013,DL,7,5,2,5,3,28.57,71.43,60.0,-2,2025-08-15 16:41:27,crd_roster_turnover_detailed.csv,2025-08-17 08:45:20,32
CRD,2012,2013,LB,2,8,0,2,8,0.0,100.0,100.0,6,2025-08-15 16:41:27,crd_roster_turnover_detailed.csv,2025-08-17 08:45:20,32
CRD,2012,2013,OL,5,5,1,4,4,20.0,80.0,80.0,0,2025-08-15 16:41:27,crd_roster_turnover_detailed.csv,2025-08-17 08:45:20,32
CRD,2012,2013,OTHER,14,12,5,9,7,35.71,64.29,58.33,-2,2025-08-15 16:41:27,crd_roster_turnover_detailed.csv,2025-08-17 08:45:20,32
CRD,2012,2013,QB,4,1,0,4,1,0.0,100.0,100.0,-3,2025-08-15 16:41:27,crd_roster_turnover_detailed.csv,2025-08-17 08:45:20,32
CRD,2012,2013,RB,7,5,1,6,4,14.29,85.71,80.0,-2,2025-08-15 16:41:27,crd_roster_turnover_detailed.csv,2025-08-17 08:45:20,32
CRD,2012,2013,ST,3,3,3,0,0,100.0,0.0,0.0,0,2025-08-15 16:41:27,crd_roster_turnover_detailed.csv,2025-08-17 08:45:20,32
CRD,2012,2013,TE,6,5,3,3,2,50.0,50.0,40.0,-1,2025-08-15 16:41:27,crd_roster_turnover_detailed.csv,2025-08-17 08:45:20,32
CRD,2012,2013,WR,5,6,3,2,3,60.0,40.0,50.0,1,2025-08-15 16:41:27,crd_roster_turnover_detailed.csv,2025-08-17 08:45:20,32
CRD,2013,2014,DB,10,7,4,6,3,40.0,60.0,42.86,-3,2025-08-15 16:41:27,crd_roster_turnover_detailed.csv,2025-08-17 08:45:20,32
CRD,2013,2014,DL,5,6,2,3,4,40.0,60.0,66.67,1,2025-08-15 16:41:27,crd_roster_turnover_detailed.csv,2025-08-17 08:45:20,32
CRD,2013,2014,LB,8,6,4,4,2,50.0,50.0,33.33,-2,2025-08-15 16:41:27,crd_roster_turnover_detailed.csv,2025-08-17 08:45:20,32
CRD,2013,2014,OL,5,4,1,4,3,20.0,80.0,75.0,-1,2025-08-15 16:41:27,crd_roster_turnover_detailed.csv,2025-08-17 08:45:20,32
CRD,2013,2014,OTHER,12,13,4,8,9,33.33,66.67,69.23,1,2025-08-15 16:41:27,crd_roster_turnover_detailed.csv,2025-08-17 08:45:20,32
CRD,2013,2014,QB,1,4,1,0,3,100.0,0.0,75.0,3,2025-08-15 16:41:27,crd_roster_turnover_detailed.csv,2025-08-17 08:45:20,32
CRD,2013,2014,RB,5,8,3,2,5,60.0,40.0,62.5,3,2025-08-15 16:41:27,crd_roster_turnover_detailed.csv,2025-08-17 08:45:20,32
CRD,2013,2014,ST,3,4,2,1,2,66.67,33.33,50.0,1,2025-08-15 16:41:27,crd_roster_turnover_detailed.csv,2025-08-17 08:45:20,32
CRD,2013,2014,TE,5,3,1,4,2,20.0,80.0,66.67,-2,2025-08-15 16:41:27,crd_roster_turnover_detailed.csv,2025-08-17 08:45:20,32
CRD,2013,2014,WR,6,7,3,3,4,50.0,50.0,57.14,1,2025-08-15 16:41:27,crd_roster_turnover_detailed.csv,2025-08-17 08:45:20,32
CRD,2014,2015,DB,7,7,4,3,3,57.14,42.86,42.86,0,2025-08-15 16:41:27,crd_roster_turnover_detailed.csv,2025-08-17 08:45:20,32
CRD,2014,2015,DL,6,8,3,3,5,50.0,50.0,62.5,2,2025-08-15 16:41:27,crd_roster_turnover_detailed.csv,2025-08-17 08:45:20,32
CRD,2014,2015,LB,6,5,1,5,4,16.67,83.33,80.0,-1,2025-08-15 16:41:27,crd_roster_turnover_detailed.csv,2025-08-17 08:45:20,32
CRD,2014,2015,OL,4,4,3,1,1,75.0,25.0,25.0,0,2025-08-15 16:41:27,crd_roster_turnover_detailed.csv,2025-08-17 08:45:20,32
CRD,2014,2015,OTHER,13,15,8,5,7,61.54,38.46,46.67,2,2025-08-15 16:41:27,crd_roster_turnover_detailed.csv,2025-08-17 08:45:20,32
CRD,2014,2015,QB,4,2,2,2,0,50.0,50.0,0.0,-2,2025-08-15 16:41:27,crd_roster_turnover_detailed.csv,2025-08-17 08:45:20,32
CRD,2014,2015,RB,8,5,3,5,2,37.5,62.5,40.0,-3,2025-08-15 16:41:27,crd_roster_turnover_detailed.csv,2025-08-17 08:45:20,32
CRD,2014,2015,ST,4,3,3,1,0,75.0,25.0,0.0,-1,2025-08-15 16:41:27,crd_roster_turnover_detailed.csv,2025-08-17 08:45:20,32
CRD,2014,2015,TE,3,3,2,1,1,66.67,33.33,33.33,0,2025-08-15 16:41:27,crd_roster_turnover_detailed.csv,2025-08-17 08:45:20,32
CRD,2014,2015,WR,7,6,4,3,2,57.14,42.86,33.33,-1,2025-08-15 16:41:27,crd_roster_turnover_detailed.csv,2025-08-17 08:45:20,32
CRD,2015,2016,DB,7,10,3,4,7,42.86,57.14,70.0,3,2025-08-15 16:41:27,crd_roster_turnover_detailed.csv,2025-08-17 08:45:20,32
CRD,2015,2016,DL,8,8,4,4,4,50.0,50.0,50.0,0,2025-08-15 16:41:27,crd_roster_turnover_detailed.csv,2025-08-17 08:45:20,32
CRD,2015,2016,LB,5,8,2,3,6,40.0,60.0,75.0,3,2025-08-15 16:41:27,crd_roster_turnover_detailed.csv,2025-08-17 08:45:20,32
CRD,2015,2016,OL,4,7,1,3,6,25.0,75.0,85.71,3,2025-08-15 16:41:27,crd_roster_turnover_detailed.csv,2025-08-17 08:45:20,32
CRD,2015,2016,OTHER,15,12,6,9,6,40.0,60.0,50.0,-3,2025-08-15 16:41:27,crd_roster_turnover_detailed.csv,2025-08-17 08:45:20,32
CRD,2015,2016,QB,2,2,2,0,0,100.0,0.0,0.0,0,2025-08-15 16:41:27,crd_roster_turnover_detailed.csv,2025-08-17 08:45:20,32
CRD,2015,2016,RB,5,5,5,0,0,100.0,0.0,0.0,0,2025-08-15 16:41:27,crd_roster_turnover_detailed.csv,2025-08-17 08:45:20,32
CRD,2015,2016,ST,3,6,2,1,4,66.67,33.33,66.67,3,2025-08-15 16:41:27,crd_roster_turnover_detailed.csv,2025-08-17 08:45:20,32
CRD,2015,2016,TE,3,4,3,0,1,100.0,0.0,25.0,1,2025-08-15 16:41:27,crd_roster_turnover_detailed.csv,2025-08-17 08:45:20,32
CRD,2015,2016,WR,6,8,6,0,2,100.0,0.0,25.0,2,2025-08-15 16:41:27,crd_roster_turnover_detailed.csv,2025-08-17 08:45:20,32
CRD,2016,2017,DB,10,8,4,6,4,40.0,60.0,50.0,-2,2025-08-15 16:41:27,crd_roster_turnover_detailed.csv,2025-08-17 08:45:20,32
CRD,2016,2017,DL,8,5,4,4,1,50.0,50.0,20.0,-3,2025-08-15 16:41:27,crd_roster_turnover_detailed.csv,2025-08-17 08:45:20,32
CRD,2016,2017,LB,8,5,3,5,2,37.5,62.5,40.0,-3,2025-08-15 16:41:27,crd_roster_turnover_detailed.csv,2025-08-17 08:45:20,32
CRD,2016,2017,OL,7,7,1,6,6,14.29,85.71,85.71,0,2025-08-15 16:41:27,crd_roster_turnover_detailed.csv,2025-08-17 08:45:20,32
CRD,2016,2017,OTHER,12,16,8,4,8,66.67,33.33,50.0,4,2025-08-15 16:41:27,crd_roster_turnover_detailed.csv,2025-08-17 08:45:20,32
CRD,2016,2017,QB,2,3,2,0,1,100.0,0.0,33.33,1,2025-08-15 16:41:27,crd_roster_turnover_detailed.csv,2025-08-17 08:45:20,32
CRD,2016,2017,RB,5,7,4,1,3,80.0,20.0,42.86,2,2025-08-15 16:41:27,crd_roster_turnover_detailed.csv,2025-08-17 08:45:20,32
CRD,2016,2017,ST,6,4,1,5,3,16.67,83.33,75.0,-2,2025-08-15 16:41:27,crd_roster_turnover_detailed.csv,2025-08-17 08:45:20,32
CRD,2016,2017,TE,4,4,2,2,2,50.0,50.0,50.0,0,2025-08-15 16:41:27,crd_roster_turnover_detailed.csv,2025-08-17 08:45:20,32
CRD,2016,2017,WR,8,9,6,2,3,75.0,25.0,33.33,1,2025-08-15 16:41:27,crd_roster_turnover_detailed.csv,2025-08-17 08:45:20,32
CRD,2017,2018,DB,8,13,4,4,9,50.0,50.0,69.23,5,2025-08-15 16:41:27,crd_roster_turnover_detailed.csv,2025-08-17 08:45:20,32
CRD,2017,2018,DL,5,8,0,5,8,0.0,100.0,100.0,3,2025-08-15 16:41:27,crd_roster_turnover_detailed.csv,2025-08-17 08:45:20,32
CRD,2017,2018,LB,5,7,1,4,6,20.0,80.0,85.71,2,2025-08-15 16:41:27,crd_roster_turnover_detailed.csv,2025-08-17 08:45:20,32
CRD,2017,2018,OL,7,10,2,5,8,28.57,71.43,80.0,3,2025-08-15 16:41:27,crd_roster_turnover_detailed.csv,2025-08-17 08:45:20,32
CRD,2017,2018,OTHER,16,14,3,13,11,18.75,81.25,78.57,-2,2025-08-15 16:41:27,crd_roster_turnover_detailed.csv,2025-08-17 08:45:20,32
CRD,2017,2018,QB,3,3,0,3,3,0.0,100.0,100.0,0,2025-08-15 16:41:27,crd_roster_turnover_detailed.csv,2025-08-17 08:45:20,32
CRD,2017,2018,RB,7,4,1,6,3,14.29,85.71,75.0,-3,2025-08-15 16:41:27,crd_roster_turnover_detailed.csv,2025-08-17 08:45:20,32
CRD,2017,2018,ST,4,5,3,1,2,75.0,25.0,40.0,1,2025-08-15 16:41:27,crd_roster_turnover_detailed.csv,2025-08-17 08:45:20,32
CRD,2017,2018,TE,4,5,2,2,3,50.0,50.0,60.0,1,2025-08-15 16:41:27,crd_roster_turnover_detailed.csv,2025-08-17 08:45:20,32
CRD,2017,2018,WR,9,8,3,6,5,33.33,66.67,62.5,-1,2025-08-15 16:41:27,crd_roster_turnover_detailed.csv,2025-08-17 08:45:20,32
CRD,2018,2019,DB,13,11,3,10,8,23.08,76.92,72.73,-2,2025-08-15 16:41:27,crd_roster_turnover_detailed.csv,2025-08-17 08:45:20,32
CRD,2018,2019,DL,8,8,0,8,8,0.0,100.0,100.0,0,2025-08-15 16:41:27,crd_roster_turnover_detailed.csv,2025-08-17 08:45:20,32
CRD,2018,2019,LB,7,7,1,6,6,14.29,85.71,85.71,0,2025-08-15 16:41:27,crd_roster_turnover_detailed.csv,2025-08-17 08:45:20,32
CRD,2018,2019,OL,10,5,1,9,4,10.0,90.0,80.0,-5,2025-08-15 16:41:27,crd_roster_turnover_detailed.csv,2025-08-17 08:45:20,32
CRD,2018,2019,OTHER,14,14,6,8,8,42.86,57.14,57.14,0,2025-08-15 16:41:27,crd_roster_turnover_detailed.csv,2025-08-17 08:45:20,32
CRD,2018,2019,QB,3,2,0,3,2,0.0,100.0,100.0,-1,2025-08-15 16:41:27,crd_roster_turnover_detailed.csv,2025-08-17 08:45:20,32
CRD,2018,2019,RB,4,5,2,2,3,50.0,50.0,60.0,1,2025-08-15 16:41:27,crd_roster_turnover_detailed.csv,2025-08-17 08:45:20,32
CRD,2018,2019,ST,5,4,3,2,1,60.0,40.0,25.0,-1,2025-08-15 16:41:27,crd_roster_turnover_detailed.csv,2025-08-17 08:45:20,32
CRD,2018,2019,TE,5,3,1,4,2,20.0,80.0,66.67,-2,2025-08-15 16:41:27,crd_roster_turnover_detailed.csv,2025-08-17 08:45:20,32
CRD,2018,2019,WR,8,10,4,4,6,50.0,50.0,60.0,2,2025-08-15 16:41:27,crd_roster_turnover_detailed.csv,2025-08-17 08:45:20,32
CRD,2019,2020,DB,11,11,7,4,4,63.64,36.36,36.36,0,2025-08-15 16:41:27,crd_roster_turnover_detailed.csv,2025-08-17 08:45:20,32
CRD,2019,2020,DL,8,9,2,6,7,25.0,75.0,77.78,1,2025-08-15 16:41:27,crd_roster_turnover_detailed.csv,2025-08-17 08:45:20,32
CRD,2019,2020,LB,7,8,3,4,5,42.86,57.14,62.5,1,2025-08-15 16:41:27,crd_roster_turnover_detailed.csv,2025-08-17 08:45:20,32
CRD,2019,2020,OL,5,4,2,3,2,40.0,60.0,50.0,-1,2025-08-15 16:41:27,crd_roster_turnover_detailed.csv,2025-08-17 08:45:20,32
CRD,2019,2020,OTHER,14,15,9,5,6,64.29,35.71,40.0,1,2025-08-15 16:41:27,crd_roster_turnover_detailed.csv,2025-08-17 08:45:20,32
CRD,2019,2020,QB,2,2,1,1,1,50.0,50.0,50.0,0,2025-08-15 16:41:27,crd_roster_turnover_detailed.csv,2025-08-17 08:45:20,32
CRD,2019,2020,RB,5,3,2,3,1,40.0,60.0,33.33,-2,2025-08-15 16:41:27,crd_roster_turnover_detailed.csv,2025-08-17 08:45:20,32
CRD,2019,2020,ST,4,4,3,1,1,75.0,25.0,25.0,0,2025-08-15 16:41:27,crd_roster_turnover_detailed.csv,2025-08-17 08:45:20,32
CRD,2019,2020,TE,3,6,2,1,4,66.67,33.33,66.67,3,2025-08-15 16:41:27,crd_roster_turnover_detailed.csv,2025-08-17 08:45:20,32
CRD,2019,2020,WR,10,7,6,4,1,60.0,40.0,14.29,-3,2025-08-15 16:41:27,crd_roster_turnover_detailed.csv,2025-08-17 08:45:20,32
CRD,2020,2021,DB,11,13,8,3,5,72.73,27.27,38.46,2,2025-08-15 16:41:27,crd_roster_turnover_detailed.csv,2025-08-17 08:45:20,32
CRD,2020,2021,DL,9,8,5,4,3,55.56,44.44,37.5,-1,2025-08-15 16:41:27,crd_roster_turnover_detailed.csv,2025-08-17 08:45:20,32
CRD,2020,2021,LB,8,7,4,4,3,50.0,50.0,42.86,-1,2025-08-15 16:41:27,crd_roster_turnover_detailed.csv,2025-08-17 08:45:20,32
CRD,2020,2021,OL,4,9,1,3,8,25.0,75.0,88.89,5,2025-08-15 16:41:27,crd_roster_turnover_detailed.csv,2025-08-17 08:45:20,32
CRD,2020,2021,OTHER,15,14,9,6,5,60.0,40.0,35.71,-1,2025-08-15 16:41:27,crd_roster_turnover_detailed.csv,2025-08-17 08:45:20,32
CRD,2020,2021,QB,2,3,2,0,1,100.0,0.0,33.33,1,2025-08-15 16:41:27,crd_roster_turnover_detailed.csv,2025-08-17 08:45:20,32
CRD,2020,2021,RB,3,5,2,1,3,66.67,33.33,60.0,2,2025-08-15 16:41:27,crd_roster_turnover_detailed.csv,2025-08-17 08:45:20,32
CRD,2020,2021,ST,4,4,2,2,2,50.0,50.0,50.0,0,2025-08-15 16:41:27,crd_roster_turnover_detailed.csv,2025-08-17 08:45:20,32
CRD,2020,2021,TE,6,6,2,4,4,33.33,66.67,66.67,0,2025-08-15 16:41:27,crd_roster_turnover_detailed.csv,2025-08-17 08:45:20,32
CRD,2020,2021,WR,7,7,3,4,4,42.86,57.14,57.14,0,2025-08-15 16:41:27,crd_roster_turnover_detailed.csv,2025-08-17 08:45:20,32
CRD,2021,2022,DB,13,12,7,6,5,53.85,46.15,41.67,-1,2025-08-15 16:41:27,crd_roster_turnover_detailed.csv,2025-08-17 08:45:20,32
CRD,2021,2022,DL,8,9,4,4,5,50.0,50.0,55.56,1,2025-08-15 16:41:27,crd_roster_turnover_detailed.csv,2025-08-17 08:45:20,32
CRD,2021,2022,LB,7,9,3,4,6,42.86,57.14,66.67,2,2025-08-15 16:41:27,crd_roster_turnover_detailed.csv,2025-08-17 08:45:20,32
CRD,2021,2022,OL,9,8,1,8,7,11.11,88.89,87.5,-1,2025-08-15 16:41:27,crd_roster_turnover_detailed.csv,2025-08-17 08:45:20,32
CRD,2021,2022,OTHER,14,14,9,5,5,64.29,35.71,35.71,0,2025-08-15 16:41:27,crd_roster_turnover_detailed.csv,2025-08-17 08:45:20,32
CRD,2021,2022,QB,3,4,2,1,2,66.67,33.33,50.0,1,2025-08-15 16:41:27,crd_roster_turnover_detailed.csv,2025-08-17 08:45:20,32
CRD,2021,2022,RB,5,7,3,2,4,60.0,40.0,57.14,2,2025-08-15 16:41:27,crd_roster_turnover_detailed.csv,2025-08-17 08:45:20,32
CRD,2021,2022,ST,4,7,3,1,4,75.0,25.0,57.14,3,2025-08-15 16:41:27,crd_roster_turnover_detailed.csv,2025-08-17 08:45:20,32
CRD,2021,2022,TE,6,4,2,4,2,33.33,66.67,50.0,-2,2025-08-15 16:41:27,crd_roster_turnover_detailed.csv,2025-08-17 08:45:20,32
CRD,2021,2022,WR,7,10,5,2,5,71.43,28.57,50.0,3,2025-08-15 16:41:27,crd_roster_turnover_detailed.csv,2025-08-17 08:45:20,32
CRD,2022,2023,DB,12,14,3,9,11,25.0,75.0,78.57,2,2025-08-15 16:41:27,crd_roster_turnover_detailed.csv,2025-08-17 08:45:20,32
CRD,2022,2023,DL,9,10,3,6,7,33.33,66.67,70.0,1,2025-08-15 16:41:27,crd_roster_turnover_detailed.csv,2025-08-17 08:45:20,32
CRD,2022,2023,LB,9,13,4,5,9,44.44,55.56,69.23,4,2025-08-15 16:41:27,crd_roster_turnover_detailed.csv,2025-08-17 08:45:20,32
CRD,2022,2023,OL,8,11,0,8,11,0.0,100.0,100.0,3,2025-08-15 16:41:27,crd_roster_turnover_detailed.csv,2025-08-17 08:45:20,32
CRD,2022,2023,OTHER,14,2,1,13,1,7.14,92.86,50.0,-12,2025-08-15 16:41:27,crd_roster_turnover_detailed.csv,2025-08-17 08:45:20,32
CRD,2022,2023,QB,4,3,1,3,2,25.0,75.0,66.67,-1,2025-08-15 16:41:27,crd_roster_turnover_detailed.csv,2025-08-17 08:45:20,32
CRD,2022,2023,RB,7,7,3,4,4,42.86,57.14,57.14,0,2025-08-15 16:41:27,crd_roster_turnover_detailed.csv,2025-08-17 08:45:20,32
CRD,2022,2023,ST,7,4,2,5,2,28.57,71.43,50.0,-3,2025-08-15 16:41:27,crd_roster_turnover_detailed.csv,2025-08-17 08:45:20,32
CRD,2022,2023,TE,4,6,2,2,4,50.0,50.0,66.67,2,2025-08-15 16:41:27,crd_roster_turnover_detailed.csv,2025-08-17 08:45:20,32
CRD,2022,2023,WR,10,7,4,6,3,40.0,60.0,42.86,-3,2025-08-15 16:41:27,crd_roster_turnover_detailed.csv,2025-08-17 08:45:20,32
CRD,2023,2024,DB,14,10,6,8,4,42.86,57.14,40.0,-4,2025-08-15 16:41:27,crd_roster_turnover_detailed.csv,2025-08-17 08:45:20,32
CRD,2023,2024,DL,10,9,4,6,5,40.0,60.0,55.56,-1,2025-08-15 16:41:27,crd_roster_turnover_detailed.csv,2025-08-17 08:45:20,32
CRD,2023,2024,LB,13,10,5,8,5,38.46,61.54,50.0,-3,2025-08-15 16:41:27,crd_roster_turnover_detailed.csv,2025-08-17 08:45:20,32
CRD,2023,2024,OL,11,9,3,8,6,27.27,72.73,66.67,-2,2025-08-15 16:41:27,crd_roster_turnover_detailed.csv,2025-08-17 08:45:20,32
CRD,2023,2024,OTHER,2,10,0,2,10,0.0,100.0,100.0,8,2025-08-15 16:41:27,crd_roster_turnover_detailed.csv,2025-08-17 08:45:20,32
CRD,2023,2024,QB,3,2,2,1,0,66.67,33.33,0.0,-1,2025-08-15 16:41:27,crd_roster_turnover_detailed.csv,2025-08-17 08:45:20,32
CRD,2023,2024,RB,7,6,4,3,2,57.14,42.86,33.33,-1,2025-08-15 16:41:27,crd_roster_turnover_detailed.csv,2025-08-17 08:45:20,32
CRD,2023,2024,ST,4,5,3,1,2,75.0,25.0,40.0,1,2025-08-15 16:41:27,crd_roster_turnover_detailed.csv,2025-08-17 08:45:20,32
CRD,2023,2024,TE,6,4,3,3,1,50.0,50.0,25.0,-2,2025-08-15 16:41:27,crd_roster_turnover_detailed.csv,2025-08-17 08:45:20,32
CRD,2023,2024,WR,7,7,3,4,4,42.86,57.14,57.14,0,2025-08-15 16:41:27,crd_roster_turnover_detailed.csv,2025-08-17 08:45:20,32
DAL,2011,2012,DB,9,13,4,5,9,44.44,55.56,69.23,4,2025-08-15 16:41:26,dal_roster_turnover_detailed.csv,2025-08-17 08:45:20,32
DAL,2011,2012,DL,5,8,4,1,4,80.0,20.0,50.0,3,2025-08-15 16:41:26,dal_roster_turnover_detailed.csv,2025-08-17 08:45:20,32
DAL,2011,2012,LB,4,5,2,2,3,50.0,50.0,60.0,1,2025-08-15 16:41:26,dal_roster_turnover_detailed.csv,2025-08-17 08:45:20,32
DAL,2011,2012,OL,6,4,3,3,1,50.0,50.0,25.0,-2,2025-08-15 16:41:26,dal_roster_turnover_detailed.csv,2025-08-17 08:45:20,32
DAL,2011,2012,OTHER,14,15,8,6,7,57.14,42.86,46.67,1,2025-08-15 16:41:26,dal_roster_turnover_detailed.csv,2025-08-17 08:45:20,32
DAL,2011,2012,QB,3,2,1,2,1,33.33,66.67,50.0,-1,2025-08-15 16:41:26,dal_roster_turnover_detailed.csv,2025-08-17 08:45:20,32
DAL,2011,2012,RB,8,5,3,5,2,37.5,62.5,40.0,-3,2025-08-15 16:41:26,dal_roster_turnover_detailed.csv,2025-08-17 08:45:20,32
DAL,2011,2012,ST,4,3,2,2,1,50.0,50.0,33.33,-1,2025-08-15 16:41:26,dal_roster_turnover_detailed.csv,2025-08-17 08:45:20,32
DAL,2011,2012,TE,4,3,2,2,1,50.0,50.0,33.33,-1,2025-08-15 16:41:26,dal_roster_turnover_detailed.csv,2025-08-17 08:45:20,32
DAL,2011,2012,WR,6,7,4,2,3,66.67,33.33,42.86,1,2025-08-15 16:41:26,dal_roster_turnover_detailed.csv,2025-08-17 08:45:20,32
DAL,2012,2013,DB,13,9,3,10,6,23.08,76.92,66.67,-4,2025-08-15 16:41:26,dal_roster_turnover_detailed.csv,2025-08-17 08:45:20,32
DAL,2012,2013,DL,8,14,1,7,13,12.5,87.5,92.86,6,2025-08-15 16:41:26,dal_roster_turnover_detailed.csv,2025-08-17 08:45:20,32
DAL,2012,2013,LB,5,8,1,4,7,20.0,80.0,87.5,3,2025-08-15 16:41:26,dal_roster_turnover_detailed.csv,2025-08-17 08:45:20,32
DAL,2012,2013,OL,4,3,2,2,1,50.0,50.0,33.33,-1,2025-08-15 16:41:26,dal_roster_turnover_detailed.csv,2025-08-17 08:45:20,32
DAL,2012,2013,OTHER,15,15,8,7,7,53.33,46.67,46.67,0,2025-08-15 16:41:26,dal_roster_turnover_detailed.csv,2025-08-17 08:45:20,32
DAL,2012,2013,QB,2,2,2,0,0,100.0,0.0,0.0,0,2025-08-15 16:41:26,dal_roster_turnover_detailed.csv,2025-08-17 08:45:20,32
DAL,2012,2013,RB,5,5,3,2,2,60.0,40.0,40.0,0,2025-08-15 16:41:26,dal_roster_turnover_detailed.csv,2025-08-17 08:45:20,32
DAL,2012,2013,ST,3,2,2,1,0,66.67,33.33,0.0,-1,2025-08-15 16:41:26,dal_roster_turnover_detailed.csv,2025-08-17 08:45:20,32
DAL,2012,2013,TE,3,4,2,1,2,66.67,33.33,50.0,1,2025-08-15 16:41:26,dal_roster_turnover_detailed.csv,2025-08-17 08:45:20,32
DAL,2012,2013,WR,7,6,4,3,2,57.14,42.86,33.33,-1,2025-08-15 16:41:26,dal_roster_turnover_detailed.csv,2025-08-17 08:45:20,32
DAL,2013,2014,DB,9,10,6,3,4,66.67,33.33,40.0,1,2025-08-15 16:41:26,dal_roster_turnover_detailed.csv,2025-08-17 08:45:20,32
DAL,2013,2014,DL,14,11,2,12,9,14.29,85.71,81.82,-3,2025-08-15 16:41:26,dal_roster_turnover_detailed.csv,2025-08-17 08:45:20,32
DAL,2013,2014,LB,8,5,1,7,4,12.5,87.5,80.0,-3,2025-08-15 16:41:26,dal_roster_turnover_detailed.csv,2025-08-17 08:45:20,32
DAL,2013,2014,OL,3,4,1,2,3,33.33,66.67,75.0,1,2025-08-15 16:41:26,dal_roster_turnover_detailed.csv,2025-08-17 08:45:20,32
DAL,2013,2014,OTHER,15,14,9,6,5,60.0,40.0,35.71,-1,2025-08-15 16:41:26,dal_roster_turnover_detailed.csv,2025-08-17 08:45:20,32
DAL,2013,2014,QB,2,2,1,1,1,50.0,50.0,50.0,0,2025-08-15 16:41:26,dal_roster_turnover_detailed.csv,2025-08-17 08:45:20,32
DAL,2013,2014,RB,5,4,4,1,0,80.0,20.0,0.0,-1,2025-08-15 16:41:26,dal_roster_turnover_detailed.csv,2025-08-17 08:45:20,32
DAL,2013,2014,ST,2,2,2,0,0,100.0,0.0,0.0,0,2025-08-15 16:41:26,dal_roster_turnover_detailed.csv,2025-08-17 08:45:20,32
DAL,2013,2014,TE,4,3,3,1,0,75.0,25.0,0.0,-1,2025-08-15 16:41:26,dal_roster_turnover_detailed.csv,2025-08-17 08:45:20,32
DAL,2013,2014,WR,6,5,4,2,1,66.67,33.33,20.0,-1,2025-08-15 16:41:26,dal_roster_turnover_detailed.csv,2025-08-17 08:45:20,32
DAL,2014,2015,DB,10,10,5,5,5,50.0,50.0,50.0,0,2025-08-15 16:41:26,dal_roster_turnover_detailed.csv,2025-08-17 08:45:20,32
DAL,2014,2015,DL,11,9,5,6,4,45.45,54.55,44.44,-2,2025-08-15 16:41:26,dal_roster_turnover_detailed.csv,2025-08-17 08:45:20,32
DAL,2014,2015,LB,5,6,2,3,4,40.0,60.0,66.67,1,2025-08-15 16:41:26,dal_roster_turnover_detailed.csv,2025-08-17 08:45:20,32
DAL,2014,2015,OL,4,5,2,2,3,50.0,50.0,60.0,1,2025-08-15 16:41:26,dal_roster_turnover_detailed.csv,2025-08-17 08:45:20,32
DAL,2014,2015,OTHER,14,12,7,7,5,50.0,50.0,41.67,-2,2025-08-15 16:41:26,dal_roster_turnover_detailed.csv,2025-08-17 08:45:20,32
DAL,2014,2015,QB,2,4,2,0,2,100.0,0.0,50.0,2,2025-08-15 16:41:26,dal_roster_turnover_detailed.csv,2025-08-17 08:45:20,32
DAL,2014,2015,RB,4,7,3,1,4,75.0,25.0,57.14,3,2025-08-15 16:41:26,dal_roster_turnover_detailed.csv,2025-08-17 08:45:20,32
DAL,2014,2015,ST,2,2,2,0,0,100.0,0.0,0.0,0,2025-08-15 16:41:26,dal_roster_turnover_detailed.csv,2025-08-17 08:45:20,32
DAL,2014,2015,TE,3,4,3,0,1,100.0,0.0,25.0,1,2025-08-15 16:41:26,dal_roster_turnover_detailed.csv,2025-08-17 08:45:20,32
DAL,2014,2015,WR,5,7,4,1,3,80.0,20.0,42.86,2,2025-08-15 16:41:26,dal_roster_turnover_detailed.csv,2025-08-17 08:45:20,32
DAL,2015,2016,DB,10,8,5,5,3,50.0,50.0,37.5,-2,2025-08-15 16:41:26,dal_roster_turnover_detailed.csv,2025-08-17 08:45:20,32
DAL,2015,2016,DL,9,7,3,6,4,33.33,66.67,57.14,-2,2025-08-15 16:41:26,dal_roster_turnover_detailed.csv,2025-08-17 08:45:20,32
DAL,2015,2016,LB,6,6,4,2,2,66.67,33.33,33.33,0,2025-08-15 16:41:26,dal_roster_turnover_detailed.csv,2025-08-17 08:45:20,32
DAL,2015,2016,OL,5,6,1,4,5,20.0,80.0,83.33,1,2025-08-15 16:41:26,dal_roster_turnover_detailed.csv,2025-08-17 08:45:20,32
DAL,2015,2016,OTHER,12,14,7,5,7,58.33,41.67,50.0,2,2025-08-15 16:41:26,dal_roster_turnover_detailed.csv,2025-08-17 08:45:20,32
DAL,2015,2016,QB,4,3,1,3,2,25.0,75.0,66.67,-1,2025-08-15 16:41:26,dal_roster_turnover_detailed.csv,2025-08-17 08:45:20,32
DAL,2015,2016,RB,7,5,3,4,2,42.86,57.14,40.0,-2,2025-08-15 16:41:26,dal_roster_turnover_detailed.csv,2025-08-17 08:45:20,32
DAL,2015,2016,ST,2,2,2,0,0,100.0,0.0,0.0,0,2025-08-15 16:41:26,dal_roster_turnover_detailed.csv,2025-08-17 08:45:20,32
DAL,2015,2016,TE,4,3,3,1,0,75.0,25.0,0.0,-1,2025-08-15 16:41:26,dal_roster_turnover_detailed.csv,2025-08-17 08:45:20,32
DAL,2015,2016,WR,7,6,6,1,0,85.71,14.29,0.0,-1,2025-08-15 16:41:26,dal_roster_turnover_detailed.csv,2025-08-17 08:45:20,32
DAL,2016,2017,DB,8,9,4,4,5,50.0,50.0,55.56,1,2025-08-15 16:41:26,dal_roster_turnover_detailed.csv,2025-08-17 08:45:20,32
DAL,2016,2017,DL,7,11,2,5,9,28.57,71.43,81.82,4,2025-08-15 16:41:26,dal_roster_turnover_detailed.csv,2025-08-17 08:45:20,32
DAL,2016,2017,LB,6,6,3,3,3,50.0,50.0,50.0,0,2025-08-15 16:41:26,dal_roster_turnover_detailed.csv,2025-08-17 08:45:20,32
DAL,2016,2017,OL,6,4,3,3,1,50.0,50.0,25.0,-2,2025-08-15 16:41:26,dal_roster_turnover_detailed.csv,2025-08-17 08:45:20,32
DAL,2016,2017,OTHER,14,12,7,7,5,50.0,50.0,41.67,-2,2025-08-15 16:41:26,dal_roster_turnover_detailed.csv,2025-08-17 08:45:20,32
DAL,2016,2017,QB,3,2,1,2,1,33.33,66.67,50.0,-1,2025-08-15 16:41:26,dal_roster_turnover_detailed.csv,2025-08-17 08:45:20,32
DAL,2016,2017,RB,5,4,4,1,0,80.0,20.0,0.0,-1,2025-08-15 16:41:26,dal_roster_turnover_detailed.csv,2025-08-17 08:45:20,32
DAL,2016,2017,ST,2,3,2,0,1,100.0,0.0,33.33,1,2025-08-15 16:41:26,dal_roster_turnover_detailed.csv,2025-08-17 08:45:20,32
DAL,2016,2017,TE,3,4,2,1,2,66.67,33.33,50.0,1,2025-08-15 16:41:26,dal_roster_turnover_detailed.csv,2025-08-17 08:45:20,32
DAL,2016,2017,WR,6,7,4,2,3,66.67,33.33,42.86,1,2025-08-15 16:41:26,dal_roster_turnover_detailed.csv,2025-08-17 08:45:20,32
DAL,2017,2018,DB,9,9,4,5,5,44.44,55.56,55.56,0,2025-08-15 16:41:26,dal_roster_turnover_detailed.csv,2025-08-17 08:45:20,32
DAL,2017,2018,DL,11,8,3,8,5,27.27,72.73,62.5,-3,2025-08-15 16:41:26,dal_roster_turnover_detailed.csv,2025-08-17 08:45:20,32
DAL,2017,2018,LB,6,4,2,4,2,33.33,66.67,50.0,-2,2025-08-15 16:41:26,dal_roster_turnover_detailed.csv,2025-08-17 08:45:20,32
DAL,2017,2018,OL,4,3,1,3,2,25.0,75.0,66.67,-1,2025-08-15 16:41:26,dal_roster_turnover_detailed.csv,2025-08-17 08:45:20,32
DAL,2017,2018,OTHER,12,15,8,4,7,66.67,33.33,46.67,3,2025-08-15 16:41:26,dal_roster_turnover_detailed.csv,2025-08-17 08:45:20,32
DAL,2017,2018,QB,2,2,2,0,0,100.0,0.0,0.0,0,2025-08-15 16:41:26,dal_roster_turnover_detailed.csv,2025-08-17 08:45:20,32
DAL,2017,2018,RB,4,4,2,2,2,50.0,50.0,50.0,0,2025-08-15 16:41:26,dal_roster_turnover_detailed.csv,2025-08-17 08:45:20,32
DAL,2017,2018,ST,3,2,1,2,1,33.33,66.67,50.0,-1,2025-08-15 16:41:26,dal_roster_turnover_detailed.csv,2025-08-17 08:45:20,32
DAL,2017,2018,TE,4,4,2,2,2,50.0,50.0,50.0,0,2025-08-15 16:41:26,dal_roster_turnover_detailed.csv,2025-08-17 08:45:20,32
DAL,2017,2018,WR,7,10,5,2,5,71.43,28.57,50.0,3,2025-08-15 16:41:26,dal_roster_turnover_detailed.csv,2025-08-17 08:45:20,32
DAL,2018,2019,DB,9,10,7,2,3,77.78,22.22,30.0,1,2025-08-15 16:41:26,dal_roster_turnover_detailed.csv,2025-08-17 08:45:20,32
DAL,2018,2019,DL,8,7,2,6,5,25.0,75.0,71.43,-1,2025-08-15 16:41:26,dal_roster_turnover_detailed.csv,2025-08-17 08:45:20,32
DAL,2018,2019,LB,4,6,4,0,2,100.0,0.0,33.33,2,2025-08-15 16:41:26,dal_roster_turnover_detailed.csv,2025-08-17 08:45:20,32
DAL,2018,2019,OL,3,5,2,1,3,66.67,33.33,60.0,2,2025-08-15 16:41:26,dal_roster_turnover_detailed.csv,2025-08-17 08:45:20,32
DAL,2018,2019,OTHER,15,13,11,4,2,73.33,26.67,15.38,-2,2025-08-15 16:41:26,dal_roster_turnover_detailed.csv,2025-08-17 08:45:20,32
DAL,2018,2019,QB,2,2,2,0,0,100.0,0.0,0.0,0,2025-08-15 16:41:26,dal_roster_turnover_detailed.csv,2025-08-17 08:45:20,32
DAL,2018,2019,RB,4,5,2,2,3,50.0,50.0,60.0,1,2025-08-15 16:41:26,dal_roster_turnover_detailed.csv,2025-08-17 08:45:20,32
DAL,2018,2019,ST,2,3,2,0,1,100.0,0.0,33.33,1,2025-08-15 16:41:26,dal_roster_turnover_detailed.csv,2025-08-17 08:45:20,32
DAL,2018,2019,TE,4,3,2,2,1,50.0,50.0,33.33,-1,2025-08-15 16:41:26,dal_roster_turnover_detailed.csv,2025-08-17 08:45:20,32
DAL,2018,2019,WR,10,8,3,7,5,30.0,70.0,62.5,-2,2025-08-15 16:41:26,dal_roster_turnover_detailed.csv,2025-08-17 08:45:20,32
DAL,2019,2020,DB,10,13,5,5,8,50.0,50.0,61.54,3,2025-08-15 16:41:26,dal_roster_turnover_detailed.csv,2025-08-17 08:45:20,32
DAL,2019,2020,DL,7,15,4,3,11,57.14,42.86,73.33,8,2025-08-15 16:41:26,dal_roster_turnover_detailed.csv,2025-08-17 08:45:20,32
DAL,2019,2020,LB,6,6,3,3,3,50.0,50.0,50.0,0,2025-08-15 16:41:26,dal_roster_turnover_detailed.csv,2025-08-17 08:45:20,32
DAL,2019,2020,OL,5,7,1,4,6,20.0,80.0,85.71,2,2025-08-15 16:41:26,dal_roster_turnover_detailed.csv,2025-08-17 08:45:20,32
DAL,2019,2020,OTHER,13,10,2,11,8,15.38,84.62,80.0,-3,2025-08-15 16:41:26,dal_roster_turnover_detailed.csv,2025-08-17 08:45:20,32
DAL,2019,2020,QB,2,4,1,1,3,50.0,50.0,75.0,2,2025-08-15 16:41:26,dal_roster_turnover_detailed.csv,2025-08-17 08:45:20,32
DAL,2019,2020,RB,5,4,2,3,2,40.0,60.0,50.0,-1,2025-08-15 16:41:26,dal_roster_turnover_detailed.csv,2025-08-17 08:45:20,32
DAL,2019,2020,ST,3,3,1,2,2,33.33,66.67,66.67,0,2025-08-15 16:41:26,dal_roster_turnover_detailed.csv,2025-08-17 08:45:20,32
DAL,2019,2020,TE,3,4,2,1,2,66.67,33.33,50.0,1,2025-08-15 16:41:26,dal_roster_turnover_detailed.csv,2025-08-17 08:45:20,32
DAL,2019,2020,WR,8,7,4,4,3,50.0,50.0,42.86,-1,2025-08-15 16:41:26,dal_roster_turnover_detailed.csv,2025-08-17 08:45:20,32
DAL,2020,2021,DB,13,13,4,9,9,30.77,69.23,69.23,0,2025-08-15 16:41:26,dal_roster_turnover_detailed.csv,2025-08-17 08:45:20,32
DAL,2020,2021,DL,15,7,4,11,3,26.67,73.33,42.86,-8,2025-08-15 16:41:26,dal_roster_turnover_detailed.csv,2025-08-17 08:45:20,32
DAL,2020,2021,LB,6,7,2,4,5,33.33,66.67,71.43,1,2025-08-15 16:41:26,dal_roster_turnover_detailed.csv,2025-08-17 08:45:20,32
DAL,2020,2021,OL,7,4,1,6,3,14.29,85.71,75.0,-3,2025-08-15 16:41:26,dal_roster_turnover_detailed.csv,2025-08-17 08:45:20,32
DAL,2020,2021,OTHER,10,16,6,4,10,60.0,40.0,62.5,6,2025-08-15 16:41:26,dal_roster_turnover_detailed.csv,2025-08-17 08:45:20,32
DAL,2020,2021,QB,4,2,1,3,1,25.0,75.0,50.0,-2,2025-08-15 16:41:26,dal_roster_turnover_detailed.csv,2025-08-17 08:45:20,32
DAL,2020,2021,RB,4,6,2,2,4,50.0,50.0,66.67,2,2025-08-15 16:41:26,dal_roster_turnover_detailed.csv,2025-08-17 08:45:20,32
DAL,2020,2021,ST,3,4,1,2,3,33.33,66.67,75.0,1,2025-08-15 16:41:26,dal_roster_turnover_detailed.csv,2025-08-17 08:45:20,32
DAL,2020,2021,TE,4,5,3,1,2,75.0,25.0,40.0,1,2025-08-15 16:41:26,dal_roster_turnover_detailed.csv,2025-08-17 08:45:20,32
DAL,2020,2021,WR,7,8,7,0,1,100.0,0.0,12.5,1,2025-08-15 16:41:26,dal_roster_turnover_detailed.csv,2025-08-17 08:45:20,32
DAL,2021,2022,DB,13,13,9,4,4,69.23,30.77,30.77,0,2025-08-15 16:41:26,dal_roster_turnover_detailed.csv,2025-08-17 08:45:20,32
DAL,2021,2022,DL,7,7,2,5,5,28.57,71.43,71.43,0,2025-08-15 16:41:26,dal_roster_turnover_detailed.csv,2025-08-17 08:45:20,32
DAL,2021,2022,LB,7,7,3,4,4,42.86,57.14,57.14,0,2025-08-15 16:41:26,dal_roster_turnover_detailed.csv,2025-08-17 08:45:20,32
DAL,2021,2022,OL,4,10,2,2,8,50.0,50.0,80.0,6,2025-08-15 16:41:26,dal_roster_turnover_detailed.csv,2025-08-17 08:45:20,32
DAL,2021,2022,OTHER,16,12,9,7,3,56.25,43.75,25.0,-4,2025-08-15 16:41:26,dal_roster_turnover_detailed.csv,2025-08-17 08:45:20,32
DAL,2021,2022,QB,2,2,2,0,0,100.0,0.0,0.0,0,2025-08-15 16:41:26,dal_roster_turnover_detailed.csv,2025-08-17 08:45:20,32
DAL,2021,2022,RB,6,5,2,4,3,33.33,66.67,60.0,-1,2025-08-15 16:41:26,dal_roster_turnover_detailed.csv,2025-08-17 08:45:20,32
DAL,2021,2022,ST,4,4,2,2,2,50.0,50.0,50.0,0,2025-08-15 16:41:26,dal_roster_turnover_detailed.csv,2025-08-17 08:45:20,32
DAL,2021,2022,TE,5,4,2,3,2,40.0,60.0,50.0,-1,2025-08-15 16:41:26,dal_roster_turnover_detailed.csv,2025-08-17 08:45:20,32
DAL,2021,2022,WR,8,9,4,4,5,50.0,50.0,55.56,1,2025-08-15 16:41:26,dal_roster_turnover_detailed.csv,2025-08-17 08:45:20,32
DAL,2022,2023,DB,13,14,9,4,5,69.23,30.77,35.71,1,2025-08-15 16:41:26,dal_roster_turnover_detailed.csv,2025-08-17 08:45:20,32
DAL,2022,2023,DL,7,11,4,3,7,57.14,42.86,63.64,4,2025-08-15 16:41:26,dal_roster_turnover_detailed.csv,2025-08-17 08:45:20,32
DAL,2022,2023,LB,7,7,3,4,4,42.86,57.14,57.14,0,2025-08-15 16:41:26,dal_roster_turnover_detailed.csv,2025-08-17 08:45:20,32
DAL,2022,2023,OL,10,11,4,6,7,40.0,60.0,63.64,1,2025-08-15 16:41:26,dal_roster_turnover_detailed.csv,2025-08-17 08:45:20,32
DAL,2022,2023,OTHER,12,0,0,12,0,0.0,100.0,0.0,-12,2025-08-15 16:41:26,dal_roster_turnover_detailed.csv,2025-08-17 08:45:20,32
DAL,2022,2023,QB,2,2,2,0,0,100.0,0.0,0.0,0,2025-08-15 16:41:26,dal_roster_turnover_detailed.csv,2025-08-17 08:45:20,32
DAL,2022,2023,RB,5,5,3,2,2,60.0,40.0,40.0,0,2025-08-15 16:41:26,dal_roster_turnover_detailed.csv,2025-08-17 08:45:20,32
DAL,2022,2023,ST,4,3,1,3,2,25.0,75.0,66.67,-1,2025-08-15 16:41:26,dal_roster_turnover_detailed.csv,2025-08-17 08:45:20,32
DAL,2022,2023,TE,4,6,3,1,3,75.0,25.0,50.0,2,2025-08-15 16:41:26,dal_roster_turnover_detailed.csv,2025-08-17 08:45:20,32
DAL,2022,2023,WR,9,6,4,5,2,44.44,55.56,33.33,-3,2025-08-15 16:41:26,dal_roster_turnover_detailed.csv,2025-08-17 08:45:20,32
DAL,2023,2024,DB,14,13,7,7,6,50.0,50.0,46.15,-1,2025-08-15 16:41:26,dal_roster_turnover_detailed.csv,2025-08-17 08:45:20,32
DAL,2023,2024,DL,11,8,2,9,6,18.18,81.82,75.0,-3,2025-08-15 16:41:26,dal_roster_turnover_detailed.csv,2025-08-17 08:45:20,32
DAL,2023,2024,LB,7,6,2,5,4,28.57,71.43,66.67,-1,2025-08-15 16:41:26,dal_roster_turnover_detailed.csv,2025-08-17 08:45:20,32
DAL,2023,2024,OL,11,7,5,6,2,45.45,54.55,28.57,-4,2025-08-15 16:41:26,dal_roster_turnover_detailed.csv,2025-08-17 08:45:20,32
DAL,2023,2024,OTHER,0,11,0,0,11,0.0,0.0,100.0,11,2025-08-15 16:41:26,dal_roster_turnover_detailed.csv,2025-08-17 08:45:20,32
DAL,2023,2024,QB,2,3,2,0,1,100.0,0.0,33.33,1,2025-08-15 16:41:26,dal_roster_turnover_detailed.csv,2025-08-17 08:45:20,32
DAL,2023,2024,RB,5,5,3,2,2,60.0,40.0,40.0,0,2025-08-15 16:41:26,dal_roster_turnover_detailed.csv,2025-08-17 08:45:20,32
DAL,2023,2024,ST,3,3,3,0,0,100.0,0.0,0.0,0,2025-08-15 16:41:26,dal_roster_turnover_detailed.csv,2025-08-17 08:45:20,32
DAL,2023,2024,TE,6,4,3,3,1,50.0,50.0,25.0,-2,2025-08-15 16:41:26,dal_roster_turnover_detailed.csv,2025-08-17 08:45:20,32
DAL,2023,2024,WR,6,8,5,1,3,83.33,16.67,37.5,2,2025-08-15 16:41:26,dal_roster_turnover_detailed.csv,2025-08-17 08:45:20,32
DEN,2011,2012,DB,10,9,4,6,5,40.0,60.0,55.56,-1,2025-08-15 16:41:28,den_roster_turnover_detailed.csv,2025-08-17 08:45:20,32
DEN,2011,2012,DL,6,6,2,4,4,33.33,66.67,66.67,0,2025-08-15 16:41:28,den_roster_turnover_detailed.csv,2025-08-17 08:45:20,32
DEN,2011,2012,LB,3,6,2,1,4,66.67,33.33,66.67,3,2025-08-15 16:41:28,den_roster_turnover_detailed.csv,2025-08-17 08:45:20,32
DEN,2011,2012,OL,4,4,1,3,3,25.0,75.0,75.0,0,2025-08-15 16:41:28,den_roster_turnover_detailed.csv,2025-08-17 08:45:20,32
DEN,2011,2012,OTHER,13,13,8,5,5,61.54,38.46,38.46,0,2025-08-15 16:41:28,den_roster_turnover_detailed.csv,2025-08-17 08:45:20,32
DEN,2011,2012,QB,2,2,0,2,2,0.0,100.0,100.0,0,2025-08-15 16:41:28,den_roster_turnover_detailed.csv,2025-08-17 08:45:20,32
DEN,2011,2012,RB,5,6,3,2,3,60.0,40.0,50.0,1,2025-08-15 16:41:28,den_roster_turnover_detailed.csv,2025-08-17 08:45:20,32
DEN,2011,2012,ST,3,3,2,1,1,66.67,33.33,33.33,0,2025-08-15 16:41:28,den_roster_turnover_detailed.csv,2025-08-17 08:45:20,32
DEN,2011,2012,TE,5,4,2,3,2,40.0,60.0,50.0,-1,2025-08-15 16:41:28,den_roster_turnover_detailed.csv,2025-08-17 08:45:20,32
DEN,2011,2012,WR,7,6,3,4,3,42.86,57.14,50.0,-1,2025-08-15 16:41:28,den_roster_turnover_detailed.csv,2025-08-17 08:45:20,32
DEN,2012,2013,DB,9,10,6,3,4,66.67,33.33,40.0,1,2025-08-15 16:41:28,den_roster_turnover_detailed.csv,2025-08-17 08:45:20,32
DEN,2012,2013,DL,6,5,2,4,3,33.33,66.67,60.0,-1,2025-08-15 16:41:28,den_roster_turnover_detailed.csv,2025-08-17 08:45:20,32
DEN,2012,2013,LB,6,5,2,4,3,33.33,66.67,60.0,-1,2025-08-15 16:41:28,den_roster_turnover_detailed.csv,2025-08-17 08:45:20,32
DEN,2012,2013,OL,4,6,0,4,6,0.0,100.0,100.0,2,2025-08-15 16:41:28,den_roster_turnover_detailed.csv,2025-08-17 08:45:20,32
DEN,2012,2013,OTHER,13,14,6,7,8,46.15,53.85,57.14,1,2025-08-15 16:41:28,den_roster_turnover_detailed.csv,2025-08-17 08:45:20,32
DEN,2012,2013,QB,2,2,2,0,0,100.0,0.0,0.0,0,2025-08-15 16:41:28,den_roster_turnover_detailed.csv,2025-08-17 08:45:20,32
DEN,2012,2013,RB,6,4,2,4,2,33.33,66.67,50.0,-2,2025-08-15 16:41:28,den_roster_turnover_detailed.csv,2025-08-17 08:45:20,32
DEN,2012,2013,ST,3,3,3,0,0,100.0,0.0,0.0,0,2025-08-15 16:41:28,den_roster_turnover_detailed.csv,2025-08-17 08:45:20,32
DEN,2012,2013,TE,4,4,4,0,0,100.0,0.0,0.0,0,2025-08-15 16:41:28,den_roster_turnover_detailed.csv,2025-08-17 08:45:20,32
DEN,2012,2013,WR,6,5,4,2,1,66.67,33.33,20.0,-1,2025-08-15 16:41:28,den_roster_turnover_detailed.csv,2025-08-17 08:45:20,32
DEN,2013,2014,DB,10,9,5,5,4,50.0,50.0,44.44,-1,2025-08-15 16:41:28,den_roster_turnover_detailed.csv,2025-08-17 08:45:20,32
DEN,2013,2014,DL,5,5,1,4,4,20.0,80.0,80.0,0,2025-08-15 16:41:28,den_roster_turnover_detailed.csv,2025-08-17 08:45:20,32
DEN,2013,2014,LB,5,7,2,3,5,40.0,60.0,71.43,2,2025-08-15 16:41:28,den_roster_turnover_detailed.csv,2025-08-17 08:45:20,32
DEN,2013,2014,OL,6,2,0,6,2,0.0,100.0,100.0,-4,2025-08-15 16:41:28,den_roster_turnover_detailed.csv,2025-08-17 08:45:20,32
DEN,2013,2014,OTHER,14,13,7,7,6,50.0,50.0,46.15,-1,2025-08-15 16:41:28,den_roster_turnover_detailed.csv,2025-08-17 08:45:20,32
DEN,2013,2014,QB,2,2,2,0,0,100.0,0.0,0.0,0,2025-08-15 16:41:28,den_roster_turnover_detailed.csv,2025-08-17 08:45:20,32
DEN,2013,2014,RB,4,5,3,1,2,75.0,25.0,40.0,1,2025-08-15 16:41:28,den_roster_turnover_detailed.csv,2025-08-17 08:45:20,32
DEN,2013,2014,ST,3,4,2,1,2,66.67,33.33,50.0,1,2025-08-15 16:41:28,den_roster_turnover_detailed.csv,2025-08-17 08:45:20,32
DEN,2013,2014,TE,4,4,3,1,1,75.0,25.0,25.0,0,2025-08-15 16:41:28,den_roster_turnover_detailed.csv,2025-08-17 08:45:20,32
DEN,2013,2014,WR,5,6,3,2,3,60.0,40.0,50.0,1,2025-08-15 16:41:28,den_roster_turnover_detailed.csv,2025-08-17 08:45:20,32
DEN,2014,2015,DB,9,9,6,3,3,66.67,33.33,33.33,0,2025-08-15 16:41:28,den_roster_turnover_detailed.csv,2025-08-17 08:45:20,32
DEN,2014,2015,DL,5,6,0,5,6,0.0,100.0,100.0,1,2025-08-15 16:41:28,den_roster_turnover_detailed.csv,2025-08-17 08:45:20,32
DEN,2014,2015,LB,7,4,3,4,1,42.86,57.14,25.0,-3,2025-08-15 16:41:28,den_roster_turnover_detailed.csv,2025-08-17 08:45:20,32
DEN,2014,2015,OL,2,4,0,2,4,0.0,100.0,100.0,2,2025-08-15 16:41:28,den_roster_turnover_detailed.csv,2025-08-17 08:45:20,32
DEN,2014,2015,OTHER,13,13,7,6,6,53.85,46.15,46.15,0,2025-08-15 16:41:28,den_roster_turnover_detailed.csv,2025-08-17 08:45:20,32
DEN,2014,2015,QB,2,3,2,0,1,100.0,0.0,33.33,1,2025-08-15 16:41:28,den_roster_turnover_detailed.csv,2025-08-17 08:45:20,32
DEN,2014,2015,RB,5,4,3,2,1,60.0,40.0,25.0,-1,2025-08-15 16:41:28,den_roster_turnover_detailed.csv,2025-08-17 08:45:20,32
DEN,2014,2015,ST,4,3,3,1,0,75.0,25.0,0.0,-1,2025-08-15 16:41:28,den_roster_turnover_detailed.csv,2025-08-17 08:45:20,32
DEN,2014,2015,TE,4,6,1,3,5,25.0,75.0,83.33,2,2025-08-15 16:41:28,den_roster_turnover_detailed.csv,2025-08-17 08:45:20,32
DEN,2014,2015,WR,6,6,4,2,2,66.67,33.33,33.33,0,2025-08-15 16:41:28,den_roster_turnover_detailed.csv,2025-08-17 08:45:20,32
DEN,2015,2016,DB,9,9,6,3,3,66.67,33.33,33.33,0,2025-08-15 16:41:28,den_roster_turnover_detailed.csv,2025-08-17 08:45:20,32
DEN,2015,2016,DL,6,5,2,4,3,33.33,66.67,60.0,-1,2025-08-15 16:41:28,den_roster_turnover_detailed.csv,2025-08-17 08:45:20,32
DEN,2015,2016,LB,4,6,1,3,5,25.0,75.0,83.33,2,2025-08-15 16:41:28,den_roster_turnover_detailed.csv,2025-08-17 08:45:20,32
DEN,2015,2016,OL,4,5,3,1,2,75.0,25.0,40.0,1,2025-08-15 16:41:28,den_roster_turnover_detailed.csv,2025-08-17 08:45:20,32
DEN,2015,2016,OTHER,13,14,8,5,6,61.54,38.46,42.86,1,2025-08-15 16:41:28,den_roster_turnover_detailed.csv,2025-08-17 08:45:20,32
DEN,2015,2016,QB,3,2,1,2,1,33.33,66.67,50.0,-1,2025-08-15 16:41:28,den_roster_turnover_detailed.csv,2025-08-17 08:45:20,32
DEN,2015,2016,RB,4,6,3,1,3,75.0,25.0,50.0,2,2025-08-15 16:41:28,den_roster_turnover_detailed.csv,2025-08-17 08:45:20,32
DEN,2015,2016,ST,3,3,1,2,2,33.33,66.67,66.67,0,2025-08-15 16:41:28,den_roster_turnover_detailed.csv,2025-08-17 08:45:20,32
DEN,2015,2016,TE,6,5,1,5,4,16.67,83.33,80.0,-1,2025-08-15 16:41:28,den_roster_turnover_detailed.csv,2025-08-17 08:45:20,32
DEN,2015,2016,WR,6,7,5,1,2,83.33,16.67,28.57,1,2025-08-15 16:41:28,den_roster_turnover_detailed.csv,2025-08-17 08:45:20,32
DEN,2016,2017,DB,9,9,5,4,4,55.56,44.44,44.44,0,2025-08-15 16:41:28,den_roster_turnover_detailed.csv,2025-08-17 08:45:20,32
DEN,2016,2017,DL,5,6,1,4,5,20.0,80.0,83.33,1,2025-08-15 16:41:28,den_roster_turnover_detailed.csv,2025-08-17 08:45:20,32
DEN,2016,2017,LB,6,6,1,5,5,16.67,83.33,83.33,0,2025-08-15 16:41:28,den_roster_turnover_detailed.csv,2025-08-17 08:45:20,32
DEN,2016,2017,OL,5,7,2,3,5,40.0,60.0,71.43,2,2025-08-15 16:41:28,den_roster_turnover_detailed.csv,2025-08-17 08:45:20,32
DEN,2016,2017,OTHER,14,15,8,6,7,57.14,42.86,46.67,1,2025-08-15 16:41:28,den_roster_turnover_detailed.csv,2025-08-17 08:45:20,32
DEN,2016,2017,QB,2,3,2,0,1,100.0,0.0,33.33,1,2025-08-15 16:41:28,den_roster_turnover_detailed.csv,2025-08-17 08:45:20,32
DEN,2016,2017,RB,6,5,3,3,2,50.0,50.0,40.0,-1,2025-08-15 16:41:28,den_roster_turnover_detailed.csv,2025-08-17 08:45:20,32
DEN,2016,2017,ST,3,3,3,0,0,100.0,0.0,0.0,0,2025-08-15 16:41:28,den_roster_turnover_detailed.csv,2025-08-17 08:45:20,32
DEN,2016,2017,TE,5,5,3,2,2,60.0,40.0,40.0,0,2025-08-15 16:41:28,den_roster_turnover_detailed.csv,2025-08-17 08:45:20,32
DEN,2016,2017,WR,7,7,5,2,2,71.43,28.57,28.57,0,2025-08-15 16:41:28,den_roster_turnover_detailed.csv,2025-08-17 08:45:20,32
DEN,2017,2018,DB,9,10,5,4,5,55.56,44.44,50.0,1,2025-08-15 16:41:28,den_roster_turnover_detailed.csv,2025-08-17 08:45:20,32
DEN,2017,2018,DL,6,5,3,3,2,50.0,50.0,40.0,-1,2025-08-15 16:41:28,den_roster_turnover_detailed.csv,2025-08-17 08:45:20,32
DEN,2017,2018,LB,6,6,1,5,5,16.67,83.33,83.33,0,2025-08-15 16:41:28,den_roster_turnover_detailed.csv,2025-08-17 08:45:20,32
DEN,2017,2018,OL,7,5,2,5,3,28.57,71.43,60.0,-2,2025-08-15 16:41:28,den_roster_turnover_detailed.csv,2025-08-17 08:45:20,32
DEN,2017,2018,OTHER,15,16,9,6,7,60.0,40.0,43.75,1,2025-08-15 16:41:28,den_roster_turnover_detailed.csv,2025-08-17 08:45:20,32
DEN,2017,2018,QB,3,2,0,3,2,0.0,100.0,100.0,-1,2025-08-15 16:41:28,den_roster_turnover_detailed.csv,2025-08-17 08:45:20,32
DEN,2017,2018,RB,5,4,2,3,2,40.0,60.0,50.0,-1,2025-08-15 16:41:28,den_roster_turnover_detailed.csv,2025-08-17 08:45:20,32
DEN,2017,2018,ST,3,4,2,1,2,66.67,33.33,50.0,1,2025-08-15 16:41:28,den_roster_turnover_detailed.csv,2025-08-17 08:45:20,32
DEN,2017,2018,TE,5,5,2,3,3,40.0,60.0,60.0,0,2025-08-15 16:41:28,den_roster_turnover_detailed.csv,2025-08-17 08:45:20,32
DEN,2017,2018,WR,7,8,3,4,5,42.86,57.14,62.5,1,2025-08-15 16:41:28,den_roster_turnover_detailed.csv,2025-08-17 08:45:20,32
DEN,2018,2019,DB,10,8,3,7,5,30.0,70.0,62.5,-2,2025-08-15 16:41:28,den_roster_turnover_detailed.csv,2025-08-17 08:45:20,32
DEN,2018,2019,DL,5,8,1,4,7,20.0,80.0,87.5,3,2025-08-15 16:41:28,den_roster_turnover_detailed.csv,2025-08-17 08:45:20,32
DEN,2018,2019,LB,6,7,2,4,5,33.33,66.67,71.43,1,2025-08-15 16:41:28,den_roster_turnover_detailed.csv,2025-08-17 08:45:20,32
DEN,2018,2019,OL,5,6,0,5,6,0.0,100.0,100.0,1,2025-08-15 16:41:28,den_roster_turnover_detailed.csv,2025-08-17 08:45:20,32
DEN,2018,2019,OTHER,16,14,7,9,7,43.75,56.25,50.0,-2,2025-08-15 16:41:28,den_roster_turnover_detailed.csv,2025-08-17 08:45:20,32
DEN,2018,2019,QB,2,3,0,2,3,0.0,100.0,100.0,1,2025-08-15 16:41:28,den_roster_turnover_detailed.csv,2025-08-17 08:45:20,32
DEN,2018,2019,RB,4,4,4,0,0,100.0,0.0,0.0,0,2025-08-15 16:41:28,den_roster_turnover_detailed.csv,2025-08-17 08:45:20,32
DEN,2018,2019,ST,4,3,3,1,0,75.0,25.0,0.0,-1,2025-08-15 16:41:28,den_roster_turnover_detailed.csv,2025-08-17 08:45:20,32
DEN,2018,2019,TE,5,4,1,4,3,20.0,80.0,75.0,-1,2025-08-15 16:41:28,den_roster_turnover_detailed.csv,2025-08-17 08:45:20,32
DEN,2018,2019,WR,8,8,5,3,3,62.5,37.5,37.5,0,2025-08-15 16:41:28,den_roster_turnover_detailed.csv,2025-08-17 08:45:20,32
DEN,2019,2020,DB,8,13,7,1,6,87.5,12.5,46.15,5,2025-08-15 16:41:28,den_roster_turnover_detailed.csv,2025-08-17 08:45:20,32
DEN,2019,2020,DL,8,9,2,6,7,25.0,75.0,77.78,1,2025-08-15 16:41:28,den_roster_turnover_detailed.csv,2025-08-17 08:45:20,32
DEN,2019,2020,LB,7,5,2,5,3,28.57,71.43,60.0,-2,2025-08-15 16:41:28,den_roster_turnover_detailed.csv,2025-08-17 08:45:20,32
DEN,2019,2020,OL,6,7,4,2,3,66.67,33.33,42.86,1,2025-08-15 16:41:28,den_roster_turnover_detailed.csv,2025-08-17 08:45:20,32
DEN,2019,2020,OTHER,14,14,6,8,8,42.86,57.14,57.14,0,2025-08-15 16:41:28,den_roster_turnover_detailed.csv,2025-08-17 08:45:20,32
DEN,2019,2020,QB,3,3,1,2,2,33.33,66.67,66.67,0,2025-08-15 16:41:28,den_roster_turnover_detailed.csv,2025-08-17 08:45:20,32
DEN,2019,2020,RB,4,5,2,2,3,50.0,50.0,60.0,1,2025-08-15 16:41:28,den_roster_turnover_detailed.csv,2025-08-17 08:45:20,32
DEN,2019,2020,ST,3,4,1,2,3,33.33,66.67,75.0,1,2025-08-15 16:41:28,den_roster_turnover_detailed.csv,2025-08-17 08:45:20,32
DEN,2019,2020,TE,4,6,3,1,3,75.0,25.0,50.0,2,2025-08-15 16:41:28,den_roster_turnover_detailed.csv,2025-08-17 08:45:20,32
DEN,2019,2020,WR,8,9,5,3,4,62.5,37.5,44.44,1,2025-08-15 16:41:28,den_roster_turnover_detailed.csv,2025-08-17 08:45:20,32
DEN,2020,2021,DB,13,11,5,8,6,38.46,61.54,54.55,-2,2025-08-15 16:41:28,den_roster_turnover_detailed.csv,2025-08-17 08:45:20,32
DEN,2020,2021,DL,9,6,3,6,3,33.33,66.67,50.0,-3,2025-08-15 16:41:28,den_roster_turnover_detailed.csv,2025-08-17 08:45:20,32
DEN,2020,2021,LB,5,9,0,5,9,0.0,100.0,100.0,4,2025-08-15 16:41:28,den_roster_turnover_detailed.csv,2025-08-17 08:45:20,32
DEN,2020,2021,OL,7,7,5,2,2,71.43,28.57,28.57,0,2025-08-15 16:41:28,den_roster_turnover_detailed.csv,2025-08-17 08:45:20,32
DEN,2020,2021,OTHER,14,17,8,6,9,57.14,42.86,52.94,3,2025-08-15 16:41:28,den_roster_turnover_detailed.csv,2025-08-17 08:45:20,32
DEN,2020,2021,QB,3,3,2,1,1,66.67,33.33,33.33,0,2025-08-15 16:41:28,den_roster_turnover_detailed.csv,2025-08-17 08:45:20,32
DEN,2020,2021,RB,5,4,1,4,3,20.0,80.0,75.0,-1,2025-08-15 16:41:28,den_roster_turnover_detailed.csv,2025-08-17 08:45:20,32
DEN,2020,2021,ST,4,3,3,1,0,75.0,25.0,0.0,-1,2025-08-15 16:41:28,den_roster_turnover_detailed.csv,2025-08-17 08:45:20,32
DEN,2020,2021,TE,6,4,3,3,1,50.0,50.0,25.0,-2,2025-08-15 16:41:28,den_roster_turnover_detailed.csv,2025-08-17 08:45:20,32
DEN,2020,2021,WR,9,11,7,2,4,77.78,22.22,36.36,2,2025-08-15 16:41:28,den_roster_turnover_detailed.csv,2025-08-17 08:45:20,32
DEN,2021,2022,DB,11,13,6,5,7,54.55,45.45,53.85,2,2025-08-15 16:41:28,den_roster_turnover_detailed.csv,2025-08-17 08:45:20,32
DEN,2021,2022,DL,6,8,2,4,6,33.33,66.67,75.0,2,2025-08-15 16:41:28,den_roster_turnover_detailed.csv,2025-08-17 08:45:20,32
DEN,2021,2022,LB,9,8,1,8,7,11.11,88.89,87.5,-1,2025-08-15 16:41:28,den_roster_turnover_detailed.csv,2025-08-17 08:45:20,32
DEN,2021,2022,OL,7,7,3,4,4,42.86,57.14,57.14,0,2025-08-15 16:41:28,den_roster_turnover_detailed.csv,2025-08-17 08:45:20,32
DEN,2021,2022,OTHER,17,17,8,9,9,47.06,52.94,52.94,0,2025-08-15 16:41:28,den_roster_turnover_detailed.csv,2025-08-17 08:45:20,32
DEN,2021,2022,QB,3,2,1,2,1,33.33,66.67,50.0,-1,2025-08-15 16:41:28,den_roster_turnover_detailed.csv,2025-08-17 08:45:20,32
DEN,2021,2022,RB,4,8,3,1,5,75.0,25.0,62.5,4,2025-08-15 16:41:28,den_roster_turnover_detailed.csv,2025-08-17 08:45:20,32
DEN,2021,2022,ST,3,4,2,1,2,66.67,33.33,50.0,1,2025-08-15 16:41:28,den_roster_turnover_detailed.csv,2025-08-17 08:45:20,32
DEN,2021,2022,TE,4,5,3,1,2,75.0,25.0,40.0,1,2025-08-15 16:41:28,den_roster_turnover_detailed.csv,2025-08-17 08:45:20,32
DEN,2021,2022,WR,11,9,5,6,4,45.45,54.55,44.44,-2,2025-08-15 16:41:28,den_roster_turnover_detailed.csv,2025-08-17 08:45:20,32
DEN,2022,2023,DB,13,13,7,6,6,53.85,46.15,46.15,0,2025-08-15 16:41:28,den_roster_turnover_detailed.csv,2025-08-17 08:45:20,32
DEN,2022,2023,DL,8,8,5,3,3,62.5,37.5,37.5,0,2025-08-15 16:41:28,den_roster_turnover_detailed.csv,2025-08-17 08:45:20,32
DEN,2022,2023,LB,8,11,2,6,9,25.0,75.0,81.82,3,2025-08-15 16:41:28,den_roster_turnover_detailed.csv,2025-08-17 08:45:20,32
DEN,2022,2023,OL,7,8,3,4,5,42.86,57.14,62.5,1,2025-08-15 16:41:28,den_roster_turnover_detailed.csv,2025-08-17 08:45:20,32
DEN,2022,2023,OTHER,17,0,0,17,0,0.0,100.0,0.0,-17,2025-08-15 16:41:28,den_roster_turnover_detailed.csv,2025-08-17 08:45:20,32
DEN,2022,2023,QB,2,2,1,1,1,50.0,50.0,50.0,0,2025-08-15 16:41:28,den_roster_turnover_detailed.csv,2025-08-17 08:45:20,32
DEN,2022,2023,RB,8,5,1,7,4,12.5,87.5,80.0,-3,2025-08-15 16:41:28,den_roster_turnover_detailed.csv,2025-08-17 08:45:20,32
DEN,2022,2023,ST,4,3,1,3,2,25.0,75.0,66.67,-1,2025-08-15 16:41:28,den_roster_turnover_detailed.csv,2025-08-17 08:45:20,32
DEN,2022,2023,TE,5,5,1,4,4,20.0,80.0,80.0,0,2025-08-15 16:41:28,den_roster_turnover_detailed.csv,2025-08-17 08:45:20,32
DEN,2022,2023,WR,9,9,3,6,6,33.33,66.67,66.67,0,2025-08-15 16:41:28,den_roster_turnover_detailed.csv,2025-08-17 08:45:20,32
DEN,2023,2024,DB,13,12,5,8,7,38.46,61.54,58.33,-1,2025-08-15 16:41:28,den_roster_turnover_detailed.csv,2025-08-17 08:45:20,32
DEN,2023,2024,DL,8,4,1,7,3,12.5,87.5,75.0,-4,2025-08-15 16:41:28,den_roster_turnover_detailed.csv,2025-08-17 08:45:20,32
DEN,2023,2024,LB,11,9,3,8,6,27.27,72.73,66.67,-2,2025-08-15 16:41:28,den_roster_turnover_detailed.csv,2025-08-17 08:45:20,32
DEN,2023,2024,OL,8,7,2,6,5,25.0,75.0,71.43,-1,2025-08-15 16:41:28,den_roster_turnover_detailed.csv,2025-08-17 08:45:20,32
DEN,2023,2024,OTHER,0,12,0,0,12,0.0,0.0,100.0,12,2025-08-15 16:41:28,den_roster_turnover_detailed.csv,2025-08-17 08:45:20,32
DEN,2023,2024,QB,2,2,1,1,1,50.0,50.0,50.0,0,2025-08-15 16:41:28,den_roster_turnover_detailed.csv,2025-08-17 08:45:20,32
DEN,2023,2024,RB,5,6,3,2,3,60.0,40.0,50.0,1,2025-08-15 16:41:28,den_roster_turnover_detailed.csv,2025-08-17 08:45:20,32
DEN,2023,2024,ST,3,3,3,0,0,100.0,0.0,0.0,0,2025-08-15 16:41:28,den_roster_turnover_detailed.csv,2025-08-17 08:45:20,32
DEN,2023,2024,TE,5,4,4,1,0,80.0,20.0,0.0,-1,2025-08-15 16:41:28,den_roster_turnover_detailed.csv,2025-08-17 08:45:20,32
DEN,2023,2024,WR,9,6,3,6,3,33.33,66.67,50.0,-3,2025-08-15 16:41:28,den_roster_turnover_detailed.csv,2025-08-17 08:45:20,32
DET,2011,2012,DB,12,15,7,5,8,58.33,41.67,53.33,3,2025-08-15 16:41:27,det_roster_turnover_detailed.csv,2025-08-17 08:45:20,32
DET,2011,2012,DL,7,6,4,3,2,57.14,42.86,33.33,-1,2025-08-15 16:41:27,det_roster_turnover_detailed.csv,2025-08-17 08:45:20,32
DET,2011,2012,LB,5,6,3,2,3,60.0,40.0,50.0,1,2025-08-15 16:41:27,det_roster_turnover_detailed.csv,2025-08-17 08:45:20,32
DET,2011,2012,OL,3,3,2,1,1,66.67,33.33,33.33,0,2025-08-15 16:41:27,det_roster_turnover_detailed.csv,2025-08-17 08:45:20,32
DET,2011,2012,OTHER,12,14,11,1,3,91.67,8.33,21.43,2,2025-08-15 16:41:27,det_roster_turnover_detailed.csv,2025-08-17 08:45:20,32
DET,2011,2012,QB,2,2,2,0,0,100.0,0.0,0.0,0,2025-08-15 16:41:27,det_roster_turnover_detailed.csv,2025-08-17 08:45:20,32
DET,2011,2012,RB,8,6,3,5,3,37.5,62.5,50.0,-2,2025-08-15 16:41:27,det_roster_turnover_detailed.csv,2025-08-17 08:45:20,32
DET,2011,2012,ST,5,4,3,2,1,60.0,40.0,25.0,-1,2025-08-15 16:41:27,det_roster_turnover_detailed.csv,2025-08-17 08:45:20,32
DET,2011,2012,TE,3,4,3,0,1,100.0,0.0,25.0,1,2025-08-15 16:41:27,det_roster_turnover_detailed.csv,2025-08-17 08:45:20,32
DET,2011,2012,WR,5,8,3,2,5,60.0,40.0,62.5,3,2025-08-15 16:41:27,det_roster_turnover_detailed.csv,2025-08-17 08:45:20,32
DET,2012,2013,DB,15,10,4,11,6,26.67,73.33,60.0,-5,2025-08-15 16:41:27,det_roster_turnover_detailed.csv,2025-08-17 08:45:20,32
DET,2012,2013,DL,6,7,1,5,6,16.67,83.33,85.71,1,2025-08-15 16:41:27,det_roster_turnover_detailed.csv,2025-08-17 08:45:20,32
DET,2012,2013,LB,6,5,3,3,2,50.0,50.0,40.0,-1,2025-08-15 16:41:27,det_roster_turnover_detailed.csv,2025-08-17 08:45:20,32
DET,2012,2013,OL,3,6,3,0,3,100.0,0.0,50.0,3,2025-08-15 16:41:27,det_roster_turnover_detailed.csv,2025-08-17 08:45:20,32
DET,2012,2013,OTHER,14,13,5,9,8,35.71,64.29,61.54,-1,2025-08-15 16:41:27,det_roster_turnover_detailed.csv,2025-08-17 08:45:20,32
DET,2012,2013,QB,2,2,2,0,0,100.0,0.0,0.0,0,2025-08-15 16:41:27,det_roster_turnover_detailed.csv,2025-08-17 08:45:20,32
DET,2012,2013,RB,6,5,2,4,3,33.33,66.67,60.0,-1,2025-08-15 16:41:27,det_roster_turnover_detailed.csv,2025-08-17 08:45:20,32
DET,2012,2013,ST,4,3,1,3,2,25.0,75.0,66.67,-1,2025-08-15 16:41:27,det_roster_turnover_detailed.csv,2025-08-17 08:45:20,32
DET,2012,2013,TE,4,5,2,2,3,50.0,50.0,60.0,1,2025-08-15 16:41:27,det_roster_turnover_detailed.csv,2025-08-17 08:45:20,32
DET,2012,2013,WR,8,8,4,4,4,50.0,50.0,50.0,0,2025-08-15 16:41:27,det_roster_turnover_detailed.csv,2025-08-17 08:45:20,32
DET,2013,2014,DB,10,12,3,7,9,30.0,70.0,75.0,2,2025-08-15 16:41:27,det_roster_turnover_detailed.csv,2025-08-17 08:45:20,32
DET,2013,2014,DL,7,5,2,5,3,28.57,71.43,60.0,-2,2025-08-15 16:41:27,det_roster_turnover_detailed.csv,2025-08-17 08:45:20,32
DET,2013,2014,LB,5,6,4,1,2,80.0,20.0,33.33,1,2025-08-15 16:41:27,det_roster_turnover_detailed.csv,2025-08-17 08:45:20,32
DET,2013,2014,OL,6,5,2,4,3,33.33,66.67,60.0,-1,2025-08-15 16:41:27,det_roster_turnover_detailed.csv,2025-08-17 08:45:20,32
DET,2013,2014,OTHER,13,14,10,3,4,76.92,23.08,28.57,1,2025-08-15 16:41:27,det_roster_turnover_detailed.csv,2025-08-17 08:45:20,32
DET,2013,2014,QB,2,1,1,1,0,50.0,50.0,0.0,-1,2025-08-15 16:41:27,det_roster_turnover_detailed.csv,2025-08-17 08:45:20,32
DET,2013,2014,RB,5,6,4,1,2,80.0,20.0,33.33,1,2025-08-15 16:41:27,det_roster_turnover_detailed.csv,2025-08-17 08:45:20,32
DET,2013,2014,ST,3,5,2,1,3,66.67,33.33,60.0,2,2025-08-15 16:41:27,det_roster_turnover_detailed.csv,2025-08-17 08:45:20,32
DET,2013,2014,TE,5,5,2,3,3,40.0,60.0,60.0,0,2025-08-15 16:41:27,det_roster_turnover_detailed.csv,2025-08-17 08:45:20,32
DET,2013,2014,WR,8,5,3,5,2,37.5,62.5,40.0,-3,2025-08-15 16:41:27,det_roster_turnover_detailed.csv,2025-08-17 08:45:20,32
DET,2014,2015,DB,12,9,5,7,4,41.67,58.33,44.44,-3,2025-08-15 16:41:27,det_roster_turnover_detailed.csv,2025-08-17 08:45:20,32
DET,2014,2015,DL,5,11,3,2,8,60.0,40.0,72.73,6,2025-08-15 16:41:27,det_roster_turnover_detailed.csv,2025-08-17 08:45:20,32
DET,2014,2015,LB,6,5,3,3,2,50.0,50.0,40.0,-1,2025-08-15 16:41:27,det_roster_turnover_detailed.csv,2025-08-17 08:45:20,32
DET,2014,2015,OL,5,5,1,4,4,20.0,80.0,80.0,0,2025-08-15 16:41:27,det_roster_turnover_detailed.csv,2025-08-17 08:45:20,32
DET,2014,2015,OTHER,14,15,7,7,8,50.0,50.0,53.33,1,2025-08-15 16:41:27,det_roster_turnover_detailed.csv,2025-08-17 08:45:20,32
DET,2014,2015,QB,1,2,1,0,1,100.0,0.0,50.0,1,2025-08-15 16:41:27,det_roster_turnover_detailed.csv,2025-08-17 08:45:20,32
DET,2014,2015,RB,6,5,3,3,2,50.0,50.0,40.0,-1,2025-08-15 16:41:27,det_roster_turnover_detailed.csv,2025-08-17 08:45:20,32
DET,2014,2015,ST,5,3,3,2,0,60.0,40.0,0.0,-2,2025-08-15 16:41:27,det_roster_turnover_detailed.csv,2025-08-17 08:45:20,32
DET,2014,2015,TE,5,5,2,3,3,40.0,60.0,60.0,0,2025-08-15 16:41:27,det_roster_turnover_detailed.csv,2025-08-17 08:45:20,32
DET,2014,2015,WR,5,5,3,2,2,60.0,40.0,40.0,0,2025-08-15 16:41:27,det_roster_turnover_detailed.csv,2025-08-17 08:45:20,32
DET,2015,2016,DB,9,12,4,5,8,44.44,55.56,66.67,3,2025-08-15 16:41:27,det_roster_turnover_detailed.csv,2025-08-17 08:45:20,32
DET,2015,2016,DL,11,5,1,10,4,9.09,90.91,80.0,-6,2025-08-15 16:41:27,det_roster_turnover_detailed.csv,2025-08-17 08:45:20,32
DET,2015,2016,LB,5,7,2,3,5,40.0,60.0,71.43,2,2025-08-15 16:41:27,det_roster_turnover_detailed.csv,2025-08-17 08:45:20,32
DET,2015,2016,OL,5,5,3,2,2,60.0,40.0,40.0,0,2025-08-15 16:41:27,det_roster_turnover_detailed.csv,2025-08-17 08:45:20,32
DET,2015,2016,OTHER,15,15,8,7,7,53.33,46.67,46.67,0,2025-08-15 16:41:27,det_roster_turnover_detailed.csv,2025-08-17 08:45:20,32
DET,2015,2016,QB,2,1,1,1,0,50.0,50.0,0.0,-1,2025-08-15 16:41:27,det_roster_turnover_detailed.csv,2025-08-17 08:45:20,32
DET,2015,2016,RB,5,7,4,1,3,80.0,20.0,42.86,2,2025-08-15 16:41:27,det_roster_turnover_detailed.csv,2025-08-17 08:45:20,32
DET,2015,2016,ST,3,3,3,0,0,100.0,0.0,0.0,0,2025-08-15 16:41:27,det_roster_turnover_detailed.csv,2025-08-17 08:45:20,32
DET,2015,2016,TE,5,6,1,4,5,20.0,80.0,83.33,1,2025-08-15 16:41:27,det_roster_turnover_detailed.csv,2025-08-17 08:45:20,32
DET,2015,2016,WR,5,5,2,3,3,40.0,60.0,60.0,0,2025-08-15 16:41:27,det_roster_turnover_detailed.csv,2025-08-17 08:45:20,32
DET,2016,2017,DB,12,9,5,7,4,41.67,58.33,44.44,-3,2025-08-15 16:41:27,det_roster_turnover_detailed.csv,2025-08-17 08:45:20,32
DET,2016,2017,DL,5,10,0,5,10,0.0,100.0,100.0,5,2025-08-15 16:41:27,det_roster_turnover_detailed.csv,2025-08-17 08:45:20,32
DET,2016,2017,LB,7,6,1,6,5,14.29,85.71,83.33,-1,2025-08-15 16:41:27,det_roster_turnover_detailed.csv,2025-08-17 08:45:20,32
DET,2016,2017,OL,5,8,3,2,5,60.0,40.0,62.5,3,2025-08-15 16:41:27,det_roster_turnover_detailed.csv,2025-08-17 08:45:20,32
DET,2016,2017,OTHER,15,14,7,8,7,46.67,53.33,50.0,-1,2025-08-15 16:41:27,det_roster_turnover_detailed.csv,2025-08-17 08:45:20,32
DET,2016,2017,QB,1,2,1,0,1,100.0,0.0,50.0,1,2025-08-15 16:41:27,det_roster_turnover_detailed.csv,2025-08-17 08:45:20,32
DET,2016,2017,RB,7,5,4,3,1,57.14,42.86,20.0,-2,2025-08-15 16:41:27,det_roster_turnover_detailed.csv,2025-08-17 08:45:20,32
DET,2016,2017,ST,3,5,3,0,2,100.0,0.0,40.0,2,2025-08-15 16:41:27,det_roster_turnover_detailed.csv,2025-08-17 08:45:20,32
DET,2016,2017,TE,6,4,1,5,3,16.67,83.33,75.0,-2,2025-08-15 16:41:27,det_roster_turnover_detailed.csv,2025-08-17 08:45:20,32
DET,2016,2017,WR,5,8,3,2,5,60.0,40.0,62.5,3,2025-08-15 16:41:27,det_roster_turnover_detailed.csv,2025-08-17 08:45:20,32
DET,2017,2018,DB,9,15,8,1,7,88.89,11.11,46.67,6,2025-08-15 16:41:27,det_roster_turnover_detailed.csv,2025-08-17 08:45:20,32
DET,2017,2018,DL,10,5,0,10,5,0.0,100.0,100.0,-5,2025-08-15 16:41:27,det_roster_turnover_detailed.csv,2025-08-17 08:45:20,32
DET,2017,2018,LB,6,7,2,4,5,33.33,66.67,71.43,1,2025-08-15 16:41:27,det_roster_turnover_detailed.csv,2025-08-17 08:45:20,32
DET,2017,2018,OL,8,4,1,7,3,12.5,87.5,75.0,-4,2025-08-15 16:41:27,det_roster_turnover_detailed.csv,2025-08-17 08:45:20,32
DET,2017,2018,OTHER,14,14,6,8,8,42.86,57.14,57.14,0,2025-08-15 16:41:27,det_roster_turnover_detailed.csv,2025-08-17 08:45:20,32
DET,2017,2018,QB,2,2,1,1,1,50.0,50.0,50.0,0,2025-08-15 16:41:27,det_roster_turnover_detailed.csv,2025-08-17 08:45:20,32
DET,2017,2018,RB,5,6,3,2,3,60.0,40.0,50.0,1,2025-08-15 16:41:27,det_roster_turnover_detailed.csv,2025-08-17 08:45:20,32
DET,2017,2018,ST,5,3,3,2,0,60.0,40.0,0.0,-2,2025-08-15 16:41:27,det_roster_turnover_detailed.csv,2025-08-17 08:45:20,32
DET,2017,2018,TE,4,5,2,2,3,50.0,50.0,60.0,1,2025-08-15 16:41:27,det_roster_turnover_detailed.csv,2025-08-17 08:45:20,32
DET,2017,2018,WR,8,9,6,2,3,75.0,25.0,33.33,1,2025-08-15 16:41:27,det_roster_turnover_detailed.csv,2025-08-17 08:45:20,32
DET,2018,2019,DB,15,12,7,8,5,46.67,53.33,41.67,-3,2025-08-15 16:41:27,det_roster_turnover_detailed.csv,2025-08-17 08:45:20,32
DET,2018,2019,DL,5,9,1,4,8,20.0,80.0,88.89,4,2025-08-15 16:41:27,det_roster_turnover_detailed.csv,2025-08-17 08:45:20,32
DET,2018,2019,LB,7,6,2,5,4,28.57,71.43,66.67,-1,2025-08-15 16:41:27,det_roster_turnover_detailed.csv,2025-08-17 08:45:20,32
DET,2018,2019,OL,4,5,0,4,5,0.0,100.0,100.0,1,2025-08-15 16:41:27,det_roster_turnover_detailed.csv,2025-08-17 08:45:20,32
DET,2018,2019,OTHER,14,12,7,7,5,50.0,50.0,41.67,-2,2025-08-15 16:41:27,det_roster_turnover_detailed.csv,2025-08-17 08:45:20,32
DET,2018,2019,QB,2,3,1,1,2,50.0,50.0,66.67,1,2025-08-15 16:41:27,det_roster_turnover_detailed.csv,2025-08-17 08:45:20,32
DET,2018,2019,RB,6,9,1,5,8,16.67,83.33,88.89,3,2025-08-15 16:41:27,det_roster_turnover_detailed.csv,2025-08-17 08:45:20,32
DET,2018,2019,ST,3,3,3,0,0,100.0,0.0,0.0,0,2025-08-15 16:41:27,det_roster_turnover_detailed.csv,2025-08-17 08:45:20,32
DET,2018,2019,TE,5,4,0,5,4,0.0,100.0,100.0,-1,2025-08-15 16:41:27,det_roster_turnover_detailed.csv,2025-08-17 08:45:20,32
DET,2018,2019,WR,9,7,3,6,4,33.33,66.67,57.14,-2,2025-08-15 16:41:27,det_roster_turnover_detailed.csv,2025-08-17 08:45:20,32
DET,2019,2020,DB,12,15,6,6,9,50.0,50.0,60.0,3,2025-08-15 16:41:27,det_roster_turnover_detailed.csv,2025-08-17 08:45:20,32
DET,2019,2020,DL,9,9,4,5,5,44.44,55.56,55.56,0,2025-08-15 16:41:27,det_roster_turnover_detailed.csv,2025-08-17 08:45:20,32
DET,2019,2020,LB,6,7,4,2,3,66.67,33.33,42.86,1,2025-08-15 16:41:27,det_roster_turnover_detailed.csv,2025-08-17 08:45:20,32
DET,2019,2020,OL,5,7,3,2,4,60.0,40.0,57.14,2,2025-08-15 16:41:27,det_roster_turnover_detailed.csv,2025-08-17 08:45:20,32
DET,2019,2020,OTHER,12,14,4,8,10,33.33,66.67,71.43,2,2025-08-15 16:41:27,det_roster_turnover_detailed.csv,2025-08-17 08:45:20,32
DET,2019,2020,QB,3,3,2,1,1,66.67,33.33,33.33,0,2025-08-15 16:41:27,det_roster_turnover_detailed.csv,2025-08-17 08:45:20,32
DET,2019,2020,RB,9,5,2,7,3,22.22,77.78,60.0,-4,2025-08-15 16:41:27,det_roster_turnover_detailed.csv,2025-08-17 08:45:20,32
DET,2019,2020,ST,3,3,2,1,1,66.67,33.33,33.33,0,2025-08-15 16:41:27,det_roster_turnover_detailed.csv,2025-08-17 08:45:20,32
DET,2019,2020,TE,4,4,3,1,1,75.0,25.0,25.0,0,2025-08-15 16:41:27,det_roster_turnover_detailed.csv,2025-08-17 08:45:20,32
DET,2019,2020,WR,7,7,4,3,3,57.14,42.86,42.86,0,2025-08-15 16:41:27,det_roster_turnover_detailed.csv,2025-08-17 08:45:20,32
DET,2020,2021,DB,15,16,4,11,12,26.67,73.33,75.0,1,2025-08-15 16:41:27,det_roster_turnover_detailed.csv,2025-08-17 08:45:20,32
DET,2020,2021,DL,9,9,2,7,7,22.22,77.78,77.78,0,2025-08-15 16:41:27,det_roster_turnover_detailed.csv,2025-08-17 08:45:20,32
DET,2020,2021,LB,7,9,2,5,7,28.57,71.43,77.78,2,2025-08-15 16:41:27,det_roster_turnover_detailed.csv,2025-08-17 08:45:20,32
DET,2020,2021,OL,7,9,4,3,5,57.14,42.86,55.56,2,2025-08-15 16:41:27,det_roster_turnover_detailed.csv,2025-08-17 08:45:20,32
DET,2020,2021,OTHER,14,14,5,9,9,35.71,64.29,64.29,0,2025-08-15 16:41:27,det_roster_turnover_detailed.csv,2025-08-17 08:45:20,32
DET,2020,2021,QB,3,3,1,2,2,33.33,66.67,66.67,0,2025-08-15 16:41:27,det_roster_turnover_detailed.csv,2025-08-17 08:45:20,32
DET,2020,2021,RB,5,5,1,4,4,20.0,80.0,80.0,0,2025-08-15 16:41:27,det_roster_turnover_detailed.csv,2025-08-17 08:45:20,32
DET,2020,2021,ST,3,5,1,2,4,33.33,66.67,80.0,2,2025-08-15 16:41:27,det_roster_turnover_detailed.csv,2025-08-17 08:45:20,32
DET,2020,2021,TE,4,6,1,3,5,25.0,75.0,83.33,2,2025-08-15 16:41:27,det_roster_turnover_detailed.csv,2025-08-17 08:45:20,32
DET,2020,2021,WR,7,9,1,6,8,14.29,85.71,88.89,2,2025-08-15 16:41:27,det_roster_turnover_detailed.csv,2025-08-17 08:45:20,32
DET,2021,2022,DB,16,13,7,9,6,43.75,56.25,46.15,-3,2025-08-15 16:41:27,det_roster_turnover_detailed.csv,2025-08-17 08:45:20,32
DET,2021,2022,DL,9,6,1,8,5,11.11,88.89,83.33,-3,2025-08-15 16:41:27,det_roster_turnover_detailed.csv,2025-08-17 08:45:20,32
DET,2021,2022,LB,9,9,5,4,4,55.56,44.44,44.44,0,2025-08-15 16:41:27,det_roster_turnover_detailed.csv,2025-08-17 08:45:20,32
DET,2021,2022,OL,9,6,2,7,4,22.22,77.78,66.67,-3,2025-08-15 16:41:27,det_roster_turnover_detailed.csv,2025-08-17 08:45:20,32
DET,2021,2022,OTHER,14,15,6,8,9,42.86,57.14,60.0,1,2025-08-15 16:41:27,det_roster_turnover_detailed.csv,2025-08-17 08:45:20,32
DET,2021,2022,QB,3,2,1,2,1,33.33,66.67,50.0,-1,2025-08-15 16:41:27,det_roster_turnover_detailed.csv,2025-08-17 08:45:20,32
DET,2021,2022,RB,5,4,3,2,1,60.0,40.0,25.0,-1,2025-08-15 16:41:27,det_roster_turnover_detailed.csv,2025-08-17 08:45:20,32
DET,2021,2022,ST,5,5,2,3,3,40.0,60.0,60.0,0,2025-08-15 16:41:27,det_roster_turnover_detailed.csv,2025-08-17 08:45:20,32
DET,2021,2022,TE,6,5,3,3,2,50.0,50.0,40.0,-1,2025-08-15 16:41:27,det_roster_turnover_detailed.csv,2025-08-17 08:45:20,32
DET,2021,2022,WR,9,11,6,3,5,66.67,33.33,45.45,2,2025-08-15 16:41:27,det_roster_turnover_detailed.csv,2025-08-17 08:45:20,32
DET,2022,2023,DB,13,14,4,9,10,30.77,69.23,71.43,1,2025-08-15 16:41:27,det_roster_turnover_detailed.csv,2025-08-17 08:45:20,32
DET,2022,2023,DL,6,12,4,2,8,66.67,33.33,66.67,6,2025-08-15 16:41:27,det_roster_turnover_detailed.csv,2025-08-17 08:45:20,32
DET,2022,2023,LB,9,10,5,4,5,55.56,44.44,50.0,1,2025-08-15 16:41:27,det_roster_turnover_detailed.csv,2025-08-17 08:45:20,32
DET,2022,2023,OL,6,12,3,3,9,50.0,50.0,75.0,6,2025-08-15 16:41:27,det_roster_turnover_detailed.csv,2025-08-17 08:45:20,32
DET,2022,2023,OTHER,15,1,1,14,0,6.67,93.33,0.0,-14,2025-08-15 16:41:27,det_roster_turnover_detailed.csv,2025-08-17 08:45:20,32
DET,2022,2023,QB,2,2,1,1,1,50.0,50.0,50.0,0,2025-08-15 16:41:27,det_roster_turnover_detailed.csv,2025-08-17 08:45:20,32
DET,2022,2023,RB,4,7,1,3,6,25.0,75.0,85.71,3,2025-08-15 16:41:27,det_roster_turnover_detailed.csv,2025-08-17 08:45:20,32
DET,2022,2023,ST,5,5,3,2,2,60.0,40.0,40.0,0,2025-08-15 16:41:27,det_roster_turnover_detailed.csv,2025-08-17 08:45:20,32
DET,2022,2023,TE,5,5,2,3,3,40.0,60.0,60.0,0,2025-08-15 16:41:27,det_roster_turnover_detailed.csv,2025-08-17 08:45:20,32
DET,2022,2023,WR,11,8,4,7,4,36.36,63.64,50.0,-3,2025-08-15 16:41:27,det_roster_turnover_detailed.csv,2025-08-17 08:45:20,32
DET,2023,2024,DB,14,13,7,7,6,50.0,50.0,46.15,-1,2025-08-15 16:41:27,det_roster_turnover_detailed.csv,2025-08-17 08:45:20,32
DET,2023,2024,DL,12,13,3,9,10,25.0,75.0,76.92,1,2025-08-15 16:41:27,det_roster_turnover_detailed.csv,2025-08-17 08:45:20,32
DET,2023,2024,LB,10,12,6,4,6,60.0,40.0,50.0,2,2025-08-15 16:41:27,det_roster_turnover_detailed.csv,2025-08-17 08:45:20,32
DET,2023,2024,OL,12,7,5,7,2,41.67,58.33,28.57,-5,2025-08-15 16:41:27,det_roster_turnover_detailed.csv,2025-08-17 08:45:20,32
DET,2023,2024,OTHER,1,12,0,1,12,0.0,100.0,100.0,11,2025-08-15 16:41:27,det_roster_turnover_detailed.csv,2025-08-17 08:45:20,32
DET,2023,2024,QB,2,3,2,0,1,100.0,0.0,33.33,1,2025-08-15 16:41:27,det_roster_turnover_detailed.csv,2025-08-17 08:45:20,32
DET,2023,2024,RB,7,5,3,4,2,42.86,57.14,40.0,-2,2025-08-15 16:41:27,det_roster_turnover_detailed.csv,2025-08-17 08:45:20,32
DET,2023,2024,ST,5,3,1,4,2,20.0,80.0,66.67,-2,2025-08-15 16:41:27,det_roster_turnover_detailed.csv,2025-08-17 08:45:20,32
DET,2023,2024,TE,5,5,3,2,2,60.0,40.0,40.0,0,2025-08-15 16:41:27,det_roster_turnover_detailed.csv,2025-08-17 08:45:20,32
DET,2023,2024,WR,8,8,3,5,5,37.5,62.5,62.5,0,2025-08-15 16:41:27,det_roster_turnover_detailed.csv,2025-08-17 08:45:20,32
GNB,2011,2012,DB,8,7,4,4,3,50.0,50.0,42.86,-1,2025-08-15 16:41:30,gnb_roster_turnover_detailed.csv,2025-08-17 08:45:20,32
GNB,2011,2012,DL,3,5,1,2,4,33.33,66.67,80.0,2,2025-08-15 16:41:30,gnb_roster_turnover_detailed.csv,2025-08-17 08:45:20,32
GNB,2011,2012,LB,8,7,6,2,1,75.0,25.0,14.29,-1,2025-08-15 16:41:30,gnb_roster_turnover_detailed.csv,2025-08-17 08:45:20,32
GNB,2011,2012,OL,3,4,1,2,3,33.33,66.67,75.0,1,2025-08-15 16:41:30,gnb_roster_turnover_detailed.csv,2025-08-17 08:45:20,32
GNB,2011,2012,OTHER,13,16,9,4,7,69.23,30.77,43.75,3,2025-08-15 16:41:30,gnb_roster_turnover_detailed.csv,2025-08-17 08:45:20,32
GNB,2011,2012,QB,2,2,1,1,1,50.0,50.0,50.0,0,2025-08-15 16:41:30,gnb_roster_turnover_detailed.csv,2025-08-17 08:45:20,32
GNB,2011,2012,RB,5,8,5,0,3,100.0,0.0,37.5,3,2025-08-15 16:41:30,gnb_roster_turnover_detailed.csv,2025-08-17 08:45:20,32
GNB,2011,2012,ST,2,2,2,0,0,100.0,0.0,0.0,0,2025-08-15 16:41:30,gnb_roster_turnover_detailed.csv,2025-08-17 08:45:20,32
GNB,2011,2012,TE,5,4,4,1,0,80.0,20.0,0.0,-1,2025-08-15 16:41:30,gnb_roster_turnover_detailed.csv,2025-08-17 08:45:20,32
GNB,2011,2012,WR,5,7,5,0,2,100.0,0.0,28.57,2,2025-08-15 16:41:30,gnb_roster_turnover_detailed.csv,2025-08-17 08:45:20,32
GNB,2012,2013,DB,7,10,6,1,4,85.71,14.29,40.0,3,2025-08-15 16:41:30,gnb_roster_turnover_detailed.csv,2025-08-17 08:45:20,32
GNB,2012,2013,DL,5,6,2,3,4,40.0,60.0,66.67,1,2025-08-15 16:41:30,gnb_roster_turnover_detailed.csv,2025-08-17 08:45:20,32
GNB,2012,2013,LB,7,7,3,4,4,42.86,57.14,57.14,0,2025-08-15 16:41:30,gnb_roster_turnover_detailed.csv,2025-08-17 08:45:20,32
GNB,2012,2013,OL,4,5,2,2,3,50.0,50.0,60.0,1,2025-08-15 16:41:30,gnb_roster_turnover_detailed.csv,2025-08-17 08:45:20,32
GNB,2012,2013,OTHER,16,13,8,8,5,50.0,50.0,38.46,-3,2025-08-15 16:41:30,gnb_roster_turnover_detailed.csv,2025-08-17 08:45:20,32
GNB,2012,2013,QB,2,4,1,1,3,50.0,50.0,75.0,2,2025-08-15 16:41:30,gnb_roster_turnover_detailed.csv,2025-08-17 08:45:20,32
GNB,2012,2013,RB,8,6,2,6,4,25.0,75.0,66.67,-2,2025-08-15 16:41:30,gnb_roster_turnover_detailed.csv,2025-08-17 08:45:20,32
GNB,2012,2013,ST,2,2,2,0,0,100.0,0.0,0.0,0,2025-08-15 16:41:30,gnb_roster_turnover_detailed.csv,2025-08-17 08:45:20,32
GNB,2012,2013,TE,4,5,2,2,3,50.0,50.0,60.0,1,2025-08-15 16:41:30,gnb_roster_turnover_detailed.csv,2025-08-17 08:45:20,32
GNB,2012,2013,WR,7,7,5,2,2,71.43,28.57,28.57,0,2025-08-15 16:41:30,gnb_roster_turnover_detailed.csv,2025-08-17 08:45:20,32
GNB,2013,2014,DB,10,9,7,3,2,70.0,30.0,22.22,-1,2025-08-15 16:41:30,gnb_roster_turnover_detailed.csv,2025-08-17 08:45:20,32
GNB,2013,2014,DL,6,5,2,4,3,33.33,66.67,60.0,-1,2025-08-15 16:41:30,gnb_roster_turnover_detailed.csv,2025-08-17 08:45:20,32
GNB,2013,2014,LB,7,6,2,5,4,28.57,71.43,66.67,-1,2025-08-15 16:41:30,gnb_roster_turnover_detailed.csv,2025-08-17 08:45:20,32
GNB,2013,2014,OL,5,5,2,3,3,40.0,60.0,60.0,0,2025-08-15 16:41:30,gnb_roster_turnover_detailed.csv,2025-08-17 08:45:20,32
GNB,2013,2014,OTHER,13,12,7,6,5,53.85,46.15,41.67,-1,2025-08-15 16:41:30,gnb_roster_turnover_detailed.csv,2025-08-17 08:45:20,32
GNB,2013,2014,QB,4,2,2,2,0,50.0,50.0,0.0,-2,2025-08-15 16:41:30,gnb_roster_turnover_detailed.csv,2025-08-17 08:45:20,32
GNB,2013,2014,RB,6,4,3,3,1,50.0,50.0,25.0,-2,2025-08-15 16:41:30,gnb_roster_turnover_detailed.csv,2025-08-17 08:45:20,32
GNB,2013,2014,ST,2,2,2,0,0,100.0,0.0,0.0,0,2025-08-15 16:41:30,gnb_roster_turnover_detailed.csv,2025-08-17 08:45:20,32
GNB,2013,2014,TE,5,5,3,2,2,60.0,40.0,40.0,0,2025-08-15 16:41:30,gnb_roster_turnover_detailed.csv,2025-08-17 08:45:20,32
GNB,2013,2014,WR,7,6,3,4,3,42.86,57.14,50.0,-1,2025-08-15 16:41:30,gnb_roster_turnover_detailed.csv,2025-08-17 08:45:20,32
GNB,2014,2015,DB,9,9,7,2,2,77.78,22.22,22.22,0,2025-08-15 16:41:30,gnb_roster_turnover_detailed.csv,2025-08-17 08:45:20,32
GNB,2014,2015,DL,5,5,3,2,2,60.0,40.0,40.0,0,2025-08-15 16:41:30,gnb_roster_turnover_detailed.csv,2025-08-17 08:45:20,32
GNB,2014,2015,LB,6,6,4,2,2,66.67,33.33,33.33,0,2025-08-15 16:41:30,gnb_roster_turnover_detailed.csv,2025-08-17 08:45:20,32
GNB,2014,2015,OL,5,4,3,2,1,60.0,40.0,25.0,-1,2025-08-15 16:41:30,gnb_roster_turnover_detailed.csv,2025-08-17 08:45:20,32
GNB,2014,2015,OTHER,12,14,8,4,6,66.67,33.33,42.86,2,2025-08-15 16:41:30,gnb_roster_turnover_detailed.csv,2025-08-17 08:45:20,32
GNB,2014,2015,QB,2,2,1,1,1,50.0,50.0,50.0,0,2025-08-15 16:41:30,gnb_roster_turnover_detailed.csv,2025-08-17 08:45:20,32
GNB,2014,2015,RB,4,6,3,1,3,75.0,25.0,50.0,2,2025-08-15 16:41:30,gnb_roster_turnover_detailed.csv,2025-08-17 08:45:20,32
GNB,2014,2015,ST,2,3,2,0,1,100.0,0.0,33.33,1,2025-08-15 16:41:30,gnb_roster_turnover_detailed.csv,2025-08-17 08:45:20,32
GNB,2014,2015,TE,5,4,3,2,1,60.0,40.0,25.0,-1,2025-08-15 16:41:30,gnb_roster_turnover_detailed.csv,2025-08-17 08:45:20,32
GNB,2014,2015,WR,6,6,3,3,3,50.0,50.0,50.0,0,2025-08-15 16:41:30,gnb_roster_turnover_detailed.csv,2025-08-17 08:45:20,32
GNB,2015,2016,DB,9,12,6,3,6,66.67,33.33,50.0,3,2025-08-15 16:41:30,gnb_roster_turnover_detailed.csv,2025-08-17 08:45:20,32
GNB,2015,2016,DL,5,7,2,3,5,40.0,60.0,71.43,2,2025-08-15 16:41:30,gnb_roster_turnover_detailed.csv,2025-08-17 08:45:20,32
GNB,2015,2016,LB,6,5,2,4,3,33.33,66.67,60.0,-1,2025-08-15 16:41:30,gnb_roster_turnover_detailed.csv,2025-08-17 08:45:20,32
GNB,2015,2016,OL,4,5,2,2,3,50.0,50.0,60.0,1,2025-08-15 16:41:30,gnb_roster_turnover_detailed.csv,2025-08-17 08:45:20,32
GNB,2015,2016,OTHER,14,13,8,6,5,57.14,42.86,38.46,-1,2025-08-15 16:41:30,gnb_roster_turnover_detailed.csv,2025-08-17 08:45:20,32
GNB,2015,2016,QB,2,2,1,1,1,50.0,50.0,50.0,0,2025-08-15 16:41:30,gnb_roster_turnover_detailed.csv,2025-08-17 08:45:20,32
GNB,2015,2016,RB,6,8,3,3,5,50.0,50.0,62.5,2,2025-08-15 16:41:30,gnb_roster_turnover_detailed.csv,2025-08-17 08:45:20,32
GNB,2015,2016,ST,3,2,1,2,1,33.33,66.67,50.0,-1,2025-08-15 16:41:30,gnb_roster_turnover_detailed.csv,2025-08-17 08:45:20,32
GNB,2015,2016,TE,4,3,2,2,1,50.0,50.0,33.33,-1,2025-08-15 16:41:30,gnb_roster_turnover_detailed.csv,2025-08-17 08:45:20,32
GNB,2015,2016,WR,6,8,4,2,4,66.67,33.33,50.0,2,2025-08-15 16:41:30,gnb_roster_turnover_detailed.csv,2025-08-17 08:45:20,32
GNB,2016,2017,DB,12,11,7,5,4,58.33,41.67,36.36,-1,2025-08-15 16:41:30,gnb_roster_turnover_detailed.csv,2025-08-17 08:45:20,32
GNB,2016,2017,DL,7,6,1,6,5,14.29,85.71,83.33,-1,2025-08-15 16:41:30,gnb_roster_turnover_detailed.csv,2025-08-17 08:45:20,32
GNB,2016,2017,LB,5,5,2,3,3,40.0,60.0,60.0,0,2025-08-15 16:41:30,gnb_roster_turnover_detailed.csv,2025-08-17 08:45:20,32
GNB,2016,2017,OL,5,5,2,3,3,40.0,60.0,60.0,0,2025-08-15 16:41:30,gnb_roster_turnover_detailed.csv,2025-08-17 08:45:20,32
GNB,2016,2017,OTHER,13,15,9,4,6,69.23,30.77,40.0,2,2025-08-15 16:41:30,gnb_roster_turnover_detailed.csv,2025-08-17 08:45:20,32
GNB,2016,2017,QB,2,3,2,0,1,100.0,0.0,33.33,1,2025-08-15 16:41:30,gnb_roster_turnover_detailed.csv,2025-08-17 08:45:20,32
GNB,2016,2017,RB,8,6,3,5,3,37.5,62.5,50.0,-2,2025-08-15 16:41:30,gnb_roster_turnover_detailed.csv,2025-08-17 08:45:20,32
GNB,2016,2017,ST,2,4,1,1,3,50.0,50.0,75.0,2,2025-08-15 16:41:30,gnb_roster_turnover_detailed.csv,2025-08-17 08:45:20,32
GNB,2016,2017,TE,3,4,1,2,3,33.33,66.67,75.0,1,2025-08-15 16:41:30,gnb_roster_turnover_detailed.csv,2025-08-17 08:45:20,32
GNB,2016,2017,WR,8,7,6,2,1,75.0,25.0,14.29,-1,2025-08-15 16:41:30,gnb_roster_turnover_detailed.csv,2025-08-17 08:45:20,32
GNB,2017,2018,DB,11,12,4,7,8,36.36,63.64,66.67,1,2025-08-15 16:41:30,gnb_roster_turnover_detailed.csv,2025-08-17 08:45:20,32
GNB,2017,2018,DL,6,8,3,3,5,50.0,50.0,62.5,2,2025-08-15 16:41:30,gnb_roster_turnover_detailed.csv,2025-08-17 08:45:20,32
GNB,2017,2018,LB,5,2,0,5,2,0.0,100.0,100.0,-3,2025-08-15 16:41:30,gnb_roster_turnover_detailed.csv,2025-08-17 08:45:20,32
GNB,2017,2018,OL,5,5,3,2,2,60.0,40.0,40.0,0,2025-08-15 16:41:30,gnb_roster_turnover_detailed.csv,2025-08-17 08:45:20,32
GNB,2017,2018,OTHER,15,16,10,5,6,66.67,33.33,37.5,1,2025-08-15 16:41:30,gnb_roster_turnover_detailed.csv,2025-08-17 08:45:20,32
GNB,2017,2018,QB,3,2,1,2,1,33.33,66.67,50.0,-1,2025-08-15 16:41:30,gnb_roster_turnover_detailed.csv,2025-08-17 08:45:20,32
GNB,2017,2018,RB,6,7,2,4,5,33.33,66.67,71.43,1,2025-08-15 16:41:30,gnb_roster_turnover_detailed.csv,2025-08-17 08:45:20,32
GNB,2017,2018,ST,4,3,1,3,2,25.0,75.0,66.67,-1,2025-08-15 16:41:30,gnb_roster_turnover_detailed.csv,2025-08-17 08:45:20,32
GNB,2017,2018,TE,4,4,1,3,3,25.0,75.0,75.0,0,2025-08-15 16:41:30,gnb_roster_turnover_detailed.csv,2025-08-17 08:45:20,32
GNB,2017,2018,WR,7,10,4,3,6,57.14,42.86,60.0,3,2025-08-15 16:41:30,gnb_roster_turnover_detailed.csv,2025-08-17 08:45:20,32
GNB,2018,2019,DB,12,11,5,7,6,41.67,58.33,54.55,-1,2025-08-15 16:41:30,gnb_roster_turnover_detailed.csv,2025-08-17 08:45:20,32
GNB,2018,2019,DL,8,6,3,5,3,37.5,62.5,50.0,-2,2025-08-15 16:41:30,gnb_roster_turnover_detailed.csv,2025-08-17 08:45:20,32
GNB,2018,2019,LB,2,3,1,1,2,50.0,50.0,66.67,1,2025-08-15 16:41:30,gnb_roster_turnover_detailed.csv,2025-08-17 08:45:20,32
GNB,2018,2019,OL,5,5,3,2,2,60.0,40.0,40.0,0,2025-08-15 16:41:30,gnb_roster_turnover_detailed.csv,2025-08-17 08:45:20,32
GNB,2018,2019,OTHER,16,12,6,10,6,37.5,62.5,50.0,-4,2025-08-15 16:41:30,gnb_roster_turnover_detailed.csv,2025-08-17 08:45:20,32
GNB,2018,2019,QB,2,2,1,1,1,50.0,50.0,50.0,0,2025-08-15 16:41:30,gnb_roster_turnover_detailed.csv,2025-08-17 08:45:20,32
GNB,2018,2019,RB,7,6,4,3,2,57.14,42.86,33.33,-1,2025-08-15 16:41:30,gnb_roster_turnover_detailed.csv,2025-08-17 08:45:20,32
GNB,2018,2019,ST,3,3,3,0,0,100.0,0.0,0.0,0,2025-08-15 16:41:30,gnb_roster_turnover_detailed.csv,2025-08-17 08:45:20,32
GNB,2018,2019,TE,4,5,3,1,2,75.0,25.0,40.0,1,2025-08-15 16:41:30,gnb_roster_turnover_detailed.csv,2025-08-17 08:45:20,32
GNB,2018,2019,WR,10,7,6,4,1,60.0,40.0,14.29,-3,2025-08-15 16:41:30,gnb_roster_turnover_detailed.csv,2025-08-17 08:45:20,32
GNB,2019,2020,DB,11,11,6,5,5,54.55,45.45,45.45,0,2025-08-15 16:41:30,gnb_roster_turnover_detailed.csv,2025-08-17 08:45:20,32
GNB,2019,2020,DL,6,10,3,3,7,50.0,50.0,70.0,4,2025-08-15 16:41:30,gnb_roster_turnover_detailed.csv,2025-08-17 08:45:20,32
GNB,2019,2020,LB,3,5,2,1,3,66.67,33.33,60.0,2,2025-08-15 16:41:30,gnb_roster_turnover_detailed.csv,2025-08-17 08:45:20,32
GNB,2019,2020,OL,5,5,2,3,3,40.0,60.0,60.0,0,2025-08-15 16:41:30,gnb_roster_turnover_detailed.csv,2025-08-17 08:45:20,32
GNB,2019,2020,OTHER,12,15,8,4,7,66.67,33.33,46.67,3,2025-08-15 16:41:30,gnb_roster_turnover_detailed.csv,2025-08-17 08:45:20,32
GNB,2019,2020,QB,2,2,2,0,0,100.0,0.0,0.0,0,2025-08-15 16:41:30,gnb_roster_turnover_detailed.csv,2025-08-17 08:45:20,32
GNB,2019,2020,RB,6,5,4,2,1,66.67,33.33,20.0,-1,2025-08-15 16:41:30,gnb_roster_turnover_detailed.csv,2025-08-17 08:45:20,32
GNB,2019,2020,ST,3,3,3,0,0,100.0,0.0,0.0,0,2025-08-15 16:41:30,gnb_roster_turnover_detailed.csv,2025-08-17 08:45:20,32
GNB,2019,2020,TE,5,6,3,2,3,60.0,40.0,50.0,1,2025-08-15 16:41:30,gnb_roster_turnover_detailed.csv,2025-08-17 08:45:20,32
GNB,2019,2020,WR,7,9,4,3,5,57.14,42.86,55.56,2,2025-08-15 16:41:30,gnb_roster_turnover_detailed.csv,2025-08-17 08:45:20,32
GNB,2020,2021,DB,11,10,5,6,5,45.45,54.55,50.0,-1,2025-08-15 16:41:30,gnb_roster_turnover_detailed.csv,2025-08-17 08:45:20,32
GNB,2020,2021,DL,10,8,3,7,5,30.0,70.0,62.5,-2,2025-08-15 16:41:30,gnb_roster_turnover_detailed.csv,2025-08-17 08:45:20,32
GNB,2020,2021,LB,5,7,3,2,4,60.0,40.0,57.14,2,2025-08-15 16:41:30,gnb_roster_turnover_detailed.csv,2025-08-17 08:45:20,32
GNB,2020,2021,OL,5,7,1,4,6,20.0,80.0,85.71,2,2025-08-15 16:41:30,gnb_roster_turnover_detailed.csv,2025-08-17 08:45:20,32
GNB,2020,2021,OTHER,15,14,7,8,7,46.67,53.33,50.0,-1,2025-08-15 16:41:30,gnb_roster_turnover_detailed.csv,2025-08-17 08:45:20,32
GNB,2020,2021,QB,2,3,1,1,2,50.0,50.0,66.67,1,2025-08-15 16:41:30,gnb_roster_turnover_detailed.csv,2025-08-17 08:45:20,32
GNB,2020,2021,RB,5,4,2,3,2,40.0,60.0,50.0,-1,2025-08-15 16:41:30,gnb_roster_turnover_detailed.csv,2025-08-17 08:45:20,32
GNB,2020,2021,ST,3,4,2,1,2,66.67,33.33,50.0,1,2025-08-15 16:41:30,gnb_roster_turnover_detailed.csv,2025-08-17 08:45:20,32
GNB,2020,2021,TE,6,5,4,2,1,66.67,33.33,20.0,-1,2025-08-15 16:41:30,gnb_roster_turnover_detailed.csv,2025-08-17 08:45:20,32
GNB,2020,2021,WR,9,9,6,3,3,66.67,33.33,33.33,0,2025-08-15 16:41:30,gnb_roster_turnover_detailed.csv,2025-08-17 08:45:20,32
GNB,2021,2022,DB,10,12,4,6,8,40.0,60.0,66.67,2,2025-08-15 16:41:30,gnb_roster_turnover_detailed.csv,2025-08-17 08:45:20,32
GNB,2021,2022,DL,8,4,3,5,1,37.5,62.5,25.0,-4,2025-08-15 16:41:30,gnb_roster_turnover_detailed.csv,2025-08-17 08:45:20,32
GNB,2021,2022,LB,7,7,3,4,4,42.86,57.14,57.14,0,2025-08-15 16:41:30,gnb_roster_turnover_detailed.csv,2025-08-17 08:45:20,32
GNB,2021,2022,OL,7,5,2,5,3,28.57,71.43,60.0,-2,2025-08-15 16:41:30,gnb_roster_turnover_detailed.csv,2025-08-17 08:45:20,32
GNB,2021,2022,OTHER,14,15,9,5,6,64.29,35.71,40.0,1,2025-08-15 16:41:30,gnb_roster_turnover_detailed.csv,2025-08-17 08:45:20,32
GNB,2021,2022,QB,3,2,2,1,0,66.67,33.33,0.0,-1,2025-08-15 16:41:30,gnb_roster_turnover_detailed.csv,2025-08-17 08:45:20,32
GNB,2021,2022,RB,4,4,4,0,0,100.0,0.0,0.0,0,2025-08-15 16:41:30,gnb_roster_turnover_detailed.csv,2025-08-17 08:45:20,32
GNB,2021,2022,ST,4,4,1,3,3,25.0,75.0,75.0,0,2025-08-15 16:41:30,gnb_roster_turnover_detailed.csv,2025-08-17 08:45:20,32
GNB,2021,2022,TE,5,4,4,1,0,80.0,20.0,0.0,-1,2025-08-15 16:41:30,gnb_roster_turnover_detailed.csv,2025-08-17 08:45:20,32
GNB,2021,2022,WR,9,8,4,5,4,44.44,55.56,50.0,-1,2025-08-15 16:41:30,gnb_roster_turnover_detailed.csv,2025-08-17 08:45:20,32
GNB,2022,2023,DB,12,17,6,6,11,50.0,50.0,64.71,5,2025-08-15 16:41:30,gnb_roster_turnover_detailed.csv,2025-08-17 08:45:20,32
GNB,2022,2023,DL,4,5,3,1,2,75.0,25.0,40.0,1,2025-08-15 16:41:30,gnb_roster_turnover_detailed.csv,2025-08-17 08:45:20,32
GNB,2022,2023,LB,7,11,3,4,8,42.86,57.14,72.73,4,2025-08-15 16:41:30,gnb_roster_turnover_detailed.csv,2025-08-17 08:45:20,32
GNB,2022,2023,OL,5,9,3,2,6,60.0,40.0,66.67,4,2025-08-15 16:41:30,gnb_roster_turnover_detailed.csv,2025-08-17 08:45:20,32
GNB,2022,2023,OTHER,15,3,2,13,1,13.33,86.67,33.33,-12,2025-08-15 16:41:30,gnb_roster_turnover_detailed.csv,2025-08-17 08:45:20,32
GNB,2022,2023,QB,2,2,1,1,1,50.0,50.0,50.0,0,2025-08-15 16:41:30,gnb_roster_turnover_detailed.csv,2025-08-17 08:45:20,32
GNB,2022,2023,RB,4,7,3,1,4,75.0,25.0,57.14,3,2025-08-15 16:41:30,gnb_roster_turnover_detailed.csv,2025-08-17 08:45:20,32
GNB,2022,2023,ST,4,3,0,4,3,0.0,100.0,100.0,-1,2025-08-15 16:41:30,gnb_roster_turnover_detailed.csv,2025-08-17 08:45:20,32
GNB,2022,2023,TE,4,4,1,3,3,25.0,75.0,75.0,0,2025-08-15 16:41:30,gnb_roster_turnover_detailed.csv,2025-08-17 08:45:20,32
GNB,2022,2023,WR,8,7,3,5,4,37.5,62.5,57.14,-1,2025-08-15 16:41:30,gnb_roster_turnover_detailed.csv,2025-08-17 08:45:20,32
GNB,2023,2024,DB,17,11,5,12,6,29.41,70.59,54.55,-6,2025-08-15 16:41:30,gnb_roster_turnover_detailed.csv,2025-08-17 08:45:20,32
GNB,2023,2024,DL,5,7,3,2,4,60.0,40.0,57.14,2,2025-08-15 16:41:30,gnb_roster_turnover_detailed.csv,2025-08-17 08:45:20,32
GNB,2023,2024,LB,11,3,1,10,2,9.09,90.91,66.67,-8,2025-08-15 16:41:30,gnb_roster_turnover_detailed.csv,2025-08-17 08:45:20,32
GNB,2023,2024,OL,9,6,1,8,5,11.11,88.89,83.33,-3,2025-08-15 16:41:30,gnb_roster_turnover_detailed.csv,2025-08-17 08:45:20,32
GNB,2023,2024,OTHER,3,12,0,3,12,0.0,100.0,100.0,9,2025-08-15 16:41:30,gnb_roster_turnover_detailed.csv,2025-08-17 08:45:20,32
GNB,2023,2024,QB,2,2,1,1,1,50.0,50.0,50.0,0,2025-08-15 16:41:30,gnb_roster_turnover_detailed.csv,2025-08-17 08:45:20,32
GNB,2023,2024,RB,7,5,1,6,4,14.29,85.71,80.0,-2,2025-08-15 16:41:30,gnb_roster_turnover_detailed.csv,2025-08-17 08:45:20,32
GNB,2023,2024,ST,3,4,2,1,2,66.67,33.33,50.0,1,2025-08-15 16:41:30,gnb_roster_turnover_detailed.csv,2025-08-17 08:45:20,32
GNB,2023,2024,TE,4,4,3,1,1,75.0,25.0,25.0,0,2025-08-15 16:41:30,gnb_roster_turnover_detailed.csv,2025-08-17 08:45:20,32
GNB,2023,2024,WR,7,6,6,1,0,85.71,14.29,0.0,-1,2025-08-15 16:41:30,gnb_roster_turnover_detailed.csv,2025-08-17 08:45:20,32
HTX,2011,2012,DB,10,11,7,3,4,70.0,30.0,36.36,1,2025-08-15 16:41:30,htx_roster_turnover_detailed.csv,2025-08-17 08:45:20,32
HTX,2011,2012,DL,5,6,4,1,2,80.0,20.0,33.33,1,2025-08-15 16:41:30,htx_roster_turnover_detailed.csv,2025-08-17 08:45:20,32
HTX,2011,2012,LB,4,5,2,2,3,50.0,50.0,60.0,1,2025-08-15 16:41:30,htx_roster_turnover_detailed.csv,2025-08-17 08:45:20,32
HTX,2011,2012,OL,6,4,2,4,2,33.33,66.67,50.0,-2,2025-08-15 16:41:30,htx_roster_turnover_detailed.csv,2025-08-17 08:45:20,32
HTX,2011,2012,OTHER,13,15,9,4,6,69.23,30.77,40.0,2,2025-08-15 16:41:30,htx_roster_turnover_detailed.csv,2025-08-17 08:45:20,32
HTX,2011,2012,QB,4,2,2,2,0,50.0,50.0,0.0,-2,2025-08-15 16:41:30,htx_roster_turnover_detailed.csv,2025-08-17 08:45:20,32
HTX,2011,2012,RB,7,7,3,4,4,42.86,57.14,57.14,0,2025-08-15 16:41:30,htx_roster_turnover_detailed.csv,2025-08-17 08:45:20,32
HTX,2011,2012,ST,4,3,1,3,2,25.0,75.0,66.67,-1,2025-08-15 16:41:30,htx_roster_turnover_detailed.csv,2025-08-17 08:45:20,32
HTX,2011,2012,TE,3,1,1,2,0,33.33,66.67,0.0,-2,2025-08-15 16:41:30,htx_roster_turnover_detailed.csv,2025-08-17 08:45:20,32
HTX,2011,2012,WR,8,6,3,5,3,37.5,62.5,50.0,-2,2025-08-15 16:41:30,htx_roster_turnover_detailed.csv,2025-08-17 08:45:20,32
HTX,2012,2013,DB,11,11,5,6,6,45.45,54.55,54.55,0,2025-08-15 16:41:30,htx_roster_turnover_detailed.csv,2025-08-17 08:45:20,32
HTX,2012,2013,DL,6,4,4,2,0,66.67,33.33,0.0,-2,2025-08-15 16:41:30,htx_roster_turnover_detailed.csv,2025-08-17 08:45:20,32
HTX,2012,2013,LB,5,9,1,4,8,20.0,80.0,88.89,4,2025-08-15 16:41:30,htx_roster_turnover_detailed.csv,2025-08-17 08:45:20,32
HTX,2012,2013,OL,4,5,3,1,2,75.0,25.0,40.0,1,2025-08-15 16:41:30,htx_roster_turnover_detailed.csv,2025-08-17 08:45:20,32
HTX,2012,2013,OTHER,15,13,10,5,3,66.67,33.33,23.08,-2,2025-08-15 16:41:30,htx_roster_turnover_detailed.csv,2025-08-17 08:45:20,32
HTX,2012,2013,QB,2,3,2,0,1,100.0,0.0,33.33,1,2025-08-15 16:41:30,htx_roster_turnover_detailed.csv,2025-08-17 08:45:20,32
HTX,2012,2013,RB,7,9,3,4,6,42.86,57.14,66.67,2,2025-08-15 16:41:30,htx_roster_turnover_detailed.csv,2025-08-17 08:45:20,32
HTX,2012,2013,ST,3,3,1,2,2,33.33,66.67,66.67,0,2025-08-15 16:41:30,htx_roster_turnover_detailed.csv,2025-08-17 08:45:20,32
HTX,2012,2013,TE,1,6,1,0,5,100.0,0.0,83.33,5,2025-08-15 16:41:30,htx_roster_turnover_detailed.csv,2025-08-17 08:45:20,32
HTX,2012,2013,WR,6,6,4,2,2,66.67,33.33,33.33,0,2025-08-15 16:41:30,htx_roster_turnover_detailed.csv,2025-08-17 08:45:20,32
HTX,2013,2014,DB,11,8,3,8,5,27.27,72.73,62.5,-3,2025-08-15 16:41:30,htx_roster_turnover_detailed.csv,2025-08-17 08:45:20,32
HTX,2013,2014,DL,4,4,1,3,3,25.0,75.0,75.0,0,2025-08-15 16:41:30,htx_roster_turnover_detailed.csv,2025-08-17 08:45:20,32
HTX,2013,2014,LB,9,9,3,6,6,33.33,66.67,66.67,0,2025-08-15 16:41:30,htx_roster_turnover_detailed.csv,2025-08-17 08:45:20,32
HTX,2013,2014,OL,5,4,1,4,3,20.0,80.0,75.0,-1,2025-08-15 16:41:30,htx_roster_turnover_detailed.csv,2025-08-17 08:45:20,32
HTX,2013,2014,OTHER,13,14,9,4,5,69.23,30.77,35.71,1,2025-08-15 16:41:30,htx_roster_turnover_detailed.csv,2025-08-17 08:45:20,32
HTX,2013,2014,QB,3,4,1,2,3,33.33,66.67,75.0,1,2025-08-15 16:41:30,htx_roster_turnover_detailed.csv,2025-08-17 08:45:20,32
HTX,2013,2014,RB,9,5,2,7,3,22.22,77.78,60.0,-4,2025-08-15 16:41:30,htx_roster_turnover_detailed.csv,2025-08-17 08:45:20,32
HTX,2013,2014,ST,3,3,3,0,0,100.0,0.0,0.0,0,2025-08-15 16:41:30,htx_roster_turnover_detailed.csv,2025-08-17 08:45:20,32
HTX,2013,2014,TE,6,4,2,4,2,33.33,66.67,50.0,-2,2025-08-15 16:41:30,htx_roster_turnover_detailed.csv,2025-08-17 08:45:20,32
HTX,2013,2014,WR,6,6,5,1,1,83.33,16.67,16.67,0,2025-08-15 16:41:30,htx_roster_turnover_detailed.csv,2025-08-17 08:45:20,32
HTX,2014,2015,DB,8,11,4,4,7,50.0,50.0,63.64,3,2025-08-15 16:41:30,htx_roster_turnover_detailed.csv,2025-08-17 08:45:20,32
HTX,2014,2015,DL,4,5,1,3,4,25.0,75.0,80.0,1,2025-08-15 16:41:30,htx_roster_turnover_detailed.csv,2025-08-17 08:45:20,32
HTX,2014,2015,LB,9,4,1,8,3,11.11,88.89,75.0,-5,2025-08-15 16:41:30,htx_roster_turnover_detailed.csv,2025-08-17 08:45:20,32
HTX,2014,2015,OL,4,5,1,3,4,25.0,75.0,80.0,1,2025-08-15 16:41:30,htx_roster_turnover_detailed.csv,2025-08-17 08:45:20,32
HTX,2014,2015,OTHER,14,15,9,5,6,64.29,35.71,40.0,1,2025-08-15 16:41:30,htx_roster_turnover_detailed.csv,2025-08-17 08:45:20,32
HTX,2014,2015,QB,4,5,1,3,4,25.0,75.0,80.0,1,2025-08-15 16:41:30,htx_roster_turnover_detailed.csv,2025-08-17 08:45:20,32
HTX,2014,2015,RB,5,6,4,1,2,80.0,20.0,33.33,1,2025-08-15 16:41:30,htx_roster_turnover_detailed.csv,2025-08-17 08:45:20,32
HTX,2014,2015,ST,3,4,3,0,1,100.0,0.0,25.0,1,2025-08-15 16:41:30,htx_roster_turnover_detailed.csv,2025-08-17 08:45:20,32
HTX,2014,2015,TE,4,3,3,1,0,75.0,25.0,0.0,-1,2025-08-15 16:41:30,htx_roster_turnover_detailed.csv,2025-08-17 08:45:20,32
HTX,2014,2015,WR,6,6,1,5,5,16.67,83.33,83.33,0,2025-08-15 16:41:30,htx_roster_turnover_detailed.csv,2025-08-17 08:45:20,32
HTX,2015,2016,DB,11,13,6,5,7,54.55,45.45,53.85,2,2025-08-15 16:41:30,htx_roster_turnover_detailed.csv,2025-08-17 08:45:20,32
HTX,2015,2016,DL,5,6,2,3,4,40.0,60.0,66.67,1,2025-08-15 16:41:30,htx_roster_turnover_detailed.csv,2025-08-17 08:45:20,32
HTX,2015,2016,LB,4,4,3,1,1,75.0,25.0,25.0,0,2025-08-15 16:41:30,htx_roster_turnover_detailed.csv,2025-08-17 08:45:20,32
HTX,2015,2016,OL,5,5,3,2,2,60.0,40.0,40.0,0,2025-08-15 16:41:30,htx_roster_turnover_detailed.csv,2025-08-17 08:45:20,32
HTX,2015,2016,OTHER,15,15,10,5,5,66.67,33.33,33.33,0,2025-08-15 16:41:30,htx_roster_turnover_detailed.csv,2025-08-17 08:45:20,32
HTX,2015,2016,QB,5,2,0,5,2,0.0,100.0,100.0,-3,2025-08-15 16:41:30,htx_roster_turnover_detailed.csv,2025-08-17 08:45:20,32
HTX,2015,2016,RB,6,6,4,2,2,66.67,33.33,33.33,0,2025-08-15 16:41:30,htx_roster_turnover_detailed.csv,2025-08-17 08:45:20,32
HTX,2015,2016,ST,4,3,3,1,0,75.0,25.0,0.0,-1,2025-08-15 16:41:30,htx_roster_turnover_detailed.csv,2025-08-17 08:45:20,32
HTX,2015,2016,TE,3,3,2,1,1,66.67,33.33,33.33,0,2025-08-15 16:41:30,htx_roster_turnover_detailed.csv,2025-08-17 08:45:20,32
HTX,2015,2016,WR,6,6,3,3,3,50.0,50.0,50.0,0,2025-08-15 16:41:30,htx_roster_turnover_detailed.csv,2025-08-17 08:45:20,32
HTX,2016,2017,DB,13,12,4,9,8,30.77,69.23,66.67,-1,2025-08-15 16:41:30,htx_roster_turnover_detailed.csv,2025-08-17 08:45:20,32
HTX,2016,2017,DL,6,8,2,4,6,33.33,66.67,75.0,2,2025-08-15 16:41:30,htx_roster_turnover_detailed.csv,2025-08-17 08:45:20,32
HTX,2016,2017,LB,4,6,1,3,5,25.0,75.0,83.33,2,2025-08-15 16:41:30,htx_roster_turnover_detailed.csv,2025-08-17 08:45:20,32
HTX,2016,2017,OL,5,7,1,4,6,20.0,80.0,85.71,2,2025-08-15 16:41:30,htx_roster_turnover_detailed.csv,2025-08-17 08:45:20,32
HTX,2016,2017,OTHER,15,16,10,5,6,66.67,33.33,37.5,1,2025-08-15 16:41:30,htx_roster_turnover_detailed.csv,2025-08-17 08:45:20,32
HTX,2016,2017,QB,2,4,1,1,3,50.0,50.0,75.0,2,2025-08-15 16:41:30,htx_roster_turnover_detailed.csv,2025-08-17 08:45:20,32
HTX,2016,2017,RB,6,7,4,2,3,66.67,33.33,42.86,1,2025-08-15 16:41:30,htx_roster_turnover_detailed.csv,2025-08-17 08:45:20,32
HTX,2016,2017,ST,3,3,2,1,1,66.67,33.33,33.33,0,2025-08-15 16:41:30,htx_roster_turnover_detailed.csv,2025-08-17 08:45:20,32
HTX,2016,2017,TE,3,6,3,0,3,100.0,0.0,50.0,3,2025-08-15 16:41:30,htx_roster_turnover_detailed.csv,2025-08-17 08:45:20,32
HTX,2016,2017,WR,6,9,4,2,5,66.67,33.33,55.56,3,2025-08-15 16:41:30,htx_roster_turnover_detailed.csv,2025-08-17 08:45:20,32
HTX,2017,2018,DB,12,11,2,10,9,16.67,83.33,81.82,-1,2025-08-15 16:41:30,htx_roster_turnover_detailed.csv,2025-08-17 08:45:20,32
HTX,2017,2018,DL,8,6,4,4,2,50.0,50.0,33.33,-2,2025-08-15 16:41:30,htx_roster_turnover_detailed.csv,2025-08-17 08:45:20,32
HTX,2017,2018,LB,6,6,2,4,4,33.33,66.67,66.67,0,2025-08-15 16:41:30,htx_roster_turnover_detailed.csv,2025-08-17 08:45:20,32
HTX,2017,2018,OL,7,6,1,6,5,14.29,85.71,83.33,-1,2025-08-15 16:41:30,htx_roster_turnover_detailed.csv,2025-08-17 08:45:20,32
HTX,2017,2018,OTHER,16,12,8,8,4,50.0,50.0,33.33,-4,2025-08-15 16:41:30,htx_roster_turnover_detailed.csv,2025-08-17 08:45:20,32
HTX,2017,2018,QB,4,2,1,3,1,25.0,75.0,50.0,-2,2025-08-15 16:41:30,htx_roster_turnover_detailed.csv,2025-08-17 08:45:20,32
HTX,2017,2018,RB,7,5,4,3,1,57.14,42.86,20.0,-2,2025-08-15 16:41:30,htx_roster_turnover_detailed.csv,2025-08-17 08:45:20,32
HTX,2017,2018,ST,3,3,2,1,1,66.67,33.33,33.33,0,2025-08-15 16:41:30,htx_roster_turnover_detailed.csv,2025-08-17 08:45:20,32
HTX,2017,2018,TE,6,3,1,5,2,16.67,83.33,66.67,-3,2025-08-15 16:41:30,htx_roster_turnover_detailed.csv,2025-08-17 08:45:20,32
HTX,2017,2018,WR,9,11,3,6,8,33.33,66.67,72.73,2,2025-08-15 16:41:30,htx_roster_turnover_detailed.csv,2025-08-17 08:45:20,32
HTX,2018,2019,DB,11,14,3,8,11,27.27,72.73,78.57,3,2025-08-15 16:41:30,htx_roster_turnover_detailed.csv,2025-08-17 08:45:20,32
HTX,2018,2019,DL,6,6,2,4,4,33.33,66.67,66.67,0,2025-08-15 16:41:30,htx_roster_turnover_detailed.csv,2025-08-17 08:45:20,32
HTX,2018,2019,LB,6,4,3,3,1,50.0,50.0,25.0,-2,2025-08-15 16:41:30,htx_roster_turnover_detailed.csv,2025-08-17 08:45:20,32
HTX,2018,2019,OL,6,6,4,2,2,66.67,33.33,33.33,0,2025-08-15 16:41:30,htx_roster_turnover_detailed.csv,2025-08-17 08:45:20,32
HTX,2018,2019,OTHER,12,15,6,6,9,50.0,50.0,60.0,3,2025-08-15 16:41:30,htx_roster_turnover_detailed.csv,2025-08-17 08:45:20,32
HTX,2018,2019,QB,2,2,1,1,1,50.0,50.0,50.0,0,2025-08-15 16:41:30,htx_roster_turnover_detailed.csv,2025-08-17 08:45:20,32
HTX,2018,2019,RB,5,5,1,4,4,20.0,80.0,80.0,0,2025-08-15 16:41:30,htx_roster_turnover_detailed.csv,2025-08-17 08:45:20,32
HTX,2018,2019,ST,3,4,3,0,1,100.0,0.0,25.0,1,2025-08-15 16:41:30,htx_roster_turnover_detailed.csv,2025-08-17 08:45:20,32
HTX,2018,2019,TE,3,4,2,1,2,66.67,33.33,50.0,1,2025-08-15 16:41:30,htx_roster_turnover_detailed.csv,2025-08-17 08:45:20,32
HTX,2018,2019,WR,11,6,5,6,1,45.45,54.55,16.67,-5,2025-08-15 16:41:30,htx_roster_turnover_detailed.csv,2025-08-17 08:45:20,32
HTX,2019,2020,DB,14,12,7,7,5,50.0,50.0,41.67,-2,2025-08-15 16:41:30,htx_roster_turnover_detailed.csv,2025-08-17 08:45:20,32
HTX,2019,2020,DL,6,7,2,4,5,33.33,66.67,71.43,1,2025-08-15 16:41:30,htx_roster_turnover_detailed.csv,2025-08-17 08:45:20,32
HTX,2019,2020,LB,4,6,2,2,4,50.0,50.0,66.67,2,2025-08-15 16:41:30,htx_roster_turnover_detailed.csv,2025-08-17 08:45:20,32
HTX,2019,2020,OL,6,6,3,3,3,50.0,50.0,50.0,0,2025-08-15 16:41:30,htx_roster_turnover_detailed.csv,2025-08-17 08:45:20,32
HTX,2019,2020,OTHER,15,14,9,6,5,60.0,40.0,35.71,-1,2025-08-15 16:41:30,htx_roster_turnover_detailed.csv,2025-08-17 08:45:20,32
HTX,2019,2020,QB,2,2,2,0,0,100.0,0.0,0.0,0,2025-08-15 16:41:30,htx_roster_turnover_detailed.csv,2025-08-17 08:45:20,32
HTX,2019,2020,RB,5,7,3,2,4,60.0,40.0,57.14,2,2025-08-15 16:41:30,htx_roster_turnover_detailed.csv,2025-08-17 08:45:20,32
HTX,2019,2020,ST,4,3,3,1,0,75.0,25.0,0.0,-1,2025-08-15 16:41:30,htx_roster_turnover_detailed.csv,2025-08-17 08:45:20,32
HTX,2019,2020,TE,4,4,2,2,2,50.0,50.0,50.0,0,2025-08-15 16:41:30,htx_roster_turnover_detailed.csv,2025-08-17 08:45:20,32
HTX,2019,2020,WR,6,9,5,1,4,83.33,16.67,44.44,3,2025-08-15 16:41:30,htx_roster_turnover_detailed.csv,2025-08-17 08:45:20,32
HTX,2020,2021,DB,12,12,5,7,7,41.67,58.33,58.33,0,2025-08-15 16:41:30,htx_roster_turnover_detailed.csv,2025-08-17 08:45:20,32
HTX,2020,2021,DL,7,11,2,5,9,28.57,71.43,81.82,4,2025-08-15 16:41:30,htx_roster_turnover_detailed.csv,2025-08-17 08:45:20,32
HTX,2020,2021,LB,6,11,0,6,11,0.0,100.0,100.0,5,2025-08-15 16:41:30,htx_roster_turnover_detailed.csv,2025-08-17 08:45:20,32
HTX,2020,2021,OL,6,5,0,6,5,0.0,100.0,100.0,-1,2025-08-15 16:41:30,htx_roster_turnover_detailed.csv,2025-08-17 08:45:20,32
HTX,2020,2021,OTHER,14,15,4,10,11,28.57,71.43,73.33,1,2025-08-15 16:41:30,htx_roster_turnover_detailed.csv,2025-08-17 08:45:20,32
HTX,2020,2021,QB,2,3,0,2,3,0.0,100.0,100.0,1,2025-08-15 16:41:30,htx_roster_turnover_detailed.csv,2025-08-17 08:45:20,32
HTX,2020,2021,RB,7,7,2,5,5,28.57,71.43,71.43,0,2025-08-15 16:41:30,htx_roster_turnover_detailed.csv,2025-08-17 08:45:20,32
HTX,2020,2021,ST,3,5,2,1,3,66.67,33.33,60.0,2,2025-08-15 16:41:30,htx_roster_turnover_detailed.csv,2025-08-17 08:45:20,32
HTX,2020,2021,TE,4,5,2,2,3,50.0,50.0,60.0,1,2025-08-15 16:41:30,htx_roster_turnover_detailed.csv,2025-08-17 08:45:20,32
HTX,2020,2021,WR,9,11,1,8,10,11.11,88.89,90.91,2,2025-08-15 16:41:30,htx_roster_turnover_detailed.csv,2025-08-17 08:45:20,32
HTX,2021,2022,DB,12,10,4,8,6,33.33,66.67,60.0,-2,2025-08-15 16:41:30,htx_roster_turnover_detailed.csv,2025-08-17 08:45:20,32
HTX,2021,2022,DL,11,8,3,8,5,27.27,72.73,62.5,-3,2025-08-15 16:41:30,htx_roster_turnover_detailed.csv,2025-08-17 08:45:20,32
HTX,2021,2022,LB,11,7,4,7,3,36.36,63.64,42.86,-4,2025-08-15 16:41:30,htx_roster_turnover_detailed.csv,2025-08-17 08:45:20,32
HTX,2021,2022,OL,5,7,2,3,5,40.0,60.0,71.43,2,2025-08-15 16:41:30,htx_roster_turnover_detailed.csv,2025-08-17 08:45:20,32
HTX,2021,2022,OTHER,15,14,5,10,9,33.33,66.67,64.29,-1,2025-08-15 16:41:30,htx_roster_turnover_detailed.csv,2025-08-17 08:45:20,32
HTX,2021,2022,QB,3,3,2,1,1,66.67,33.33,33.33,0,2025-08-15 16:41:30,htx_roster_turnover_detailed.csv,2025-08-17 08:45:20,32
HTX,2021,2022,RB,7,5,2,5,3,28.57,71.43,60.0,-2,2025-08-15 16:41:30,htx_roster_turnover_detailed.csv,2025-08-17 08:45:20,32
HTX,2021,2022,ST,5,3,3,2,0,60.0,40.0,0.0,-2,2025-08-15 16:41:30,htx_roster_turnover_detailed.csv,2025-08-17 08:45:20,32
HTX,2021,2022,TE,5,7,3,2,4,60.0,40.0,57.14,2,2025-08-15 16:41:30,htx_roster_turnover_detailed.csv,2025-08-17 08:45:20,32
HTX,2021,2022,WR,11,10,6,5,4,54.55,45.45,40.0,-1,2025-08-15 16:41:30,htx_roster_turnover_detailed.csv,2025-08-17 08:45:20,32
HTX,2022,2023,DB,10,18,5,5,13,50.0,50.0,72.22,8,2025-08-15 16:41:30,htx_roster_turnover_detailed.csv,2025-08-17 08:45:20,32
HTX,2022,2023,DL,8,13,1,7,12,12.5,87.5,92.31,5,2025-08-15 16:41:30,htx_roster_turnover_detailed.csv,2025-08-17 08:45:20,32
HTX,2022,2023,LB,7,8,4,3,4,57.14,42.86,50.0,1,2025-08-15 16:41:30,htx_roster_turnover_detailed.csv,2025-08-17 08:45:20,32
HTX,2022,2023,OL,7,15,3,4,12,42.86,57.14,80.0,8,2025-08-15 16:41:30,htx_roster_turnover_detailed.csv,2025-08-17 08:45:20,32
HTX,2022,2023,OTHER,14,2,0,14,2,0.0,100.0,100.0,-12,2025-08-15 16:41:30,htx_roster_turnover_detailed.csv,2025-08-17 08:45:20,32
HTX,2022,2023,QB,3,3,1,2,2,33.33,66.67,66.67,0,2025-08-15 16:41:30,htx_roster_turnover_detailed.csv,2025-08-17 08:45:20,32
HTX,2022,2023,RB,5,4,2,3,2,40.0,60.0,50.0,-1,2025-08-15 16:41:30,htx_roster_turnover_detailed.csv,2025-08-17 08:45:20,32
HTX,2022,2023,ST,3,5,3,0,2,100.0,0.0,40.0,2,2025-08-15 16:41:30,htx_roster_turnover_detailed.csv,2025-08-17 08:45:20,32
HTX,2022,2023,TE,7,5,2,5,3,28.57,71.43,60.0,-2,2025-08-15 16:41:30,htx_roster_turnover_detailed.csv,2025-08-17 08:45:20,32
HTX,2022,2023,WR,10,8,2,8,6,20.0,80.0,75.0,-2,2025-08-15 16:41:30,htx_roster_turnover_detailed.csv,2025-08-17 08:45:20,32
HTX,2023,2024,DB,18,12,8,10,4,44.44,55.56,33.33,-6,2025-08-15 16:41:30,htx_roster_turnover_detailed.csv,2025-08-17 08:45:20,32
HTX,2023,2024,DL,13,9,5,8,4,38.46,61.54,44.44,-4,2025-08-15 16:41:30,htx_roster_turnover_detailed.csv,2025-08-17 08:45:20,32
HTX,2023,2024,LB,8,9,3,5,6,37.5,62.5,66.67,1,2025-08-15 16:41:30,htx_roster_turnover_detailed.csv,2025-08-17 08:45:20,32
HTX,2023,2024,OL,15,7,5,10,2,33.33,66.67,28.57,-8,2025-08-15 16:41:30,htx_roster_turnover_detailed.csv,2025-08-17 08:45:20,32
HTX,2023,2024,OTHER,2,11,0,2,11,0.0,100.0,100.0,9,2025-08-15 16:41:30,htx_roster_turnover_detailed.csv,2025-08-17 08:45:20,32
HTX,2023,2024,QB,3,2,2,1,0,66.67,33.33,0.0,-1,2025-08-15 16:41:30,htx_roster_turnover_detailed.csv,2025-08-17 08:45:20,32
HTX,2023,2024,RB,4,8,3,1,5,75.0,25.0,62.5,4,2025-08-15 16:41:30,htx_roster_turnover_detailed.csv,2025-08-17 08:45:20,32
HTX,2023,2024,ST,5,3,2,3,1,40.0,60.0,33.33,-2,2025-08-15 16:41:30,htx_roster_turnover_detailed.csv,2025-08-17 08:45:20,32
HTX,2023,2024,TE,5,5,3,2,2,60.0,40.0,40.0,0,2025-08-15 16:41:30,htx_roster_turnover_detailed.csv,2025-08-17 08:45:20,32
HTX,2023,2024,WR,8,9,6,2,3,75.0,25.0,33.33,1,2025-08-15 16:41:30,htx_roster_turnover_detailed.csv,2025-08-17 08:45:20,32
JAX,2011,2012,DB,14,10,4,10,6,28.57,71.43,60.0,-4,2025-08-15 16:41:33,jax_roster_turnover_detailed.csv,2025-08-17 08:45:20,32
JAX,2011,2012,DL,8,7,2,6,5,25.0,75.0,71.43,-1,2025-08-15 16:41:33,jax_roster_turnover_detailed.csv,2025-08-17 08:45:20,32
JAX,2011,2012,LB,6,7,2,4,5,33.33,66.67,71.43,1,2025-08-15 16:41:33,jax_roster_turnover_detailed.csv,2025-08-17 08:45:20,32
JAX,2011,2012,OL,5,6,1,4,5,20.0,80.0,83.33,1,2025-08-15 16:41:33,jax_roster_turnover_detailed.csv,2025-08-17 08:45:20,32
JAX,2011,2012,OTHER,16,16,7,9,9,43.75,56.25,56.25,0,2025-08-15 16:41:33,jax_roster_turnover_detailed.csv,2025-08-17 08:45:20,32
JAX,2011,2012,QB,2,2,1,1,1,50.0,50.0,50.0,0,2025-08-15 16:41:33,jax_roster_turnover_detailed.csv,2025-08-17 08:45:20,32
JAX,2011,2012,RB,6,9,3,3,6,50.0,50.0,66.67,3,2025-08-15 16:41:33,jax_roster_turnover_detailed.csv,2025-08-17 08:45:20,32
JAX,2011,2012,ST,3,2,1,2,1,33.33,66.67,50.0,-1,2025-08-15 16:41:33,jax_roster_turnover_detailed.csv,2025-08-17 08:45:20,32
JAX,2011,2012,TE,6,4,3,3,1,50.0,50.0,25.0,-2,2025-08-15 16:41:33,jax_roster_turnover_detailed.csv,2025-08-17 08:45:20,32
JAX,2011,2012,WR,9,12,2,7,10,22.22,77.78,83.33,3,2025-08-15 16:41:33,jax_roster_turnover_detailed.csv,2025-08-17 08:45:20,32
JAX,2012,2013,DB,10,8,2,8,6,20.0,80.0,75.0,-2,2025-08-15 16:41:33,jax_roster_turnover_detailed.csv,2025-08-17 08:45:20,32
JAX,2012,2013,DL,7,8,1,6,7,14.29,85.71,87.5,1,2025-08-15 16:41:33,jax_roster_turnover_detailed.csv,2025-08-17 08:45:20,32
JAX,2012,2013,LB,7,6,1,6,5,14.29,85.71,83.33,-1,2025-08-15 16:41:33,jax_roster_turnover_detailed.csv,2025-08-17 08:45:20,32
JAX,2012,2013,OL,6,6,1,5,5,16.67,83.33,83.33,0,2025-08-15 16:41:33,jax_roster_turnover_detailed.csv,2025-08-17 08:45:20,32
JAX,2012,2013,OTHER,16,14,4,12,10,25.0,75.0,71.43,-2,2025-08-15 16:41:33,jax_roster_turnover_detailed.csv,2025-08-17 08:45:20,32
JAX,2012,2013,QB,2,2,2,0,0,100.0,0.0,0.0,0,2025-08-15 16:41:33,jax_roster_turnover_detailed.csv,2025-08-17 08:45:20,32
JAX,2012,2013,RB,9,5,3,6,2,33.33,66.67,40.0,-4,2025-08-15 16:41:33,jax_roster_turnover_detailed.csv,2025-08-17 08:45:20,32
JAX,2012,2013,ST,2,3,2,0,1,100.0,0.0,33.33,1,2025-08-15 16:41:33,jax_roster_turnover_detailed.csv,2025-08-17 08:45:20,32
JAX,2012,2013,TE,4,5,1,3,4,25.0,75.0,80.0,1,2025-08-15 16:41:33,jax_roster_turnover_detailed.csv,2025-08-17 08:45:20,32
JAX,2012,2013,WR,12,11,3,9,8,25.0,75.0,72.73,-1,2025-08-15 16:41:33,jax_roster_turnover_detailed.csv,2025-08-17 08:45:20,32
JAX,2013,2014,DB,8,12,4,4,8,50.0,50.0,66.67,4,2025-08-15 16:41:33,jax_roster_turnover_detailed.csv,2025-08-17 08:45:20,32
JAX,2013,2014,DL,8,5,2,6,3,25.0,75.0,60.0,-3,2025-08-15 16:41:33,jax_roster_turnover_detailed.csv,2025-08-17 08:45:20,32
JAX,2013,2014,LB,6,8,3,3,5,50.0,50.0,62.5,2,2025-08-15 16:41:33,jax_roster_turnover_detailed.csv,2025-08-17 08:45:20,32
JAX,2013,2014,OL,6,5,1,5,4,16.67,83.33,80.0,-1,2025-08-15 16:41:33,jax_roster_turnover_detailed.csv,2025-08-17 08:45:20,32
JAX,2013,2014,OTHER,14,14,6,8,8,42.86,57.14,57.14,0,2025-08-15 16:41:33,jax_roster_turnover_detailed.csv,2025-08-17 08:45:20,32
JAX,2013,2014,QB,2,2,1,1,1,50.0,50.0,50.0,0,2025-08-15 16:41:33,jax_roster_turnover_detailed.csv,2025-08-17 08:45:20,32
JAX,2013,2014,RB,5,5,2,3,3,40.0,60.0,60.0,0,2025-08-15 16:41:33,jax_roster_turnover_detailed.csv,2025-08-17 08:45:20,32
JAX,2013,2014,ST,3,3,3,0,0,100.0,0.0,0.0,0,2025-08-15 16:41:33,jax_roster_turnover_detailed.csv,2025-08-17 08:45:20,32
JAX,2013,2014,TE,5,5,2,3,3,40.0,60.0,60.0,0,2025-08-15 16:41:33,jax_roster_turnover_detailed.csv,2025-08-17 08:45:20,32
JAX,2013,2014,WR,11,7,3,8,4,27.27,72.73,57.14,-4,2025-08-15 16:41:33,jax_roster_turnover_detailed.csv,2025-08-17 08:45:20,32
JAX,2014,2015,DB,12,9,4,8,5,33.33,66.67,55.56,-3,2025-08-15 16:41:33,jax_roster_turnover_detailed.csv,2025-08-17 08:45:20,32
JAX,2014,2015,DL,5,5,2,3,3,40.0,60.0,60.0,0,2025-08-15 16:41:33,jax_roster_turnover_detailed.csv,2025-08-17 08:45:20,32
JAX,2014,2015,LB,8,9,3,5,6,37.5,62.5,66.67,1,2025-08-15 16:41:33,jax_roster_turnover_detailed.csv,2025-08-17 08:45:20,32
JAX,2014,2015,OL,5,5,2,3,3,40.0,60.0,60.0,0,2025-08-15 16:41:33,jax_roster_turnover_detailed.csv,2025-08-17 08:45:20,32
JAX,2014,2015,OTHER,14,13,5,9,8,35.71,64.29,61.54,-1,2025-08-15 16:41:33,jax_roster_turnover_detailed.csv,2025-08-17 08:45:20,32
JAX,2014,2015,QB,2,1,1,1,0,50.0,50.0,0.0,-1,2025-08-15 16:41:33,jax_roster_turnover_detailed.csv,2025-08-17 08:45:20,32
JAX,2014,2015,RB,5,6,1,4,5,20.0,80.0,83.33,1,2025-08-15 16:41:33,jax_roster_turnover_detailed.csv,2025-08-17 08:45:20,32
JAX,2014,2015,ST,3,3,2,1,1,66.67,33.33,33.33,0,2025-08-15 16:41:33,jax_roster_turnover_detailed.csv,2025-08-17 08:45:20,32
JAX,2014,2015,TE,5,4,3,2,1,60.0,40.0,25.0,-1,2025-08-15 16:41:33,jax_roster_turnover_detailed.csv,2025-08-17 08:45:20,32
JAX,2014,2015,WR,7,8,3,4,5,42.86,57.14,62.5,1,2025-08-15 16:41:33,jax_roster_turnover_detailed.csv,2025-08-17 08:45:20,32
JAX,2015,2016,DB,9,9,3,6,6,33.33,66.67,66.67,0,2025-08-15 16:41:33,jax_roster_turnover_detailed.csv,2025-08-17 08:45:20,32
JAX,2015,2016,DL,5,6,3,2,3,60.0,40.0,50.0,1,2025-08-15 16:41:33,jax_roster_turnover_detailed.csv,2025-08-17 08:45:20,32
JAX,2015,2016,LB,9,6,2,7,4,22.22,77.78,66.67,-3,2025-08-15 16:41:33,jax_roster_turnover_detailed.csv,2025-08-17 08:45:20,32
JAX,2015,2016,OL,5,7,3,2,4,60.0,40.0,57.14,2,2025-08-15 16:41:33,jax_roster_turnover_detailed.csv,2025-08-17 08:45:20,32
JAX,2015,2016,OTHER,13,14,6,7,8,46.15,53.85,57.14,1,2025-08-15 16:41:33,jax_roster_turnover_detailed.csv,2025-08-17 08:45:20,32
JAX,2015,2016,QB,1,2,1,0,1,100.0,0.0,50.0,1,2025-08-15 16:41:33,jax_roster_turnover_detailed.csv,2025-08-17 08:45:20,32
JAX,2015,2016,RB,6,5,3,3,2,50.0,50.0,40.0,-1,2025-08-15 16:41:33,jax_roster_turnover_detailed.csv,2025-08-17 08:45:20,32
JAX,2015,2016,ST,3,3,2,1,1,66.67,33.33,33.33,0,2025-08-15 16:41:33,jax_roster_turnover_detailed.csv,2025-08-17 08:45:20,32
JAX,2015,2016,TE,4,4,2,2,2,50.0,50.0,50.0,0,2025-08-15 16:41:33,jax_roster_turnover_detailed.csv,2025-08-17 08:45:20,32
JAX,2015,2016,WR,8,10,8,0,2,100.0,0.0,20.0,2,2025-08-15 16:41:33,jax_roster_turnover_detailed.csv,2025-08-17 08:45:20,32
JAX,2016,2017,DB,9,8,3,6,5,33.33,66.67,62.5,-1,2025-08-15 16:41:33,jax_roster_turnover_detailed.csv,2025-08-17 08:45:20,32
JAX,2016,2017,DL,6,7,2,4,5,33.33,66.67,71.43,1,2025-08-15 16:41:33,jax_roster_turnover_detailed.csv,2025-08-17 08:45:20,32
JAX,2016,2017,LB,6,4,1,5,3,16.67,83.33,75.0,-2,2025-08-15 16:41:33,jax_roster_turnover_detailed.csv,2025-08-17 08:45:20,32
JAX,2016,2017,OL,7,5,4,3,1,57.14,42.86,20.0,-2,2025-08-15 16:41:33,jax_roster_turnover_detailed.csv,2025-08-17 08:45:20,32
JAX,2016,2017,OTHER,14,13,9,5,4,64.29,35.71,30.77,-1,2025-08-15 16:41:33,jax_roster_turnover_detailed.csv,2025-08-17 08:45:20,32
JAX,2016,2017,QB,2,2,2,0,0,100.0,0.0,0.0,0,2025-08-15 16:41:33,jax_roster_turnover_detailed.csv,2025-08-17 08:45:20,32
JAX,2016,2017,RB,5,5,3,2,2,60.0,40.0,40.0,0,2025-08-15 16:41:33,jax_roster_turnover_detailed.csv,2025-08-17 08:45:20,32
JAX,2016,2017,ST,3,5,2,1,3,66.67,33.33,60.0,2,2025-08-15 16:41:33,jax_roster_turnover_detailed.csv,2025-08-17 08:45:20,32
JAX,2016,2017,TE,4,3,2,2,1,50.0,50.0,33.33,-1,2025-08-15 16:41:33,jax_roster_turnover_detailed.csv,2025-08-17 08:45:20,32
JAX,2016,2017,WR,10,10,4,6,6,40.0,60.0,60.0,0,2025-08-15 16:41:33,jax_roster_turnover_detailed.csv,2025-08-17 08:45:20,32
JAX,2017,2018,DB,8,12,4,4,8,50.0,50.0,66.67,4,2025-08-15 16:41:33,jax_roster_turnover_detailed.csv,2025-08-17 08:45:20,32
JAX,2017,2018,DL,7,5,3,4,2,42.86,57.14,40.0,-2,2025-08-15 16:41:33,jax_roster_turnover_detailed.csv,2025-08-17 08:45:20,32
JAX,2017,2018,LB,4,7,3,1,4,75.0,25.0,57.14,3,2025-08-15 16:41:33,jax_roster_turnover_detailed.csv,2025-08-17 08:45:20,32
JAX,2017,2018,OL,5,7,5,0,2,100.0,0.0,28.57,2,2025-08-15 16:41:33,jax_roster_turnover_detailed.csv,2025-08-17 08:45:20,32
JAX,2017,2018,OTHER,13,13,10,3,3,76.92,23.08,23.08,0,2025-08-15 16:41:33,jax_roster_turnover_detailed.csv,2025-08-17 08:45:20,32
JAX,2017,2018,QB,2,2,1,1,1,50.0,50.0,50.0,0,2025-08-15 16:41:33,jax_roster_turnover_detailed.csv,2025-08-17 08:45:20,32
JAX,2017,2018,RB,5,8,4,1,4,80.0,20.0,50.0,3,2025-08-15 16:41:33,jax_roster_turnover_detailed.csv,2025-08-17 08:45:20,32
JAX,2017,2018,ST,5,5,2,3,3,40.0,60.0,60.0,0,2025-08-15 16:41:33,jax_roster_turnover_detailed.csv,2025-08-17 08:45:20,32
JAX,2017,2018,TE,3,5,2,1,3,66.67,33.33,60.0,2,2025-08-15 16:41:33,jax_roster_turnover_detailed.csv,2025-08-17 08:45:20,32
JAX,2017,2018,WR,10,7,3,7,4,30.0,70.0,57.14,-3,2025-08-15 16:41:33,jax_roster_turnover_detailed.csv,2025-08-17 08:45:20,32
JAX,2018,2019,DB,12,13,5,7,8,41.67,58.33,61.54,1,2025-08-15 16:41:33,jax_roster_turnover_detailed.csv,2025-08-17 08:45:20,32
JAX,2018,2019,DL,5,4,1,4,3,20.0,80.0,75.0,-1,2025-08-15 16:41:33,jax_roster_turnover_detailed.csv,2025-08-17 08:45:20,32
JAX,2018,2019,LB,7,11,3,4,8,42.86,57.14,72.73,4,2025-08-15 16:41:33,jax_roster_turnover_detailed.csv,2025-08-17 08:45:20,32
JAX,2018,2019,OL,7,4,2,5,2,28.57,71.43,50.0,-3,2025-08-15 16:41:33,jax_roster_turnover_detailed.csv,2025-08-17 08:45:20,32
JAX,2018,2019,OTHER,13,13,7,6,6,53.85,46.15,46.15,0,2025-08-15 16:41:33,jax_roster_turnover_detailed.csv,2025-08-17 08:45:20,32
JAX,2018,2019,QB,2,2,0,2,2,0.0,100.0,100.0,0,2025-08-15 16:41:33,jax_roster_turnover_detailed.csv,2025-08-17 08:45:20,32
JAX,2018,2019,RB,8,5,1,7,4,12.5,87.5,80.0,-3,2025-08-15 16:41:33,jax_roster_turnover_detailed.csv,2025-08-17 08:45:20,32
JAX,2018,2019,ST,5,3,2,3,1,40.0,60.0,33.33,-2,2025-08-15 16:41:33,jax_roster_turnover_detailed.csv,2025-08-17 08:45:20,32
JAX,2018,2019,TE,5,7,2,3,5,40.0,60.0,71.43,2,2025-08-15 16:41:33,jax_roster_turnover_detailed.csv,2025-08-17 08:45:20,32
JAX,2018,2019,WR,7,7,3,4,4,42.86,57.14,57.14,0,2025-08-15 16:41:33,jax_roster_turnover_detailed.csv,2025-08-17 08:45:20,32
JAX,2019,2020,DB,13,13,5,8,8,38.46,61.54,61.54,0,2025-08-15 16:41:33,jax_roster_turnover_detailed.csv,2025-08-17 08:45:20,32
JAX,2019,2020,DL,4,7,0,4,7,0.0,100.0,100.0,3,2025-08-15 16:41:33,jax_roster_turnover_detailed.csv,2025-08-17 08:45:20,32
JAX,2019,2020,LB,11,8,2,9,6,18.18,81.82,75.0,-3,2025-08-15 16:41:33,jax_roster_turnover_detailed.csv,2025-08-17 08:45:20,32
JAX,2019,2020,OL,4,6,3,1,3,75.0,25.0,50.0,2,2025-08-15 16:41:33,jax_roster_turnover_detailed.csv,2025-08-17 08:45:20,32
JAX,2019,2020,OTHER,13,16,7,6,9,53.85,46.15,56.25,3,2025-08-15 16:41:33,jax_roster_turnover_detailed.csv,2025-08-17 08:45:20,32
JAX,2019,2020,QB,2,3,1,1,2,50.0,50.0,66.67,1,2025-08-15 16:41:33,jax_roster_turnover_detailed.csv,2025-08-17 08:45:20,32
JAX,2019,2020,RB,5,7,1,4,6,20.0,80.0,85.71,2,2025-08-15 16:41:33,jax_roster_turnover_detailed.csv,2025-08-17 08:45:20,32
JAX,2019,2020,ST,3,8,2,1,6,66.67,33.33,75.0,5,2025-08-15 16:41:33,jax_roster_turnover_detailed.csv,2025-08-17 08:45:20,32
JAX,2019,2020,TE,7,5,1,6,4,14.29,85.71,80.0,-2,2025-08-15 16:41:33,jax_roster_turnover_detailed.csv,2025-08-17 08:45:20,32
JAX,2019,2020,WR,7,8,4,3,4,57.14,42.86,50.0,1,2025-08-15 16:41:33,jax_roster_turnover_detailed.csv,2025-08-17 08:45:20,32
JAX,2020,2021,DB,13,12,4,9,8,30.77,69.23,66.67,-1,2025-08-15 16:41:33,jax_roster_turnover_detailed.csv,2025-08-17 08:45:20,32
JAX,2020,2021,DL,7,6,0,7,6,0.0,100.0,100.0,-1,2025-08-15 16:41:33,jax_roster_turnover_detailed.csv,2025-08-17 08:45:20,32
JAX,2020,2021,LB,8,8,3,5,5,37.5,62.5,62.5,0,2025-08-15 16:41:33,jax_roster_turnover_detailed.csv,2025-08-17 08:45:20,32
JAX,2020,2021,OL,6,8,5,1,3,83.33,16.67,37.5,2,2025-08-15 16:41:33,jax_roster_turnover_detailed.csv,2025-08-17 08:45:20,32
JAX,2020,2021,OTHER,16,13,7,9,6,43.75,56.25,46.15,-3,2025-08-15 16:41:33,jax_roster_turnover_detailed.csv,2025-08-17 08:45:20,32
JAX,2020,2021,QB,3,2,0,3,2,0.0,100.0,100.0,-1,2025-08-15 16:41:33,jax_roster_turnover_detailed.csv,2025-08-17 08:45:20,32
JAX,2020,2021,RB,7,7,4,3,3,57.14,42.86,42.86,0,2025-08-15 16:41:33,jax_roster_turnover_detailed.csv,2025-08-17 08:45:20,32
JAX,2020,2021,ST,8,5,2,6,3,25.0,75.0,60.0,-3,2025-08-15 16:41:33,jax_roster_turnover_detailed.csv,2025-08-17 08:45:20,32
JAX,2020,2021,TE,5,5,1,4,4,20.0,80.0,80.0,0,2025-08-15 16:41:33,jax_roster_turnover_detailed.csv,2025-08-17 08:45:20,32
JAX,2020,2021,WR,8,14,2,6,12,25.0,75.0,85.71,6,2025-08-15 16:41:33,jax_roster_turnover_detailed.csv,2025-08-17 08:45:20,32
JAX,2021,2022,DB,12,10,6,6,4,50.0,50.0,40.0,-2,2025-08-15 16:41:33,jax_roster_turnover_detailed.csv,2025-08-17 08:45:20,32
JAX,2021,2022,DL,6,6,1,5,5,16.67,83.33,83.33,0,2025-08-15 16:41:33,jax_roster_turnover_detailed.csv,2025-08-17 08:45:20,32
JAX,2021,2022,LB,8,6,1,7,5,12.5,87.5,83.33,-2,2025-08-15 16:41:33,jax_roster_turnover_detailed.csv,2025-08-17 08:45:20,32
JAX,2021,2022,OL,8,7,1,7,6,12.5,87.5,85.71,-1,2025-08-15 16:41:33,jax_roster_turnover_detailed.csv,2025-08-17 08:45:20,32
JAX,2021,2022,OTHER,13,14,7,6,7,53.85,46.15,50.0,1,2025-08-15 16:41:33,jax_roster_turnover_detailed.csv,2025-08-17 08:45:20,32
JAX,2021,2022,QB,2,2,2,0,0,100.0,0.0,0.0,0,2025-08-15 16:41:33,jax_roster_turnover_detailed.csv,2025-08-17 08:45:20,32
JAX,2021,2022,RB,7,4,1,6,3,14.29,85.71,75.0,-3,2025-08-15 16:41:33,jax_roster_turnover_detailed.csv,2025-08-17 08:45:20,32
JAX,2021,2022,ST,5,3,1,4,2,20.0,80.0,66.67,-2,2025-08-15 16:41:33,jax_roster_turnover_detailed.csv,2025-08-17 08:45:20,32
JAX,2021,2022,TE,5,4,2,3,2,40.0,60.0,50.0,-1,2025-08-15 16:41:33,jax_roster_turnover_detailed.csv,2025-08-17 08:45:20,32
JAX,2021,2022,WR,14,5,2,12,3,14.29,85.71,60.0,-9,2025-08-15 16:41:33,jax_roster_turnover_detailed.csv,2025-08-17 08:45:20,32
JAX,2022,2023,DB,10,12,8,2,4,80.0,20.0,33.33,2,2025-08-15 16:41:33,jax_roster_turnover_detailed.csv,2025-08-17 08:45:20,32
JAX,2022,2023,DL,6,8,3,3,5,50.0,50.0,62.5,2,2025-08-15 16:41:33,jax_roster_turnover_detailed.csv,2025-08-17 08:45:20,32
JAX,2022,2023,LB,6,10,4,2,6,66.67,33.33,60.0,4,2025-08-15 16:41:33,jax_roster_turnover_detailed.csv,2025-08-17 08:45:20,32
JAX,2022,2023,OL,7,11,4,3,7,57.14,42.86,63.64,4,2025-08-15 16:41:33,jax_roster_turnover_detailed.csv,2025-08-17 08:45:20,32
JAX,2022,2023,OTHER,14,1,1,13,0,7.14,92.86,0.0,-13,2025-08-15 16:41:33,jax_roster_turnover_detailed.csv,2025-08-17 08:45:20,32
JAX,2022,2023,QB,2,3,2,0,1,100.0,0.0,33.33,1,2025-08-15 16:41:33,jax_roster_turnover_detailed.csv,2025-08-17 08:45:20,32
JAX,2022,2023,RB,4,4,2,2,2,50.0,50.0,50.0,0,2025-08-15 16:41:33,jax_roster_turnover_detailed.csv,2025-08-17 08:45:20,32
JAX,2022,2023,ST,3,3,2,1,1,66.67,33.33,33.33,0,2025-08-15 16:41:33,jax_roster_turnover_detailed.csv,2025-08-17 08:45:20,32
JAX,2022,2023,TE,4,4,2,2,2,50.0,50.0,50.0,0,2025-08-15 16:41:33,jax_roster_turnover_detailed.csv,2025-08-17 08:45:20,32
JAX,2022,2023,WR,5,8,4,1,4,80.0,20.0,50.0,3,2025-08-15 16:41:33,jax_roster_turnover_detailed.csv,2025-08-17 08:45:20,32
JAX,2023,2024,DB,12,12,6,6,6,50.0,50.0,50.0,0,2025-08-15 16:41:33,jax_roster_turnover_detailed.csv,2025-08-17 08:45:20,32
JAX,2023,2024,DL,8,9,2,6,7,25.0,75.0,77.78,1,2025-08-15 16:41:33,jax_roster_turnover_detailed.csv,2025-08-17 08:45:20,32
JAX,2023,2024,LB,10,7,4,6,3,40.0,60.0,42.86,-3,2025-08-15 16:41:33,jax_roster_turnover_detailed.csv,2025-08-17 08:45:20,32
JAX,2023,2024,OL,11,7,4,7,3,36.36,63.64,42.86,-4,2025-08-15 16:41:33,jax_roster_turnover_detailed.csv,2025-08-17 08:45:20,32
JAX,2023,2024,OTHER,1,12,0,1,12,0.0,100.0,100.0,11,2025-08-15 16:41:33,jax_roster_turnover_detailed.csv,2025-08-17 08:45:20,32
JAX,2023,2024,QB,3,2,1,2,1,33.33,66.67,50.0,-1,2025-08-15 16:41:33,jax_roster_turnover_detailed.csv,2025-08-17 08:45:20,32
JAX,2023,2024,RB,4,4,3,1,1,75.0,25.0,25.0,0,2025-08-15 16:41:33,jax_roster_turnover_detailed.csv,2025-08-17 08:45:20,32
JAX,2023,2024,ST,3,3,2,1,1,66.67,33.33,33.33,0,2025-08-15 16:41:33,jax_roster_turnover_detailed.csv,2025-08-17 08:45:20,32
JAX,2023,2024,TE,4,4,3,1,1,75.0,25.0,25.0,0,2025-08-15 16:41:33,jax_roster_turnover_detailed.csv,2025-08-17 08:45:20,32
JAX,2023,2024,WR,8,10,4,4,6,50.0,50.0,60.0,2,2025-08-15 16:41:33,jax_roster_turnover_detailed.csv,2025-08-17 08:45:20,32
KAN,2011,2012,DB,9,8,4,5,4,44.44,55.56,50.0,-1,2025-08-15 16:41:30,kan_roster_turnover_detailed.csv,2025-08-17 08:45:20,32
KAN,2011,2012,DL,5,8,2,3,6,40.0,60.0,75.0,3,2025-08-15 16:41:30,kan_roster_turnover_detailed.csv,2025-08-17 08:45:20,32
KAN,2011,2012,LB,4,7,3,1,4,75.0,25.0,57.14,3,2025-08-15 16:41:30,kan_roster_turnover_detailed.csv,2025-08-17 08:45:20,32
KAN,2011,2012,OL,4,3,1,3,2,25.0,75.0,66.67,-1,2025-08-15 16:41:30,kan_roster_turnover_detailed.csv,2025-08-17 08:45:20,32
KAN,2011,2012,OTHER,13,14,8,5,6,61.54,38.46,42.86,1,2025-08-15 16:41:30,kan_roster_turnover_detailed.csv,2025-08-17 08:45:20,32
KAN,2011,2012,QB,3,2,1,2,1,33.33,66.67,50.0,-1,2025-08-15 16:41:30,kan_roster_turnover_detailed.csv,2025-08-17 08:45:20,32
KAN,2011,2012,RB,5,7,2,3,5,40.0,60.0,71.43,2,2025-08-15 16:41:30,kan_roster_turnover_detailed.csv,2025-08-17 08:45:20,32
KAN,2011,2012,ST,2,2,2,0,0,100.0,0.0,0.0,0,2025-08-15 16:41:30,kan_roster_turnover_detailed.csv,2025-08-17 08:45:20,32
KAN,2011,2012,TE,3,4,1,2,3,33.33,66.67,75.0,1,2025-08-15 16:41:30,kan_roster_turnover_detailed.csv,2025-08-17 08:45:20,32
KAN,2011,2012,WR,8,8,4,4,4,50.0,50.0,50.0,0,2025-08-15 16:41:30,kan_roster_turnover_detailed.csv,2025-08-17 08:45:20,32
KAN,2012,2013,DB,8,9,2,6,7,25.0,75.0,77.78,1,2025-08-15 16:41:30,kan_roster_turnover_detailed.csv,2025-08-17 08:45:20,32
KAN,2012,2013,DL,8,7,4,4,3,50.0,50.0,42.86,-1,2025-08-15 16:41:30,kan_roster_turnover_detailed.csv,2025-08-17 08:45:20,32
KAN,2012,2013,LB,7,6,1,6,5,14.29,85.71,83.33,-1,2025-08-15 16:41:30,kan_roster_turnover_detailed.csv,2025-08-17 08:45:20,32
KAN,2012,2013,OL,3,4,1,2,3,33.33,66.67,75.0,1,2025-08-15 16:41:30,kan_roster_turnover_detailed.csv,2025-08-17 08:45:20,32
KAN,2012,2013,OTHER,14,15,9,5,6,64.29,35.71,40.0,1,2025-08-15 16:41:30,kan_roster_turnover_detailed.csv,2025-08-17 08:45:20,32
KAN,2012,2013,QB,2,2,0,2,2,0.0,100.0,100.0,0,2025-08-15 16:41:30,kan_roster_turnover_detailed.csv,2025-08-17 08:45:20,32
KAN,2012,2013,RB,7,4,2,5,2,28.57,71.43,50.0,-3,2025-08-15 16:41:30,kan_roster_turnover_detailed.csv,2025-08-17 08:45:20,32
KAN,2012,2013,ST,2,2,2,0,0,100.0,0.0,0.0,0,2025-08-15 16:41:30,kan_roster_turnover_detailed.csv,2025-08-17 08:45:20,32
KAN,2012,2013,TE,4,6,0,4,6,0.0,100.0,100.0,2,2025-08-15 16:41:30,kan_roster_turnover_detailed.csv,2025-08-17 08:45:20,32
KAN,2012,2013,WR,8,7,2,6,5,25.0,75.0,71.43,-1,2025-08-15 16:41:30,kan_roster_turnover_detailed.csv,2025-08-17 08:45:20,32
KAN,2013,2014,DB,9,8,3,6,5,33.33,66.67,62.5,-1,2025-08-15 16:41:30,kan_roster_turnover_detailed.csv,2025-08-17 08:45:20,32
KAN,2013,2014,DL,7,5,1,6,4,14.29,85.71,80.0,-2,2025-08-15 16:41:30,kan_roster_turnover_detailed.csv,2025-08-17 08:45:20,32
KAN,2013,2014,LB,6,8,2,4,6,33.33,66.67,75.0,2,2025-08-15 16:41:30,kan_roster_turnover_detailed.csv,2025-08-17 08:45:20,32
KAN,2013,2014,OL,4,4,1,3,3,25.0,75.0,75.0,0,2025-08-15 16:41:30,kan_roster_turnover_detailed.csv,2025-08-17 08:45:20,32
KAN,2013,2014,OTHER,15,13,4,11,9,26.67,73.33,69.23,-2,2025-08-15 16:41:30,kan_roster_turnover_detailed.csv,2025-08-17 08:45:20,32
KAN,2013,2014,QB,2,2,2,0,0,100.0,0.0,0.0,0,2025-08-15 16:41:30,kan_roster_turnover_detailed.csv,2025-08-17 08:45:20,32
KAN,2013,2014,RB,4,7,4,0,3,100.0,0.0,42.86,3,2025-08-15 16:41:30,kan_roster_turnover_detailed.csv,2025-08-17 08:45:20,32
KAN,2013,2014,ST,2,2,1,1,1,50.0,50.0,50.0,0,2025-08-15 16:41:30,kan_roster_turnover_detailed.csv,2025-08-17 08:45:20,32
KAN,2013,2014,TE,6,5,3,3,2,50.0,50.0,40.0,-1,2025-08-15 16:41:30,kan_roster_turnover_detailed.csv,2025-08-17 08:45:20,32
KAN,2013,2014,WR,7,7,4,3,3,57.14,42.86,42.86,0,2025-08-15 16:41:30,kan_roster_turnover_detailed.csv,2025-08-17 08:45:20,32
KAN,2014,2015,DB,8,10,5,3,5,62.5,37.5,50.0,2,2025-08-15 16:41:30,kan_roster_turnover_detailed.csv,2025-08-17 08:45:20,32
KAN,2014,2015,DL,5,4,2,3,2,40.0,60.0,50.0,-1,2025-08-15 16:41:30,kan_roster_turnover_detailed.csv,2025-08-17 08:45:20,32
KAN,2014,2015,LB,8,4,1,7,3,12.5,87.5,75.0,-4,2025-08-15 16:41:30,kan_roster_turnover_detailed.csv,2025-08-17 08:45:20,32
KAN,2014,2015,OL,4,3,0,4,3,0.0,100.0,100.0,-1,2025-08-15 16:41:30,kan_roster_turnover_detailed.csv,2025-08-17 08:45:20,32
KAN,2014,2015,OTHER,13,17,8,5,9,61.54,38.46,52.94,4,2025-08-15 16:41:30,kan_roster_turnover_detailed.csv,2025-08-17 08:45:20,32
KAN,2014,2015,QB,2,2,2,0,0,100.0,0.0,0.0,0,2025-08-15 16:41:30,kan_roster_turnover_detailed.csv,2025-08-17 08:45:20,32
KAN,2014,2015,RB,7,6,5,2,1,71.43,28.57,16.67,-1,2025-08-15 16:41:30,kan_roster_turnover_detailed.csv,2025-08-17 08:45:20,32
KAN,2014,2015,ST,2,3,2,0,1,100.0,0.0,33.33,1,2025-08-15 16:41:30,kan_roster_turnover_detailed.csv,2025-08-17 08:45:20,32
KAN,2014,2015,TE,5,4,2,3,2,40.0,60.0,50.0,-1,2025-08-15 16:41:30,kan_roster_turnover_detailed.csv,2025-08-17 08:45:20,32
KAN,2014,2015,WR,7,5,3,4,2,42.86,57.14,40.0,-2,2025-08-15 16:41:30,kan_roster_turnover_detailed.csv,2025-08-17 08:45:20,32
KAN,2015,2016,DB,10,7,3,7,4,30.0,70.0,57.14,-3,2025-08-15 16:41:30,kan_roster_turnover_detailed.csv,2025-08-17 08:45:20,32
KAN,2015,2016,DL,4,7,3,1,4,75.0,25.0,57.14,3,2025-08-15 16:41:30,kan_roster_turnover_detailed.csv,2025-08-17 08:45:20,32
KAN,2015,2016,LB,4,7,2,2,5,50.0,50.0,71.43,3,2025-08-15 16:41:30,kan_roster_turnover_detailed.csv,2025-08-17 08:45:20,32
KAN,2015,2016,OL,3,5,1,2,4,33.33,66.67,80.0,2,2025-08-15 16:41:30,kan_roster_turnover_detailed.csv,2025-08-17 08:45:20,32
KAN,2015,2016,OTHER,17,16,8,9,8,47.06,52.94,50.0,-1,2025-08-15 16:41:30,kan_roster_turnover_detailed.csv,2025-08-17 08:45:20,32
KAN,2015,2016,QB,2,2,1,1,1,50.0,50.0,50.0,0,2025-08-15 16:41:30,kan_roster_turnover_detailed.csv,2025-08-17 08:45:20,32
KAN,2015,2016,RB,6,6,6,0,0,100.0,0.0,0.0,0,2025-08-15 16:41:30,kan_roster_turnover_detailed.csv,2025-08-17 08:45:20,32
KAN,2015,2016,ST,3,3,3,0,0,100.0,0.0,0.0,0,2025-08-15 16:41:30,kan_roster_turnover_detailed.csv,2025-08-17 08:45:20,32
KAN,2015,2016,TE,4,2,2,2,0,50.0,50.0,0.0,-2,2025-08-15 16:41:30,kan_roster_turnover_detailed.csv,2025-08-17 08:45:20,32
KAN,2015,2016,WR,5,6,3,2,3,60.0,40.0,50.0,1,2025-08-15 16:41:30,kan_roster_turnover_detailed.csv,2025-08-17 08:45:20,32
KAN,2016,2017,DB,7,10,5,2,5,71.43,28.57,50.0,3,2025-08-15 16:41:30,kan_roster_turnover_detailed.csv,2025-08-17 08:45:20,32
KAN,2016,2017,DL,7,6,1,6,5,14.29,85.71,83.33,-1,2025-08-15 16:41:30,kan_roster_turnover_detailed.csv,2025-08-17 08:45:20,32
KAN,2016,2017,LB,7,6,3,4,3,42.86,57.14,50.0,-1,2025-08-15 16:41:30,kan_roster_turnover_detailed.csv,2025-08-17 08:45:20,32
KAN,2016,2017,OL,5,5,3,2,2,60.0,40.0,40.0,0,2025-08-15 16:41:30,kan_roster_turnover_detailed.csv,2025-08-17 08:45:20,32
KAN,2016,2017,OTHER,16,15,12,4,3,75.0,25.0,20.0,-1,2025-08-15 16:41:30,kan_roster_turnover_detailed.csv,2025-08-17 08:45:20,32
KAN,2016,2017,QB,2,3,1,1,2,50.0,50.0,66.67,1,2025-08-15 16:41:30,kan_roster_turnover_detailed.csv,2025-08-17 08:45:20,32
KAN,2016,2017,RB,6,6,3,3,3,50.0,50.0,50.0,0,2025-08-15 16:41:30,kan_roster_turnover_detailed.csv,2025-08-17 08:45:20,32
KAN,2016,2017,ST,3,4,3,0,1,100.0,0.0,25.0,1,2025-08-15 16:41:30,kan_roster_turnover_detailed.csv,2025-08-17 08:45:20,32
KAN,2016,2017,TE,2,3,1,1,2,50.0,50.0,66.67,1,2025-08-15 16:41:30,kan_roster_turnover_detailed.csv,2025-08-17 08:45:20,32
KAN,2016,2017,WR,6,6,4,2,2,66.67,33.33,33.33,0,2025-08-15 16:41:30,kan_roster_turnover_detailed.csv,2025-08-17 08:45:20,32
KAN,2017,2018,DB,10,9,4,6,5,40.0,60.0,55.56,-1,2025-08-15 16:41:30,kan_roster_turnover_detailed.csv,2025-08-17 08:45:20,32
KAN,2017,2018,DL,6,7,3,3,4,50.0,50.0,57.14,1,2025-08-15 16:41:30,kan_roster_turnover_detailed.csv,2025-08-17 08:45:20,32
KAN,2017,2018,LB,6,4,1,5,3,16.67,83.33,75.0,-2,2025-08-15 16:41:30,kan_roster_turnover_detailed.csv,2025-08-17 08:45:20,32
KAN,2017,2018,OL,5,5,2,3,3,40.0,60.0,60.0,0,2025-08-15 16:41:30,kan_roster_turnover_detailed.csv,2025-08-17 08:45:20,32
KAN,2017,2018,OTHER,15,14,9,6,5,60.0,40.0,35.71,-1,2025-08-15 16:41:30,kan_roster_turnover_detailed.csv,2025-08-17 08:45:20,32
KAN,2017,2018,QB,3,2,1,2,1,33.33,66.67,50.0,-1,2025-08-15 16:41:30,kan_roster_turnover_detailed.csv,2025-08-17 08:45:20,32
KAN,2017,2018,RB,6,7,4,2,3,66.67,33.33,42.86,1,2025-08-15 16:41:30,kan_roster_turnover_detailed.csv,2025-08-17 08:45:20,32
KAN,2017,2018,ST,4,3,3,1,0,75.0,25.0,0.0,-1,2025-08-15 16:41:30,kan_roster_turnover_detailed.csv,2025-08-17 08:45:20,32
KAN,2017,2018,TE,3,4,2,1,2,66.67,33.33,50.0,1,2025-08-15 16:41:30,kan_roster_turnover_detailed.csv,2025-08-17 08:45:20,32
KAN,2017,2018,WR,6,7,4,2,3,66.67,33.33,42.86,1,2025-08-15 16:41:30,kan_roster_turnover_detailed.csv,2025-08-17 08:45:20,32
KAN,2018,2019,DB,9,10,4,5,6,44.44,55.56,60.0,1,2025-08-15 16:41:30,kan_roster_turnover_detailed.csv,2025-08-17 08:45:20,32
KAN,2018,2019,DL,7,7,1,6,6,14.29,85.71,85.71,0,2025-08-15 16:41:30,kan_roster_turnover_detailed.csv,2025-08-17 08:45:20,32
KAN,2018,2019,LB,4,5,2,2,3,50.0,50.0,60.0,1,2025-08-15 16:41:30,kan_roster_turnover_detailed.csv,2025-08-17 08:45:20,32
KAN,2018,2019,OL,5,5,2,3,3,40.0,60.0,60.0,0,2025-08-15 16:41:30,kan_roster_turnover_detailed.csv,2025-08-17 08:45:20,32
KAN,2018,2019,OTHER,14,15,8,6,7,57.14,42.86,46.67,1,2025-08-15 16:41:30,kan_roster_turnover_detailed.csv,2025-08-17 08:45:20,32
KAN,2018,2019,QB,2,2,1,1,1,50.0,50.0,50.0,0,2025-08-15 16:41:30,kan_roster_turnover_detailed.csv,2025-08-17 08:45:20,32
KAN,2018,2019,RB,7,7,5,2,2,71.43,28.57,28.57,0,2025-08-15 16:41:30,kan_roster_turnover_detailed.csv,2025-08-17 08:45:20,32
KAN,2018,2019,ST,3,3,3,0,0,100.0,0.0,0.0,0,2025-08-15 16:41:30,kan_roster_turnover_detailed.csv,2025-08-17 08:45:20,32
KAN,2018,2019,TE,4,3,2,2,1,50.0,50.0,33.33,-1,2025-08-15 16:41:30,kan_roster_turnover_detailed.csv,2025-08-17 08:45:20,32
KAN,2018,2019,WR,7,6,4,3,2,57.14,42.86,33.33,-1,2025-08-15 16:41:30,kan_roster_turnover_detailed.csv,2025-08-17 08:45:20,32
KAN,2019,2020,DB,10,11,5,5,6,50.0,50.0,54.55,1,2025-08-15 16:41:30,kan_roster_turnover_detailed.csv,2025-08-17 08:45:20,32
KAN,2019,2020,DL,7,9,3,4,6,42.86,57.14,66.67,2,2025-08-15 16:41:30,kan_roster_turnover_detailed.csv,2025-08-17 08:45:20,32
KAN,2019,2020,LB,5,6,3,2,3,60.0,40.0,50.0,1,2025-08-15 16:41:30,kan_roster_turnover_detailed.csv,2025-08-17 08:45:20,32
KAN,2019,2020,OL,5,8,2,3,6,40.0,60.0,75.0,3,2025-08-15 16:41:30,kan_roster_turnover_detailed.csv,2025-08-17 08:45:20,32
KAN,2019,2020,OTHER,15,14,10,5,4,66.67,33.33,28.57,-1,2025-08-15 16:41:30,kan_roster_turnover_detailed.csv,2025-08-17 08:45:20,32
KAN,2019,2020,QB,2,2,1,1,1,50.0,50.0,50.0,0,2025-08-15 16:41:30,kan_roster_turnover_detailed.csv,2025-08-17 08:45:20,32
KAN,2019,2020,RB,7,6,3,4,3,42.86,57.14,50.0,-1,2025-08-15 16:41:30,kan_roster_turnover_detailed.csv,2025-08-17 08:45:20,32
KAN,2019,2020,ST,3,3,2,1,1,66.67,33.33,33.33,0,2025-08-15 16:41:30,kan_roster_turnover_detailed.csv,2025-08-17 08:45:20,32
KAN,2019,2020,TE,3,3,2,1,1,66.67,33.33,33.33,0,2025-08-15 16:41:30,kan_roster_turnover_detailed.csv,2025-08-17 08:45:20,32
KAN,2019,2020,WR,6,8,6,0,2,100.0,0.0,25.0,2,2025-08-15 16:41:30,kan_roster_turnover_detailed.csv,2025-08-17 08:45:20,32
KAN,2020,2021,DB,11,9,6,5,3,54.55,45.45,33.33,-2,2025-08-15 16:41:30,kan_roster_turnover_detailed.csv,2025-08-17 08:45:20,32
KAN,2020,2021,DL,9,6,4,5,2,44.44,55.56,33.33,-3,2025-08-15 16:41:30,kan_roster_turnover_detailed.csv,2025-08-17 08:45:20,32
KAN,2020,2021,LB,6,6,3,3,3,50.0,50.0,50.0,0,2025-08-15 16:41:30,kan_roster_turnover_detailed.csv,2025-08-17 08:45:20,32
KAN,2020,2021,OL,8,5,0,8,5,0.0,100.0,100.0,-3,2025-08-15 16:41:30,kan_roster_turnover_detailed.csv,2025-08-17 08:45:20,32
KAN,2020,2021,OTHER,14,16,6,8,10,42.86,57.14,62.5,2,2025-08-15 16:41:30,kan_roster_turnover_detailed.csv,2025-08-17 08:45:20,32
KAN,2020,2021,QB,2,2,2,0,0,100.0,0.0,0.0,0,2025-08-15 16:41:30,kan_roster_turnover_detailed.csv,2025-08-17 08:45:20,32
KAN,2020,2021,RB,6,5,2,4,3,33.33,66.67,60.0,-1,2025-08-15 16:41:30,kan_roster_turnover_detailed.csv,2025-08-17 08:45:20,32
KAN,2020,2021,ST,3,5,3,0,2,100.0,0.0,40.0,2,2025-08-15 16:41:30,kan_roster_turnover_detailed.csv,2025-08-17 08:45:20,32
KAN,2020,2021,TE,3,5,1,2,4,33.33,66.67,80.0,2,2025-08-15 16:41:30,kan_roster_turnover_detailed.csv,2025-08-17 08:45:20,32
KAN,2020,2021,WR,8,7,5,3,2,62.5,37.5,28.57,-1,2025-08-15 16:41:30,kan_roster_turnover_detailed.csv,2025-08-17 08:45:20,32
KAN,2021,2022,DB,9,11,3,6,8,33.33,66.67,72.73,2,2025-08-15 16:41:30,kan_roster_turnover_detailed.csv,2025-08-17 08:45:20,32
KAN,2021,2022,DL,6,8,2,4,6,33.33,66.67,75.0,2,2025-08-15 16:41:30,kan_roster_turnover_detailed.csv,2025-08-17 08:45:20,32
KAN,2021,2022,LB,6,6,2,4,4,33.33,66.67,66.67,0,2025-08-15 16:41:30,kan_roster_turnover_detailed.csv,2025-08-17 08:45:20,32
KAN,2021,2022,OL,5,6,3,2,3,60.0,40.0,50.0,1,2025-08-15 16:41:30,kan_roster_turnover_detailed.csv,2025-08-17 08:45:20,32
KAN,2021,2022,OTHER,16,12,9,7,3,56.25,43.75,25.0,-4,2025-08-15 16:41:30,kan_roster_turnover_detailed.csv,2025-08-17 08:45:20,32
KAN,2021,2022,QB,2,2,2,0,0,100.0,0.0,0.0,0,2025-08-15 16:41:30,kan_roster_turnover_detailed.csv,2025-08-17 08:45:20,32
KAN,2021,2022,RB,5,5,3,2,2,60.0,40.0,40.0,0,2025-08-15 16:41:30,kan_roster_turnover_detailed.csv,2025-08-17 08:45:20,32
KAN,2021,2022,ST,5,5,3,2,2,60.0,40.0,40.0,0,2025-08-15 16:41:30,kan_roster_turnover_detailed.csv,2025-08-17 08:45:20,32
KAN,2021,2022,TE,5,4,4,1,0,80.0,20.0,0.0,-1,2025-08-15 16:41:30,kan_roster_turnover_detailed.csv,2025-08-17 08:45:20,32
KAN,2021,2022,WR,7,9,2,5,7,28.57,71.43,77.78,2,2025-08-15 16:41:30,kan_roster_turnover_detailed.csv,2025-08-17 08:45:20,32
KAN,2022,2023,DB,11,11,5,6,6,45.45,54.55,54.55,0,2025-08-15 16:41:30,kan_roster_turnover_detailed.csv,2025-08-17 08:45:20,32
KAN,2022,2023,DL,8,13,3,5,10,37.5,62.5,76.92,5,2025-08-15 16:41:30,kan_roster_turnover_detailed.csv,2025-08-17 08:45:20,32
KAN,2022,2023,LB,6,8,4,2,4,66.67,33.33,50.0,2,2025-08-15 16:41:30,kan_roster_turnover_detailed.csv,2025-08-17 08:45:20,32
KAN,2022,2023,OL,6,10,4,2,6,66.67,33.33,60.0,4,2025-08-15 16:41:30,kan_roster_turnover_detailed.csv,2025-08-17 08:45:20,32
KAN,2022,2023,OTHER,12,0,0,12,0,0.0,100.0,0.0,-12,2025-08-15 16:41:30,kan_roster_turnover_detailed.csv,2025-08-17 08:45:20,32
KAN,2022,2023,QB,2,2,1,1,1,50.0,50.0,50.0,0,2025-08-15 16:41:30,kan_roster_turnover_detailed.csv,2025-08-17 08:45:20,32
KAN,2022,2023,RB,5,5,3,2,2,60.0,40.0,40.0,0,2025-08-15 16:41:30,kan_roster_turnover_detailed.csv,2025-08-17 08:45:20,32
KAN,2022,2023,ST,5,3,3,2,0,60.0,40.0,0.0,-2,2025-08-15 16:41:30,kan_roster_turnover_detailed.csv,2025-08-17 08:45:20,32
KAN,2022,2023,TE,4,4,3,1,1,75.0,25.0,25.0,0,2025-08-15 16:41:30,kan_roster_turnover_detailed.csv,2025-08-17 08:45:20,32
KAN,2022,2023,WR,9,9,5,4,4,55.56,44.44,44.44,0,2025-08-15 16:41:30,kan_roster_turnover_detailed.csv,2025-08-17 08:45:20,32
KAN,2023,2024,DB,11,10,6,5,4,54.55,45.45,40.0,-1,2025-08-15 16:41:30,kan_roster_turnover_detailed.csv,2025-08-17 08:45:20,32
KAN,2023,2024,DL,13,8,5,8,3,38.46,61.54,37.5,-5,2025-08-15 16:41:30,kan_roster_turnover_detailed.csv,2025-08-17 08:45:20,32
KAN,2023,2024,LB,8,6,4,4,2,50.0,50.0,33.33,-2,2025-08-15 16:41:30,kan_roster_turnover_detailed.csv,2025-08-17 08:45:20,32
KAN,2023,2024,OL,10,7,2,8,5,20.0,80.0,71.43,-3,2025-08-15 16:41:30,kan_roster_turnover_detailed.csv,2025-08-17 08:45:20,32
KAN,2023,2024,OTHER,0,12,0,0,12,0.0,0.0,100.0,12,2025-08-15 16:41:30,kan_roster_turnover_detailed.csv,2025-08-17 08:45:20,32
KAN,2023,2024,QB,2,3,1,1,2,50.0,50.0,66.67,1,2025-08-15 16:41:30,kan_roster_turnover_detailed.csv,2025-08-17 08:45:20,32
KAN,2023,2024,RB,5,5,1,4,4,20.0,80.0,80.0,0,2025-08-15 16:41:30,kan_roster_turnover_detailed.csv,2025-08-17 08:45:20,32
KAN,2023,2024,ST,3,5,2,1,3,66.67,33.33,60.0,2,2025-08-15 16:41:30,kan_roster_turnover_detailed.csv,2025-08-17 08:45:20,32
KAN,2023,2024,TE,4,7,2,2,5,50.0,50.0,71.43,3,2025-08-15 16:41:30,kan_roster_turnover_detailed.csv,2025-08-17 08:45:20,32
KAN,2023,2024,WR,9,11,6,3,5,66.67,33.33,45.45,2,2025-08-15 16:41:30,kan_roster_turnover_detailed.csv,2025-08-17 08:45:20,32
MIA,2011,2012,DB,11,13,4,7,9,36.36,63.64,69.23,2,2025-08-15 16:41:26,mia_roster_turnover_detailed.csv,2025-08-17 08:45:20,32
MIA,2011,2012,DL,8,8,3,5,5,37.5,62.5,62.5,0,2025-08-15 16:41:26,mia_roster_turnover_detailed.csv,2025-08-17 08:45:20,32
MIA,2011,2012,LB,2,4,1,1,3,50.0,50.0,75.0,2,2025-08-15 16:41:26,mia_roster_turnover_detailed.csv,2025-08-17 08:45:20,32
MIA,2011,2012,OL,4,3,2,2,1,50.0,50.0,33.33,-1,2025-08-15 16:41:26,mia_roster_turnover_detailed.csv,2025-08-17 08:45:20,32
MIA,2011,2012,OTHER,13,12,8,5,4,61.54,38.46,33.33,-1,2025-08-15 16:41:26,mia_roster_turnover_detailed.csv,2025-08-17 08:45:20,32
MIA,2011,2012,QB,3,3,1,2,2,33.33,66.67,66.67,0,2025-08-15 16:41:26,mia_roster_turnover_detailed.csv,2025-08-17 08:45:20,32
MIA,2011,2012,RB,7,6,3,4,3,42.86,57.14,50.0,-1,2025-08-15 16:41:26,mia_roster_turnover_detailed.csv,2025-08-17 08:45:20,32
MIA,2011,2012,ST,4,4,3,1,1,75.0,25.0,25.0,0,2025-08-15 16:41:26,mia_roster_turnover_detailed.csv,2025-08-17 08:45:20,32
MIA,2011,2012,TE,4,4,3,1,1,75.0,25.0,25.0,0,2025-08-15 16:41:26,mia_roster_turnover_detailed.csv,2025-08-17 08:45:20,32
MIA,2011,2012,WR,7,8,3,4,5,42.86,57.14,62.5,1,2025-08-15 16:41:26,mia_roster_turnover_detailed.csv,2025-08-17 08:45:20,32
MIA,2012,2013,DB,13,13,5,8,8,38.46,61.54,61.54,0,2025-08-15 16:41:26,mia_roster_turnover_detailed.csv,2025-08-17 08:45:20,32
MIA,2012,2013,DL,8,7,3,5,4,37.5,62.5,57.14,-1,2025-08-15 16:41:26,mia_roster_turnover_detailed.csv,2025-08-17 08:45:20,32
MIA,2012,2013,LB,4,4,2,2,2,50.0,50.0,50.0,0,2025-08-15 16:41:26,mia_roster_turnover_detailed.csv,2025-08-17 08:45:20,32
MIA,2012,2013,OL,3,5,1,2,4,33.33,66.67,80.0,2,2025-08-15 16:41:26,mia_roster_turnover_detailed.csv,2025-08-17 08:45:20,32
MIA,2012,2013,OTHER,12,15,9,3,6,75.0,25.0,40.0,3,2025-08-15 16:41:26,mia_roster_turnover_detailed.csv,2025-08-17 08:45:20,32
MIA,2012,2013,QB,3,2,2,1,0,66.67,33.33,0.0,-1,2025-08-15 16:41:26,mia_roster_turnover_detailed.csv,2025-08-17 08:45:20,32
MIA,2012,2013,RB,6,5,3,3,2,50.0,50.0,40.0,-1,2025-08-15 16:41:26,mia_roster_turnover_detailed.csv,2025-08-17 08:45:20,32
MIA,2012,2013,ST,4,3,2,2,1,50.0,50.0,33.33,-1,2025-08-15 16:41:26,mia_roster_turnover_detailed.csv,2025-08-17 08:45:20,32
MIA,2012,2013,TE,4,5,2,2,3,50.0,50.0,60.0,1,2025-08-15 16:41:26,mia_roster_turnover_detailed.csv,2025-08-17 08:45:20,32
MIA,2012,2013,WR,8,5,2,6,3,25.0,75.0,60.0,-3,2025-08-15 16:41:26,mia_roster_turnover_detailed.csv,2025-08-17 08:45:20,32
MIA,2013,2014,DB,13,15,8,5,7,61.54,38.46,46.67,2,2025-08-15 16:41:26,mia_roster_turnover_detailed.csv,2025-08-17 08:45:20,32
MIA,2013,2014,DL,7,7,3,4,4,42.86,57.14,57.14,0,2025-08-15 16:41:26,mia_roster_turnover_detailed.csv,2025-08-17 08:45:20,32
MIA,2013,2014,LB,4,8,1,3,7,25.0,75.0,87.5,4,2025-08-15 16:41:26,mia_roster_turnover_detailed.csv,2025-08-17 08:45:20,32
MIA,2013,2014,OL,5,5,0,5,5,0.0,100.0,100.0,0,2025-08-15 16:41:26,mia_roster_turnover_detailed.csv,2025-08-17 08:45:20,32
MIA,2013,2014,OTHER,15,12,5,10,7,33.33,66.67,58.33,-3,2025-08-15 16:41:26,mia_roster_turnover_detailed.csv,2025-08-17 08:45:20,32
MIA,2013,2014,QB,2,2,2,0,0,100.0,0.0,0.0,0,2025-08-15 16:41:26,mia_roster_turnover_detailed.csv,2025-08-17 08:45:20,32
MIA,2013,2014,RB,5,6,2,3,4,40.0,60.0,66.67,1,2025-08-15 16:41:26,mia_roster_turnover_detailed.csv,2025-08-17 08:45:20,32
MIA,2013,2014,ST,3,3,3,0,0,100.0,0.0,0.0,0,2025-08-15 16:41:26,mia_roster_turnover_detailed.csv,2025-08-17 08:45:20,32
MIA,2013,2014,TE,5,3,2,3,1,40.0,60.0,33.33,-2,2025-08-15 16:41:26,mia_roster_turnover_detailed.csv,2025-08-17 08:45:20,32
MIA,2013,2014,WR,5,7,3,2,4,60.0,40.0,57.14,2,2025-08-15 16:41:26,mia_roster_turnover_detailed.csv,2025-08-17 08:45:20,32
MIA,2014,2015,DB,15,8,4,11,4,26.67,73.33,50.0,-7,2025-08-15 16:41:26,mia_roster_turnover_detailed.csv,2025-08-17 08:45:20,32
MIA,2014,2015,DL,7,9,2,5,7,28.57,71.43,77.78,2,2025-08-15 16:41:26,mia_roster_turnover_detailed.csv,2025-08-17 08:45:20,32
MIA,2014,2015,LB,8,7,2,6,5,25.0,75.0,71.43,-1,2025-08-15 16:41:26,mia_roster_turnover_detailed.csv,2025-08-17 08:45:20,32
MIA,2014,2015,OL,5,5,0,5,5,0.0,100.0,100.0,0,2025-08-15 16:41:26,mia_roster_turnover_detailed.csv,2025-08-17 08:45:20,32
MIA,2014,2015,OTHER,12,16,7,5,9,58.33,41.67,56.25,4,2025-08-15 16:41:26,mia_roster_turnover_detailed.csv,2025-08-17 08:45:20,32
MIA,2014,2015,QB,2,2,2,0,0,100.0,0.0,0.0,0,2025-08-15 16:41:26,mia_roster_turnover_detailed.csv,2025-08-17 08:45:20,32
MIA,2014,2015,RB,6,6,3,3,3,50.0,50.0,50.0,0,2025-08-15 16:41:26,mia_roster_turnover_detailed.csv,2025-08-17 08:45:20,32
MIA,2014,2015,ST,3,3,1,2,2,33.33,66.67,66.67,0,2025-08-15 16:41:26,mia_roster_turnover_detailed.csv,2025-08-17 08:45:20,32
MIA,2014,2015,TE,3,4,1,2,3,33.33,66.67,75.0,1,2025-08-15 16:41:26,mia_roster_turnover_detailed.csv,2025-08-17 08:45:20,32
MIA,2014,2015,WR,7,7,2,5,5,28.57,71.43,71.43,0,2025-08-15 16:41:26,mia_roster_turnover_detailed.csv,2025-08-17 08:45:20,32
MIA,2015,2016,DB,8,10,4,4,6,50.0,50.0,60.0,2,2025-08-15 16:41:26,mia_roster_turnover_detailed.csv,2025-08-17 08:45:20,32
MIA,2015,2016,DL,9,5,1,8,4,11.11,88.89,80.0,-4,2025-08-15 16:41:26,mia_roster_turnover_detailed.csv,2025-08-17 08:45:20,32
MIA,2015,2016,LB,7,6,3,4,3,42.86,57.14,50.0,-1,2025-08-15 16:41:26,mia_roster_turnover_detailed.csv,2025-08-17 08:45:20,32
MIA,2015,2016,OL,5,8,1,4,7,20.0,80.0,87.5,3,2025-08-15 16:41:26,mia_roster_turnover_detailed.csv,2025-08-17 08:45:20,32
MIA,2015,2016,OTHER,16,17,6,10,11,37.5,62.5,64.71,1,2025-08-15 16:41:26,mia_roster_turnover_detailed.csv,2025-08-17 08:45:20,32
MIA,2015,2016,QB,2,3,2,0,1,100.0,0.0,33.33,1,2025-08-15 16:41:26,mia_roster_turnover_detailed.csv,2025-08-17 08:45:20,32
MIA,2015,2016,RB,6,5,2,4,3,33.33,66.67,60.0,-1,2025-08-15 16:41:26,mia_roster_turnover_detailed.csv,2025-08-17 08:45:20,32
MIA,2015,2016,ST,3,3,3,0,0,100.0,0.0,0.0,0,2025-08-15 16:41:26,mia_roster_turnover_detailed.csv,2025-08-17 08:45:20,32
MIA,2015,2016,TE,4,5,2,2,3,50.0,50.0,60.0,1,2025-08-15 16:41:26,mia_roster_turnover_detailed.csv,2025-08-17 08:45:20,32
MIA,2015,2016,WR,7,7,3,4,4,42.86,57.14,57.14,0,2025-08-15 16:41:26,mia_roster_turnover_detailed.csv,2025-08-17 08:45:20,32
MIA,2016,2017,DB,10,11,5,5,6,50.0,50.0,54.55,1,2025-08-15 16:41:26,mia_roster_turnover_detailed.csv,2025-08-17 08:45:20,32
MIA,2016,2017,DL,5,6,1,4,5,20.0,80.0,83.33,1,2025-08-15 16:41:26,mia_roster_turnover_detailed.csv,2025-08-17 08:45:20,32
MIA,2016,2017,LB,6,6,1,5,5,16.67,83.33,83.33,0,2025-08-15 16:41:26,mia_roster_turnover_detailed.csv,2025-08-17 08:45:20,32
MIA,2016,2017,OL,8,4,2,6,2,25.0,75.0,50.0,-4,2025-08-15 16:41:26,mia_roster_turnover_detailed.csv,2025-08-17 08:45:20,32
MIA,2016,2017,OTHER,17,16,8,9,8,47.06,52.94,50.0,-1,2025-08-15 16:41:26,mia_roster_turnover_detailed.csv,2025-08-17 08:45:20,32
MIA,2016,2017,QB,3,3,1,2,2,33.33,66.67,66.67,0,2025-08-15 16:41:26,mia_roster_turnover_detailed.csv,2025-08-17 08:45:20,32
MIA,2016,2017,RB,5,5,3,2,2,60.0,40.0,40.0,0,2025-08-15 16:41:26,mia_roster_turnover_detailed.csv,2025-08-17 08:45:20,32
MIA,2016,2017,ST,3,3,1,2,2,33.33,66.67,66.67,0,2025-08-15 16:41:26,mia_roster_turnover_detailed.csv,2025-08-17 08:45:20,32
MIA,2016,2017,TE,5,4,1,4,3,20.0,80.0,75.0,-1,2025-08-15 16:41:26,mia_roster_turnover_detailed.csv,2025-08-17 08:45:20,32
MIA,2016,2017,WR,7,6,6,1,0,85.71,14.29,0.0,-1,2025-08-15 16:41:26,mia_roster_turnover_detailed.csv,2025-08-17 08:45:20,32
MIA,2017,2018,DB,11,9,5,6,4,45.45,54.55,44.44,-2,2025-08-15 16:41:26,mia_roster_turnover_detailed.csv,2025-08-17 08:45:20,32
MIA,2017,2018,DL,6,10,4,2,6,66.67,33.33,60.0,4,2025-08-15 16:41:26,mia_roster_turnover_detailed.csv,2025-08-17 08:45:20,32
MIA,2017,2018,LB,6,5,3,3,2,50.0,50.0,40.0,-1,2025-08-15 16:41:26,mia_roster_turnover_detailed.csv,2025-08-17 08:45:20,32
MIA,2017,2018,OL,4,8,3,1,5,75.0,25.0,62.5,4,2025-08-15 16:41:26,mia_roster_turnover_detailed.csv,2025-08-17 08:45:20,32
MIA,2017,2018,OTHER,16,12,8,8,4,50.0,50.0,33.33,-4,2025-08-15 16:41:26,mia_roster_turnover_detailed.csv,2025-08-17 08:45:20,32
MIA,2017,2018,QB,3,2,0,3,2,0.0,100.0,100.0,-1,2025-08-15 16:41:26,mia_roster_turnover_detailed.csv,2025-08-17 08:45:20,32
MIA,2017,2018,RB,5,5,2,3,3,40.0,60.0,60.0,0,2025-08-15 16:41:26,mia_roster_turnover_detailed.csv,2025-08-17 08:45:20,32
MIA,2017,2018,ST,3,3,2,1,1,66.67,33.33,33.33,0,2025-08-15 16:41:26,mia_roster_turnover_detailed.csv,2025-08-17 08:45:20,32
MIA,2017,2018,TE,4,5,1,3,4,25.0,75.0,80.0,1,2025-08-15 16:41:26,mia_roster_turnover_detailed.csv,2025-08-17 08:45:20,32
MIA,2017,2018,WR,6,8,4,2,4,66.67,33.33,50.0,2,2025-08-15 16:41:26,mia_roster_turnover_detailed.csv,2025-08-17 08:45:20,32
MIA,2018,2019,DB,9,19,3,6,16,33.33,66.67,84.21,10,2025-08-15 16:41:26,mia_roster_turnover_detailed.csv,2025-08-17 08:45:20,32
MIA,2018,2019,DL,10,9,0,10,9,0.0,100.0,100.0,-1,2025-08-15 16:41:26,mia_roster_turnover_detailed.csv,2025-08-17 08:45:20,32
MIA,2018,2019,LB,5,4,0,5,4,0.0,100.0,100.0,-1,2025-08-15 16:41:26,mia_roster_turnover_detailed.csv,2025-08-17 08:45:20,32
MIA,2018,2019,OL,8,8,1,7,7,12.5,87.5,87.5,0,2025-08-15 16:41:26,mia_roster_turnover_detailed.csv,2025-08-17 08:45:20,32
MIA,2018,2019,OTHER,12,17,3,9,14,25.0,75.0,82.35,5,2025-08-15 16:41:26,mia_roster_turnover_detailed.csv,2025-08-17 08:45:20,32
MIA,2018,2019,QB,2,2,0,2,2,0.0,100.0,100.0,0,2025-08-15 16:41:26,mia_roster_turnover_detailed.csv,2025-08-17 08:45:20,32
MIA,2018,2019,RB,5,9,2,3,7,40.0,60.0,77.78,4,2025-08-15 16:41:26,mia_roster_turnover_detailed.csv,2025-08-17 08:45:20,32
MIA,2018,2019,ST,3,3,2,1,1,66.67,33.33,33.33,0,2025-08-15 16:41:26,mia_roster_turnover_detailed.csv,2025-08-17 08:45:20,32
MIA,2018,2019,TE,5,4,3,2,1,60.0,40.0,25.0,-1,2025-08-15 16:41:26,mia_roster_turnover_detailed.csv,2025-08-17 08:45:20,32
MIA,2018,2019,WR,8,9,4,4,5,50.0,50.0,55.56,1,2025-08-15 16:41:26,mia_roster_turnover_detailed.csv,2025-08-17 08:45:20,32
MIA,2019,2020,DB,19,10,4,15,6,21.05,78.95,60.0,-9,2025-08-15 16:41:26,mia_roster_turnover_detailed.csv,2025-08-17 08:45:20,32
MIA,2019,2020,DL,9,5,1,8,4,11.11,88.89,80.0,-4,2025-08-15 16:41:26,mia_roster_turnover_detailed.csv,2025-08-17 08:45:20,32
MIA,2019,2020,LB,4,3,1,3,2,25.0,75.0,66.67,-1,2025-08-15 16:41:26,mia_roster_turnover_detailed.csv,2025-08-17 08:45:20,32
MIA,2019,2020,OL,8,4,1,7,3,12.5,87.5,75.0,-4,2025-08-15 16:41:26,mia_roster_turnover_detailed.csv,2025-08-17 08:45:20,32
MIA,2019,2020,OTHER,17,15,4,13,11,23.53,76.47,73.33,-2,2025-08-15 16:41:26,mia_roster_turnover_detailed.csv,2025-08-17 08:45:20,32
MIA,2019,2020,QB,2,2,1,1,1,50.0,50.0,50.0,0,2025-08-15 16:41:26,mia_roster_turnover_detailed.csv,2025-08-17 08:45:20,32
MIA,2019,2020,RB,9,7,3,6,4,33.33,66.67,57.14,-2,2025-08-15 16:41:26,mia_roster_turnover_detailed.csv,2025-08-17 08:45:20,32
MIA,2019,2020,ST,3,3,2,1,1,66.67,33.33,33.33,0,2025-08-15 16:41:26,mia_roster_turnover_detailed.csv,2025-08-17 08:45:20,32
MIA,2019,2020,TE,4,4,2,2,2,50.0,50.0,50.0,0,2025-08-15 16:41:26,mia_roster_turnover_detailed.csv,2025-08-17 08:45:20,32
MIA,2019,2020,WR,9,10,5,4,5,55.56,44.44,50.0,1,2025-08-15 16:41:26,mia_roster_turnover_detailed.csv,2025-08-17 08:45:20,32
MIA,2020,2021,DB,10,15,6,4,9,60.0,40.0,60.0,5,2025-08-15 16:41:26,mia_roster_turnover_detailed.csv,2025-08-17 08:45:20,32
MIA,2020,2021,DL,5,3,0,5,3,0.0,100.0,100.0,-2,2025-08-15 16:41:26,mia_roster_turnover_detailed.csv,2025-08-17 08:45:20,32
MIA,2020,2021,LB,3,7,2,1,5,66.67,33.33,71.43,4,2025-08-15 16:41:26,mia_roster_turnover_detailed.csv,2025-08-17 08:45:20,32
MIA,2020,2021,OL,4,7,2,2,5,50.0,50.0,71.43,3,2025-08-15 16:41:26,mia_roster_turnover_detailed.csv,2025-08-17 08:45:20,32
MIA,2020,2021,OTHER,15,12,10,5,2,66.67,33.33,16.67,-3,2025-08-15 16:41:26,mia_roster_turnover_detailed.csv,2025-08-17 08:45:20,32
MIA,2020,2021,QB,2,2,1,1,1,50.0,50.0,50.0,0,2025-08-15 16:41:26,mia_roster_turnover_detailed.csv,2025-08-17 08:45:20,32
MIA,2020,2021,RB,7,7,3,4,4,42.86,57.14,57.14,0,2025-08-15 16:41:26,mia_roster_turnover_detailed.csv,2025-08-17 08:45:20,32
MIA,2020,2021,ST,3,3,2,1,1,66.67,33.33,33.33,0,2025-08-15 16:41:26,mia_roster_turnover_detailed.csv,2025-08-17 08:45:20,32
MIA,2020,2021,TE,4,5,3,1,2,75.0,25.0,40.0,1,2025-08-15 16:41:26,mia_roster_turnover_detailed.csv,2025-08-17 08:45:20,32
MIA,2020,2021,WR,10,10,6,4,4,60.0,40.0,40.0,0,2025-08-15 16:41:26,mia_roster_turnover_detailed.csv,2025-08-17 08:45:20,32
MIA,2021,2022,DB,15,9,6,9,3,40.0,60.0,33.33,-6,2025-08-15 16:41:26,mia_roster_turnover_detailed.csv,2025-08-17 08:45:20,32
MIA,2021,2022,DL,3,6,1,2,5,33.33,66.67,83.33,3,2025-08-15 16:41:26,mia_roster_turnover_detailed.csv,2025-08-17 08:45:20,32
MIA,2021,2022,LB,7,6,3,4,3,42.86,57.14,50.0,-1,2025-08-15 16:41:26,mia_roster_turnover_detailed.csv,2025-08-17 08:45:20,32
MIA,2021,2022,OL,7,5,1,6,4,14.29,85.71,80.0,-2,2025-08-15 16:41:26,mia_roster_turnover_detailed.csv,2025-08-17 08:45:20,32
MIA,2021,2022,OTHER,12,17,8,4,9,66.67,33.33,52.94,5,2025-08-15 16:41:26,mia_roster_turnover_detailed.csv,2025-08-17 08:45:20,32
MIA,2021,2022,QB,2,3,1,1,2,50.0,50.0,66.67,1,2025-08-15 16:41:26,mia_roster_turnover_detailed.csv,2025-08-17 08:45:20,32
MIA,2021,2022,RB,7,6,2,5,4,28.57,71.43,66.67,-1,2025-08-15 16:41:26,mia_roster_turnover_detailed.csv,2025-08-17 08:45:20,32
MIA,2021,2022,ST,3,3,2,1,1,66.67,33.33,33.33,0,2025-08-15 16:41:26,mia_roster_turnover_detailed.csv,2025-08-17 08:45:20,32
MIA,2021,2022,TE,5,5,4,1,1,80.0,20.0,20.0,0,2025-08-15 16:41:26,mia_roster_turnover_detailed.csv,2025-08-17 08:45:20,32
MIA,2021,2022,WR,10,8,1,9,7,10.0,90.0,87.5,-2,2025-08-15 16:41:26,mia_roster_turnover_detailed.csv,2025-08-17 08:45:20,32
MIA,2022,2023,DB,9,13,4,5,9,44.44,55.56,69.23,4,2025-08-15 16:41:26,mia_roster_turnover_detailed.csv,2025-08-17 08:45:20,32
MIA,2022,2023,DL,6,7,2,4,5,33.33,66.67,71.43,1,2025-08-15 16:41:26,mia_roster_turnover_detailed.csv,2025-08-17 08:45:20,32
MIA,2022,2023,LB,6,11,3,3,8,50.0,50.0,72.73,5,2025-08-15 16:41:26,mia_roster_turnover_detailed.csv,2025-08-17 08:45:20,32
MIA,2022,2023,OL,5,10,3,2,7,60.0,40.0,70.0,5,2025-08-15 16:41:26,mia_roster_turnover_detailed.csv,2025-08-17 08:45:20,32
MIA,2022,2023,OTHER,17,5,5,12,0,29.41,70.59,0.0,-12,2025-08-15 16:41:26,mia_roster_turnover_detailed.csv,2025-08-17 08:45:20,32
MIA,2022,2023,QB,3,2,1,2,1,33.33,66.67,50.0,-1,2025-08-15 16:41:26,mia_roster_turnover_detailed.csv,2025-08-17 08:45:20,32
MIA,2022,2023,RB,6,7,4,2,3,66.67,33.33,42.86,1,2025-08-15 16:41:26,mia_roster_turnover_detailed.csv,2025-08-17 08:45:20,32
MIA,2022,2023,ST,3,3,2,1,1,66.67,33.33,33.33,0,2025-08-15 16:41:26,mia_roster_turnover_detailed.csv,2025-08-17 08:45:20,32
MIA,2022,2023,TE,5,4,2,3,2,40.0,60.0,50.0,-1,2025-08-15 16:41:26,mia_roster_turnover_detailed.csv,2025-08-17 08:45:20,32
MIA,2022,2023,WR,8,8,5,3,3,62.5,37.5,37.5,0,2025-08-15 16:41:26,mia_roster_turnover_detailed.csv,2025-08-17 08:45:20,32
MIA,2023,2024,DB,13,11,6,7,5,46.15,53.85,45.45,-2,2025-08-15 16:41:26,mia_roster_turnover_detailed.csv,2025-08-17 08:45:20,32
MIA,2023,2024,DL,7,5,2,5,3,28.57,71.43,60.0,-2,2025-08-15 16:41:26,mia_roster_turnover_detailed.csv,2025-08-17 08:45:20,32
MIA,2023,2024,LB,11,9,4,7,5,36.36,63.64,55.56,-2,2025-08-15 16:41:26,mia_roster_turnover_detailed.csv,2025-08-17 08:45:20,32
MIA,2023,2024,OL,10,7,3,7,4,30.0,70.0,57.14,-3,2025-08-15 16:41:26,mia_roster_turnover_detailed.csv,2025-08-17 08:45:20,32
MIA,2023,2024,OTHER,5,12,0,5,12,0.0,100.0,100.0,7,2025-08-15 16:41:26,mia_roster_turnover_detailed.csv,2025-08-17 08:45:20,32
MIA,2023,2024,QB,2,4,1,1,3,50.0,50.0,75.0,2,2025-08-15 16:41:26,mia_roster_turnover_detailed.csv,2025-08-17 08:45:20,32
MIA,2023,2024,RB,7,5,4,3,1,57.14,42.86,20.0,-2,2025-08-15 16:41:26,mia_roster_turnover_detailed.csv,2025-08-17 08:45:20,32
MIA,2023,2024,ST,3,7,3,0,4,100.0,0.0,57.14,4,2025-08-15 16:41:26,mia_roster_turnover_detailed.csv,2025-08-17 08:45:20,32
MIA,2023,2024,TE,4,5,3,1,2,75.0,25.0,40.0,1,2025-08-15 16:41:26,mia_roster_turnover_detailed.csv,2025-08-17 08:45:20,32
MIA,2023,2024,WR,8,10,6,2,4,75.0,25.0,40.0,2,2025-08-15 16:41:26,mia_roster_turnover_detailed.csv,2025-08-17 08:45:20,32
MIN,2011,2012,DB,11,8,5,6,3,45.45,54.55,37.5,-3,2025-08-15 16:41:28,min_roster_turnover_detailed.csv,2025-08-17 08:45:20,32
MIN,2011,2012,DL,5,5,3,2,2,60.0,40.0,40.0,0,2025-08-15 16:41:28,min_roster_turnover_detailed.csv,2025-08-17 08:45:20,32
MIN,2011,2012,LB,5,5,1,4,4,20.0,80.0,80.0,0,2025-08-15 16:41:28,min_roster_turnover_detailed.csv,2025-08-17 08:45:20,32
MIN,2011,2012,OL,3,3,1,2,2,33.33,66.67,66.67,0,2025-08-15 16:41:28,min_roster_turnover_detailed.csv,2025-08-17 08:45:20,32
MIN,2011,2012,OTHER,14,13,8,6,5,57.14,42.86,38.46,-1,2025-08-15 16:41:28,min_roster_turnover_detailed.csv,2025-08-17 08:45:20,32
MIN,2011,2012,QB,3,2,2,1,0,66.67,33.33,0.0,-1,2025-08-15 16:41:28,min_roster_turnover_detailed.csv,2025-08-17 08:45:20,32
MIN,2011,2012,RB,3,5,2,1,3,66.67,33.33,60.0,2,2025-08-15 16:41:28,min_roster_turnover_detailed.csv,2025-08-17 08:45:20,32
MIN,2011,2012,ST,4,3,2,2,1,50.0,50.0,33.33,-1,2025-08-15 16:41:28,min_roster_turnover_detailed.csv,2025-08-17 08:45:20,32
MIN,2011,2012,TE,4,3,2,2,1,50.0,50.0,33.33,-1,2025-08-15 16:41:28,min_roster_turnover_detailed.csv,2025-08-17 08:45:20,32
MIN,2011,2012,WR,7,6,4,3,2,57.14,42.86,33.33,-1,2025-08-15 16:41:28,min_roster_turnover_detailed.csv,2025-08-17 08:45:20,32
MIN,2012,2013,DB,8,9,6,2,3,75.0,25.0,33.33,1,2025-08-15 16:41:28,min_roster_turnover_detailed.csv,2025-08-17 08:45:20,32
MIN,2012,2013,DL,5,5,2,3,3,40.0,60.0,60.0,0,2025-08-15 16:41:28,min_roster_turnover_detailed.csv,2025-08-17 08:45:20,32
MIN,2012,2013,LB,5,6,2,3,4,40.0,60.0,66.67,1,2025-08-15 16:41:28,min_roster_turnover_detailed.csv,2025-08-17 08:45:20,32
MIN,2012,2013,OL,3,4,2,1,2,66.67,33.33,50.0,1,2025-08-15 16:41:28,min_roster_turnover_detailed.csv,2025-08-17 08:45:20,32
MIN,2012,2013,OTHER,13,13,10,3,3,76.92,23.08,23.08,0,2025-08-15 16:41:28,min_roster_turnover_detailed.csv,2025-08-17 08:45:20,32
MIN,2012,2013,QB,2,3,1,1,2,50.0,50.0,66.67,1,2025-08-15 16:41:28,min_roster_turnover_detailed.csv,2025-08-17 08:45:20,32
MIN,2012,2013,RB,5,7,5,0,2,100.0,0.0,28.57,2,2025-08-15 16:41:28,min_roster_turnover_detailed.csv,2025-08-17 08:45:20,32
MIN,2012,2013,ST,3,3,2,1,1,66.67,33.33,33.33,0,2025-08-15 16:41:28,min_roster_turnover_detailed.csv,2025-08-17 08:45:20,32
MIN,2012,2013,TE,3,3,2,1,1,66.67,33.33,33.33,0,2025-08-15 16:41:28,min_roster_turnover_detailed.csv,2025-08-17 08:45:20,32
MIN,2012,2013,WR,6,6,2,4,4,33.33,66.67,66.67,0,2025-08-15 16:41:28,min_roster_turnover_detailed.csv,2025-08-17 08:45:20,32
MIN,2013,2014,DB,9,8,5,4,3,55.56,44.44,37.5,-1,2025-08-15 16:41:28,min_roster_turnover_detailed.csv,2025-08-17 08:45:20,32
MIN,2013,2014,DL,5,5,1,4,4,20.0,80.0,80.0,0,2025-08-15 16:41:28,min_roster_turnover_detailed.csv,2025-08-17 08:45:20,32
MIN,2013,2014,LB,6,5,2,4,3,33.33,66.67,60.0,-1,2025-08-15 16:41:28,min_roster_turnover_detailed.csv,2025-08-17 08:45:20,32
MIN,2013,2014,OL,4,4,2,2,2,50.0,50.0,50.0,0,2025-08-15 16:41:28,min_roster_turnover_detailed.csv,2025-08-17 08:45:20,32
MIN,2013,2014,OTHER,13,15,6,7,9,46.15,53.85,60.0,2,2025-08-15 16:41:28,min_roster_turnover_detailed.csv,2025-08-17 08:45:20,32
MIN,2013,2014,QB,3,3,2,1,1,66.67,33.33,33.33,0,2025-08-15 16:41:28,min_roster_turnover_detailed.csv,2025-08-17 08:45:20,32
MIN,2013,2014,RB,7,7,5,2,2,71.43,28.57,28.57,0,2025-08-15 16:41:28,min_roster_turnover_detailed.csv,2025-08-17 08:45:20,32
MIN,2013,2014,ST,3,3,3,0,0,100.0,0.0,0.0,0,2025-08-15 16:41:28,min_roster_turnover_detailed.csv,2025-08-17 08:45:20,32
MIN,2013,2014,TE,3,4,2,1,2,66.67,33.33,50.0,1,2025-08-15 16:41:28,min_roster_turnover_detailed.csv,2025-08-17 08:45:20,32
MIN,2013,2014,WR,6,6,4,2,2,66.67,33.33,33.33,0,2025-08-15 16:41:28,min_roster_turnover_detailed.csv,2025-08-17 08:45:20,32
MIN,2014,2015,DB,8,10,7,1,3,87.5,12.5,30.0,2,2025-08-15 16:41:28,min_roster_turnover_detailed.csv,2025-08-17 08:45:20,32
MIN,2014,2015,DL,5,7,3,2,4,60.0,40.0,57.14,2,2025-08-15 16:41:28,min_roster_turnover_detailed.csv,2025-08-17 08:45:20,32
MIN,2014,2015,LB,5,5,2,3,3,40.0,60.0,60.0,0,2025-08-15 16:41:28,min_roster_turnover_detailed.csv,2025-08-17 08:45:20,32
MIN,2014,2015,OL,4,3,0,4,3,0.0,100.0,100.0,-1,2025-08-15 16:41:28,min_roster_turnover_detailed.csv,2025-08-17 08:45:20,32
MIN,2014,2015,OTHER,15,13,9,6,4,60.0,40.0,30.77,-2,2025-08-15 16:41:28,min_roster_turnover_detailed.csv,2025-08-17 08:45:20,32
MIN,2014,2015,QB,3,2,1,2,1,33.33,66.67,50.0,-1,2025-08-15 16:41:28,min_roster_turnover_detailed.csv,2025-08-17 08:45:20,32
MIN,2014,2015,RB,7,4,4,3,0,57.14,42.86,0.0,-3,2025-08-15 16:41:28,min_roster_turnover_detailed.csv,2025-08-17 08:45:20,32
MIN,2014,2015,ST,3,3,2,1,1,66.67,33.33,33.33,0,2025-08-15 16:41:28,min_roster_turnover_detailed.csv,2025-08-17 08:45:20,32
MIN,2014,2015,TE,4,3,2,2,1,50.0,50.0,33.33,-1,2025-08-15 16:41:28,min_roster_turnover_detailed.csv,2025-08-17 08:45:20,32
MIN,2014,2015,WR,6,6,4,2,2,66.67,33.33,33.33,0,2025-08-15 16:41:28,min_roster_turnover_detailed.csv,2025-08-17 08:45:20,32
MIN,2015,2016,DB,10,7,6,4,1,60.0,40.0,14.29,-3,2025-08-15 16:41:28,min_roster_turnover_detailed.csv,2025-08-17 08:45:20,32
MIN,2015,2016,DL,7,5,2,5,3,28.57,71.43,60.0,-2,2025-08-15 16:41:28,min_roster_turnover_detailed.csv,2025-08-17 08:45:20,32
MIN,2015,2016,LB,5,7,3,2,4,60.0,40.0,57.14,2,2025-08-15 16:41:28,min_roster_turnover_detailed.csv,2025-08-17 08:45:20,32
MIN,2015,2016,OL,3,8,2,1,6,66.67,33.33,75.0,5,2025-08-15 16:41:28,min_roster_turnover_detailed.csv,2025-08-17 08:45:20,32
MIN,2015,2016,OTHER,13,12,9,4,3,69.23,30.77,25.0,-1,2025-08-15 16:41:28,min_roster_turnover_detailed.csv,2025-08-17 08:45:20,32
MIN,2015,2016,QB,2,2,1,1,1,50.0,50.0,50.0,0,2025-08-15 16:41:28,min_roster_turnover_detailed.csv,2025-08-17 08:45:20,32
MIN,2015,2016,RB,4,5,4,0,1,100.0,0.0,20.0,1,2025-08-15 16:41:28,min_roster_turnover_detailed.csv,2025-08-17 08:45:20,32
MIN,2015,2016,ST,3,4,3,0,1,100.0,0.0,25.0,1,2025-08-15 16:41:28,min_roster_turnover_detailed.csv,2025-08-17 08:45:20,32
MIN,2015,2016,TE,3,4,3,0,1,100.0,0.0,25.0,1,2025-08-15 16:41:28,min_roster_turnover_detailed.csv,2025-08-17 08:45:20,32
MIN,2015,2016,WR,6,7,5,1,2,83.33,16.67,28.57,1,2025-08-15 16:41:28,min_roster_turnover_detailed.csv,2025-08-17 08:45:20,32
MIN,2016,2017,DB,7,8,5,2,3,71.43,28.57,37.5,1,2025-08-15 16:41:28,min_roster_turnover_detailed.csv,2025-08-17 08:45:20,32
MIN,2016,2017,DL,5,4,0,5,4,0.0,100.0,100.0,-1,2025-08-15 16:41:28,min_roster_turnover_detailed.csv,2025-08-17 08:45:20,32
MIN,2016,2017,LB,7,6,5,2,1,71.43,28.57,16.67,-1,2025-08-15 16:41:28,min_roster_turnover_detailed.csv,2025-08-17 08:45:20,32
MIN,2016,2017,OL,8,5,0,8,5,0.0,100.0,100.0,-3,2025-08-15 16:41:28,min_roster_turnover_detailed.csv,2025-08-17 08:45:20,32
MIN,2016,2017,OTHER,12,13,4,8,9,33.33,66.67,69.23,1,2025-08-15 16:41:28,min_roster_turnover_detailed.csv,2025-08-17 08:45:20,32
MIN,2016,2017,QB,2,3,1,1,2,50.0,50.0,66.67,1,2025-08-15 16:41:28,min_roster_turnover_detailed.csv,2025-08-17 08:45:20,32
MIN,2016,2017,RB,5,4,1,4,3,20.0,80.0,75.0,-1,2025-08-15 16:41:28,min_roster_turnover_detailed.csv,2025-08-17 08:45:20,32
MIN,2016,2017,ST,4,3,2,2,1,50.0,50.0,33.33,-1,2025-08-15 16:41:28,min_roster_turnover_detailed.csv,2025-08-17 08:45:20,32
MIN,2016,2017,TE,4,4,2,2,2,50.0,50.0,50.0,0,2025-08-15 16:41:28,min_roster_turnover_detailed.csv,2025-08-17 08:45:20,32
MIN,2016,2017,WR,7,6,4,3,2,57.14,42.86,33.33,-1,2025-08-15 16:41:28,min_roster_turnover_detailed.csv,2025-08-17 08:45:20,32
MIN,2017,2018,DB,8,10,5,3,5,62.5,37.5,50.0,2,2025-08-15 16:41:28,min_roster_turnover_detailed.csv,2025-08-17 08:45:20,32
MIN,2017,2018,DL,4,5,2,2,3,50.0,50.0,60.0,1,2025-08-15 16:41:28,min_roster_turnover_detailed.csv,2025-08-17 08:45:20,32
MIN,2017,2018,LB,6,4,3,3,1,50.0,50.0,25.0,-2,2025-08-15 16:41:28,min_roster_turnover_detailed.csv,2025-08-17 08:45:20,32
MIN,2017,2018,OL,5,4,2,3,2,40.0,60.0,50.0,-1,2025-08-15 16:41:28,min_roster_turnover_detailed.csv,2025-08-17 08:45:20,32
MIN,2017,2018,OTHER,13,14,10,3,4,76.92,23.08,28.57,1,2025-08-15 16:41:28,min_roster_turnover_detailed.csv,2025-08-17 08:45:20,32
MIN,2017,2018,QB,3,1,0,3,1,0.0,100.0,100.0,-2,2025-08-15 16:41:28,min_roster_turnover_detailed.csv,2025-08-17 08:45:20,32
MIN,2017,2018,RB,4,6,3,1,3,75.0,25.0,50.0,2,2025-08-15 16:41:28,min_roster_turnover_detailed.csv,2025-08-17 08:45:20,32
MIN,2017,2018,ST,3,4,1,2,3,33.33,66.67,75.0,1,2025-08-15 16:41:28,min_roster_turnover_detailed.csv,2025-08-17 08:45:20,32
MIN,2017,2018,TE,4,3,2,2,1,50.0,50.0,33.33,-1,2025-08-15 16:41:28,min_roster_turnover_detailed.csv,2025-08-17 08:45:20,32
MIN,2017,2018,WR,6,7,4,2,3,66.67,33.33,42.86,1,2025-08-15 16:41:28,min_roster_turnover_detailed.csv,2025-08-17 08:45:20,32
MIN,2018,2019,DB,10,11,7,3,4,70.0,30.0,36.36,1,2025-08-15 16:41:28,min_roster_turnover_detailed.csv,2025-08-17 08:45:20,32
MIN,2018,2019,DL,5,5,2,3,3,40.0,60.0,60.0,0,2025-08-15 16:41:28,min_roster_turnover_detailed.csv,2025-08-17 08:45:20,32
MIN,2018,2019,LB,4,6,3,1,3,75.0,25.0,50.0,2,2025-08-15 16:41:28,min_roster_turnover_detailed.csv,2025-08-17 08:45:20,32
MIN,2018,2019,OL,4,7,1,3,6,25.0,75.0,85.71,3,2025-08-15 16:41:28,min_roster_turnover_detailed.csv,2025-08-17 08:45:20,32
MIN,2018,2019,OTHER,14,13,9,5,4,64.29,35.71,30.77,-1,2025-08-15 16:41:28,min_roster_turnover_detailed.csv,2025-08-17 08:45:20,32
MIN,2018,2019,QB,1,2,1,0,1,100.0,0.0,50.0,1,2025-08-15 16:41:28,min_roster_turnover_detailed.csv,2025-08-17 08:45:20,32
MIN,2018,2019,RB,6,5,4,2,1,66.67,33.33,20.0,-1,2025-08-15 16:41:28,min_roster_turnover_detailed.csv,2025-08-17 08:45:20,32
MIN,2018,2019,ST,4,3,1,3,2,25.0,75.0,66.67,-1,2025-08-15 16:41:28,min_roster_turnover_detailed.csv,2025-08-17 08:45:20,32
MIN,2018,2019,TE,3,4,2,1,2,66.67,33.33,50.0,1,2025-08-15 16:41:28,min_roster_turnover_detailed.csv,2025-08-17 08:45:20,32
MIN,2018,2019,WR,7,8,4,3,4,57.14,42.86,50.0,1,2025-08-15 16:41:28,min_roster_turnover_detailed.csv,2025-08-17 08:45:20,32
MIN,2019,2020,DB,11,15,7,4,8,63.64,36.36,53.33,4,2025-08-15 16:41:28,min_roster_turnover_detailed.csv,2025-08-17 08:45:20,32
MIN,2019,2020,DL,5,6,2,3,4,40.0,60.0,66.67,1,2025-08-15 16:41:28,min_roster_turnover_detailed.csv,2025-08-17 08:45:20,32
MIN,2019,2020,LB,6,7,1,5,6,16.67,83.33,85.71,1,2025-08-15 16:41:28,min_roster_turnover_detailed.csv,2025-08-17 08:45:20,32
MIN,2019,2020,OL,7,6,5,2,1,71.43,28.57,16.67,-1,2025-08-15 16:41:28,min_roster_turnover_detailed.csv,2025-08-17 08:45:20,32
MIN,2019,2020,OTHER,13,13,4,9,9,30.77,69.23,69.23,0,2025-08-15 16:41:28,min_roster_turnover_detailed.csv,2025-08-17 08:45:20,32
MIN,2019,2020,QB,2,1,1,1,0,50.0,50.0,0.0,-1,2025-08-15 16:41:28,min_roster_turnover_detailed.csv,2025-08-17 08:45:20,32
MIN,2019,2020,RB,5,6,5,0,1,100.0,0.0,16.67,1,2025-08-15 16:41:28,min_roster_turnover_detailed.csv,2025-08-17 08:45:20,32
MIN,2019,2020,ST,3,4,3,0,1,100.0,0.0,25.0,1,2025-08-15 16:41:28,min_roster_turnover_detailed.csv,2025-08-17 08:45:20,32
MIN,2019,2020,TE,4,5,4,0,1,100.0,0.0,20.0,1,2025-08-15 16:41:28,min_roster_turnover_detailed.csv,2025-08-17 08:45:20,32
MIN,2019,2020,WR,8,7,3,5,4,37.5,62.5,57.14,-1,2025-08-15 16:41:28,min_roster_turnover_detailed.csv,2025-08-17 08:45:20,32
MIN,2020,2021,DB,15,10,4,11,6,26.67,73.33,60.0,-5,2025-08-15 16:41:28,min_roster_turnover_detailed.csv,2025-08-17 08:45:20,32
MIN,2020,2021,DL,6,7,2,4,5,33.33,66.67,71.43,1,2025-08-15 16:41:28,min_roster_turnover_detailed.csv,2025-08-17 08:45:20,32
MIN,2020,2021,LB,7,6,2,5,4,28.57,71.43,66.67,-1,2025-08-15 16:41:28,min_roster_turnover_detailed.csv,2025-08-17 08:45:20,32
MIN,2020,2021,OL,6,5,1,5,4,16.67,83.33,80.0,-1,2025-08-15 16:41:28,min_roster_turnover_detailed.csv,2025-08-17 08:45:20,32
MIN,2020,2021,OTHER,13,19,3,10,16,23.08,76.92,84.21,6,2025-08-15 16:41:28,min_roster_turnover_detailed.csv,2025-08-17 08:45:20,32
MIN,2020,2021,QB,1,3,1,0,2,100.0,0.0,66.67,2,2025-08-15 16:41:28,min_roster_turnover_detailed.csv,2025-08-17 08:45:20,32
MIN,2020,2021,RB,6,8,5,1,3,83.33,16.67,37.5,2,2025-08-15 16:41:28,min_roster_turnover_detailed.csv,2025-08-17 08:45:20,32
MIN,2020,2021,ST,4,3,1,3,2,25.0,75.0,66.67,-1,2025-08-15 16:41:28,min_roster_turnover_detailed.csv,2025-08-17 08:45:20,32
MIN,2020,2021,TE,5,4,2,3,2,40.0,60.0,50.0,-1,2025-08-15 16:41:28,min_roster_turnover_detailed.csv,2025-08-17 08:45:20,32
MIN,2020,2021,WR,7,7,4,3,3,57.14,42.86,42.86,0,2025-08-15 16:41:28,min_roster_turnover_detailed.csv,2025-08-17 08:45:20,32
MIN,2021,2022,DB,10,12,5,5,7,50.0,50.0,58.33,2,2025-08-15 16:41:28,min_roster_turnover_detailed.csv,2025-08-17 08:45:20,32
MIN,2021,2022,DL,7,6,2,5,4,28.57,71.43,66.67,-1,2025-08-15 16:41:28,min_roster_turnover_detailed.csv,2025-08-17 08:45:20,32
MIN,2021,2022,LB,6,7,2,4,5,33.33,66.67,71.43,1,2025-08-15 16:41:28,min_roster_turnover_detailed.csv,2025-08-17 08:45:20,32
MIN,2021,2022,OL,5,8,2,3,6,40.0,60.0,75.0,3,2025-08-15 16:41:28,min_roster_turnover_detailed.csv,2025-08-17 08:45:20,32
MIN,2021,2022,OTHER,19,13,7,12,6,36.84,63.16,46.15,-6,2025-08-15 16:41:28,min_roster_turnover_detailed.csv,2025-08-17 08:45:20,32
MIN,2021,2022,QB,3,2,1,2,1,33.33,66.67,50.0,-1,2025-08-15 16:41:28,min_roster_turnover_detailed.csv,2025-08-17 08:45:20,32
MIN,2021,2022,RB,8,5,4,4,1,50.0,50.0,20.0,-3,2025-08-15 16:41:28,min_roster_turnover_detailed.csv,2025-08-17 08:45:20,32
MIN,2021,2022,ST,3,3,2,1,1,66.67,33.33,33.33,0,2025-08-15 16:41:28,min_roster_turnover_detailed.csv,2025-08-17 08:45:20,32
MIN,2021,2022,TE,4,6,1,3,5,25.0,75.0,83.33,2,2025-08-15 16:41:28,min_roster_turnover_detailed.csv,2025-08-17 08:45:20,32
MIN,2021,2022,WR,7,6,4,3,2,57.14,42.86,33.33,-1,2025-08-15 16:41:28,min_roster_turnover_detailed.csv,2025-08-17 08:45:20,32
MIN,2022,2023,DB,12,13,7,5,6,58.33,41.67,46.15,1,2025-08-15 16:41:28,min_roster_turnover_detailed.csv,2025-08-17 08:45:20,32
MIN,2022,2023,DL,6,8,3,3,5,50.0,50.0,62.5,2,2025-08-15 16:41:28,min_roster_turnover_detailed.csv,2025-08-17 08:45:20,32
MIN,2022,2023,LB,7,12,5,2,7,71.43,28.57,58.33,5,2025-08-15 16:41:28,min_roster_turnover_detailed.csv,2025-08-17 08:45:20,32
MIN,2022,2023,OL,8,11,5,3,6,62.5,37.5,54.55,3,2025-08-15 16:41:28,min_roster_turnover_detailed.csv,2025-08-17 08:45:20,32
MIN,2022,2023,OTHER,13,1,1,12,0,7.69,92.31,0.0,-12,2025-08-15 16:41:28,min_roster_turnover_detailed.csv,2025-08-17 08:45:20,32
MIN,2022,2023,QB,2,4,2,0,2,100.0,0.0,50.0,2,2025-08-15 16:41:28,min_roster_turnover_detailed.csv,2025-08-17 08:45:20,32
MIN,2022,2023,RB,5,6,4,1,2,80.0,20.0,33.33,1,2025-08-15 16:41:28,min_roster_turnover_detailed.csv,2025-08-17 08:45:20,32
MIN,2022,2023,ST,3,3,3,0,0,100.0,0.0,0.0,0,2025-08-15 16:41:28,min_roster_turnover_detailed.csv,2025-08-17 08:45:20,32
MIN,2022,2023,TE,6,4,3,3,1,50.0,50.0,25.0,-2,2025-08-15 16:41:28,min_roster_turnover_detailed.csv,2025-08-17 08:45:20,32
MIN,2022,2023,WR,6,8,3,3,5,50.0,50.0,62.5,2,2025-08-15 16:41:28,min_roster_turnover_detailed.csv,2025-08-17 08:45:20,32
MIN,2023,2024,DB,13,11,6,7,5,46.15,53.85,45.45,-2,2025-08-15 16:41:28,min_roster_turnover_detailed.csv,2025-08-17 08:45:20,32
MIN,2023,2024,DL,8,5,1,7,4,12.5,87.5,80.0,-3,2025-08-15 16:41:28,min_roster_turnover_detailed.csv,2025-08-17 08:45:20,32
MIN,2023,2024,LB,12,8,2,10,6,16.67,83.33,75.0,-4,2025-08-15 16:41:28,min_roster_turnover_detailed.csv,2025-08-17 08:45:20,32
MIN,2023,2024,OL,11,7,4,7,3,36.36,63.64,42.86,-4,2025-08-15 16:41:28,min_roster_turnover_detailed.csv,2025-08-17 08:45:20,32
MIN,2023,2024,OTHER,1,12,0,1,12,0.0,100.0,100.0,11,2025-08-15 16:41:28,min_roster_turnover_detailed.csv,2025-08-17 08:45:20,32
MIN,2023,2024,QB,4,2,1,3,1,25.0,75.0,50.0,-2,2025-08-15 16:41:28,min_roster_turnover_detailed.csv,2025-08-17 08:45:20,32
MIN,2023,2024,RB,6,5,4,2,1,66.67,33.33,20.0,-1,2025-08-15 16:41:28,min_roster_turnover_detailed.csv,2025-08-17 08:45:20,32
MIN,2023,2024,ST,3,5,2,1,3,66.67,33.33,60.0,2,2025-08-15 16:41:28,min_roster_turnover_detailed.csv,2025-08-17 08:45:20,32
MIN,2023,2024,TE,4,5,4,0,1,100.0,0.0,20.0,1,2025-08-15 16:41:28,min_roster_turnover_detailed.csv,2025-08-17 08:45:20,32
MIN,2023,2024,WR,8,6,5,3,1,62.5,37.5,16.67,-2,2025-08-15 16:41:28,min_roster_turnover_detailed.csv,2025-08-17 08:45:20,32
NOR,2011,2012,DB,6,9,4,2,5,66.67,33.33,55.56,3,2025-08-15 16:41:31,nor_roster_turnover_detailed.csv,2025-08-17 08:45:20,32
NOR,2011,2012,DL,7,4,3,4,1,42.86,57.14,25.0,-3,2025-08-15 16:41:31,nor_roster_turnover_detailed.csv,2025-08-17 08:45:20,32
NOR,2011,2012,LB,5,6,4,1,2,80.0,20.0,33.33,1,2025-08-15 16:41:31,nor_roster_turnover_detailed.csv,2025-08-17 08:45:20,32
NOR,2011,2012,OL,4,6,1,3,5,25.0,75.0,83.33,2,2025-08-15 16:41:31,nor_roster_turnover_detailed.csv,2025-08-17 08:45:20,32
NOR,2011,2012,OTHER,14,13,10,4,3,71.43,28.57,23.08,-1,2025-08-15 16:41:31,nor_roster_turnover_detailed.csv,2025-08-17 08:45:20,32
NOR,2011,2012,QB,2,2,2,0,0,100.0,0.0,0.0,0,2025-08-15 16:41:31,nor_roster_turnover_detailed.csv,2025-08-17 08:45:20,32
NOR,2011,2012,RB,6,6,5,1,1,83.33,16.67,16.67,0,2025-08-15 16:41:31,nor_roster_turnover_detailed.csv,2025-08-17 08:45:20,32
NOR,2011,2012,ST,3,3,2,1,1,66.67,33.33,33.33,0,2025-08-15 16:41:31,nor_roster_turnover_detailed.csv,2025-08-17 08:45:20,32
NOR,2011,2012,TE,4,4,3,1,1,75.0,25.0,25.0,0,2025-08-15 16:41:31,nor_roster_turnover_detailed.csv,2025-08-17 08:45:20,32
NOR,2011,2012,WR,6,7,4,2,3,66.67,33.33,42.86,1,2025-08-15 16:41:31,nor_roster_turnover_detailed.csv,2025-08-17 08:45:20,32
NOR,2012,2013,DB,9,10,4,5,6,44.44,55.56,60.0,1,2025-08-15 16:41:31,nor_roster_turnover_detailed.csv,2025-08-17 08:45:20,32
NOR,2012,2013,DL,4,7,1,3,6,25.0,75.0,85.71,3,2025-08-15 16:41:31,nor_roster_turnover_detailed.csv,2025-08-17 08:45:20,32
NOR,2012,2013,LB,6,6,3,3,3,50.0,50.0,50.0,0,2025-08-15 16:41:31,nor_roster_turnover_detailed.csv,2025-08-17 08:45:20,32
NOR,2012,2013,OL,6,4,2,4,2,33.33,66.67,50.0,-2,2025-08-15 16:41:31,nor_roster_turnover_detailed.csv,2025-08-17 08:45:20,32
NOR,2012,2013,OTHER,13,13,6,7,7,46.15,53.85,53.85,0,2025-08-15 16:41:31,nor_roster_turnover_detailed.csv,2025-08-17 08:45:20,32
NOR,2012,2013,QB,2,2,1,1,1,50.0,50.0,50.0,0,2025-08-15 16:41:31,nor_roster_turnover_detailed.csv,2025-08-17 08:45:20,32
NOR,2012,2013,RB,6,6,5,1,1,83.33,16.67,16.67,0,2025-08-15 16:41:31,nor_roster_turnover_detailed.csv,2025-08-17 08:45:20,32
NOR,2012,2013,ST,3,4,3,0,1,100.0,0.0,25.0,1,2025-08-15 16:41:31,nor_roster_turnover_detailed.csv,2025-08-17 08:45:20,32
NOR,2012,2013,TE,4,3,1,3,2,25.0,75.0,66.67,-1,2025-08-15 16:41:31,nor_roster_turnover_detailed.csv,2025-08-17 08:45:20,32
NOR,2012,2013,WR,7,5,2,5,3,28.57,71.43,60.0,-2,2025-08-15 16:41:31,nor_roster_turnover_detailed.csv,2025-08-17 08:45:20,32
NOR,2013,2014,DB,10,10,2,8,8,20.0,80.0,80.0,0,2025-08-15 16:41:31,nor_roster_turnover_detailed.csv,2025-08-17 08:45:20,32
NOR,2013,2014,DL,7,7,4,3,3,57.14,42.86,42.86,0,2025-08-15 16:41:31,nor_roster_turnover_detailed.csv,2025-08-17 08:45:20,32
NOR,2013,2014,LB,6,4,1,5,3,16.67,83.33,75.0,-2,2025-08-15 16:41:31,nor_roster_turnover_detailed.csv,2025-08-17 08:45:20,32
NOR,2013,2014,OL,4,5,2,2,3,50.0,50.0,60.0,1,2025-08-15 16:41:31,nor_roster_turnover_detailed.csv,2025-08-17 08:45:20,32
NOR,2013,2014,OTHER,13,13,11,2,2,84.62,15.38,15.38,0,2025-08-15 16:41:31,nor_roster_turnover_detailed.csv,2025-08-17 08:45:20,32
NOR,2013,2014,QB,2,2,2,0,0,100.0,0.0,0.0,0,2025-08-15 16:41:31,nor_roster_turnover_detailed.csv,2025-08-17 08:45:20,32
NOR,2013,2014,RB,6,10,4,2,6,66.67,33.33,60.0,4,2025-08-15 16:41:31,nor_roster_turnover_detailed.csv,2025-08-17 08:45:20,32
NOR,2013,2014,ST,4,3,3,1,0,75.0,25.0,0.0,-1,2025-08-15 16:41:31,nor_roster_turnover_detailed.csv,2025-08-17 08:45:20,32
NOR,2013,2014,TE,3,3,3,0,0,100.0,0.0,0.0,0,2025-08-15 16:41:31,nor_roster_turnover_detailed.csv,2025-08-17 08:45:20,32
NOR,2013,2014,WR,5,7,4,1,3,80.0,20.0,42.86,2,2025-08-15 16:41:31,nor_roster_turnover_detailed.csv,2025-08-17 08:45:20,32
NOR,2014,2015,DB,10,12,5,5,7,50.0,50.0,58.33,2,2025-08-15 16:41:31,nor_roster_turnover_detailed.csv,2025-08-17 08:45:20,32
NOR,2014,2015,DL,7,5,1,6,4,14.29,85.71,80.0,-2,2025-08-15 16:41:31,nor_roster_turnover_detailed.csv,2025-08-17 08:45:20,32
NOR,2014,2015,LB,4,7,0,4,7,0.0,100.0,100.0,3,2025-08-15 16:41:31,nor_roster_turnover_detailed.csv,2025-08-17 08:45:20,32
NOR,2014,2015,OL,5,3,0,5,3,0.0,100.0,100.0,-2,2025-08-15 16:41:31,nor_roster_turnover_detailed.csv,2025-08-17 08:45:20,32
NOR,2014,2015,OTHER,13,15,5,8,10,38.46,61.54,66.67,2,2025-08-15 16:41:31,nor_roster_turnover_detailed.csv,2025-08-17 08:45:20,32
NOR,2014,2015,QB,2,2,2,0,0,100.0,0.0,0.0,0,2025-08-15 16:41:31,nor_roster_turnover_detailed.csv,2025-08-17 08:45:20,32
NOR,2014,2015,RB,10,9,4,6,5,40.0,60.0,55.56,-1,2025-08-15 16:41:31,nor_roster_turnover_detailed.csv,2025-08-17 08:45:20,32
NOR,2014,2015,ST,3,5,2,1,3,66.67,33.33,60.0,2,2025-08-15 16:41:31,nor_roster_turnover_detailed.csv,2025-08-17 08:45:20,32
NOR,2014,2015,TE,3,3,2,1,1,66.67,33.33,33.33,0,2025-08-15 16:41:31,nor_roster_turnover_detailed.csv,2025-08-17 08:45:20,32
NOR,2014,2015,WR,7,7,3,4,4,42.86,57.14,57.14,0,2025-08-15 16:41:31,nor_roster_turnover_detailed.csv,2025-08-17 08:45:20,32
NOR,2015,2016,DB,12,12,3,9,9,25.0,75.0,75.0,0,2025-08-15 16:41:31,nor_roster_turnover_detailed.csv,2025-08-17 08:45:20,32
NOR,2015,2016,DL,5,7,2,3,5,40.0,60.0,71.43,2,2025-08-15 16:41:31,nor_roster_turnover_detailed.csv,2025-08-17 08:45:20,32
NOR,2015,2016,LB,7,6,2,5,4,28.57,71.43,66.67,-1,2025-08-15 16:41:31,nor_roster_turnover_detailed.csv,2025-08-17 08:45:20,32
NOR,2015,2016,OL,3,4,2,1,2,66.67,33.33,50.0,1,2025-08-15 16:41:31,nor_roster_turnover_detailed.csv,2025-08-17 08:45:20,32
NOR,2015,2016,OTHER,15,14,8,7,6,53.33,46.67,42.86,-1,2025-08-15 16:41:31,nor_roster_turnover_detailed.csv,2025-08-17 08:45:20,32
NOR,2015,2016,QB,2,1,1,1,0,50.0,50.0,0.0,-1,2025-08-15 16:41:31,nor_roster_turnover_detailed.csv,2025-08-17 08:45:20,32
NOR,2015,2016,RB,9,6,4,5,2,44.44,55.56,33.33,-3,2025-08-15 16:41:31,nor_roster_turnover_detailed.csv,2025-08-17 08:45:20,32
NOR,2015,2016,ST,5,3,2,3,1,40.0,60.0,33.33,-2,2025-08-15 16:41:31,nor_roster_turnover_detailed.csv,2025-08-17 08:45:20,32
NOR,2015,2016,TE,3,4,1,2,3,33.33,66.67,75.0,1,2025-08-15 16:41:31,nor_roster_turnover_detailed.csv,2025-08-17 08:45:20,32
NOR,2015,2016,WR,7,6,3,4,3,42.86,57.14,50.0,-1,2025-08-15 16:41:31,nor_roster_turnover_detailed.csv,2025-08-17 08:45:20,32
NOR,2016,2017,DB,12,9,4,8,5,33.33,66.67,55.56,-3,2025-08-15 16:41:31,nor_roster_turnover_detailed.csv,2025-08-17 08:45:20,32
NOR,2016,2017,DL,7,9,1,6,8,14.29,85.71,88.89,2,2025-08-15 16:41:31,nor_roster_turnover_detailed.csv,2025-08-17 08:45:20,32
NOR,2016,2017,LB,6,8,2,4,6,33.33,66.67,75.0,2,2025-08-15 16:41:31,nor_roster_turnover_detailed.csv,2025-08-17 08:45:20,32
NOR,2016,2017,OL,4,5,1,3,4,25.0,75.0,80.0,1,2025-08-15 16:41:31,nor_roster_turnover_detailed.csv,2025-08-17 08:45:20,32
NOR,2016,2017,OTHER,14,14,7,7,7,50.0,50.0,50.0,0,2025-08-15 16:41:31,nor_roster_turnover_detailed.csv,2025-08-17 08:45:20,32
NOR,2016,2017,QB,1,3,1,0,2,100.0,0.0,66.67,2,2025-08-15 16:41:31,nor_roster_turnover_detailed.csv,2025-08-17 08:45:20,32
NOR,2016,2017,RB,6,7,3,3,4,50.0,50.0,57.14,1,2025-08-15 16:41:31,nor_roster_turnover_detailed.csv,2025-08-17 08:45:20,32
NOR,2016,2017,ST,3,3,2,1,1,66.67,33.33,33.33,0,2025-08-15 16:41:31,nor_roster_turnover_detailed.csv,2025-08-17 08:45:20,32
NOR,2016,2017,TE,4,5,3,1,2,75.0,25.0,40.0,1,2025-08-15 16:41:31,nor_roster_turnover_detailed.csv,2025-08-17 08:45:20,32
NOR,2016,2017,WR,6,7,4,2,3,66.67,33.33,42.86,1,2025-08-15 16:41:31,nor_roster_turnover_detailed.csv,2025-08-17 08:45:20,32
NOR,2017,2018,DB,9,8,4,5,4,44.44,55.56,50.0,-1,2025-08-15 16:41:31,nor_roster_turnover_detailed.csv,2025-08-17 08:45:20,32
NOR,2017,2018,DL,9,5,2,7,3,22.22,77.78,60.0,-4,2025-08-15 16:41:31,nor_roster_turnover_detailed.csv,2025-08-17 08:45:20,32
NOR,2017,2018,LB,8,6,3,5,3,37.5,62.5,50.0,-2,2025-08-15 16:41:31,nor_roster_turnover_detailed.csv,2025-08-17 08:45:20,32
NOR,2017,2018,OL,5,7,2,3,5,40.0,60.0,71.43,2,2025-08-15 16:41:31,nor_roster_turnover_detailed.csv,2025-08-17 08:45:20,32
NOR,2017,2018,OTHER,14,14,11,3,3,78.57,21.43,21.43,0,2025-08-15 16:41:31,nor_roster_turnover_detailed.csv,2025-08-17 08:45:20,32
NOR,2017,2018,QB,3,3,2,1,1,66.67,33.33,33.33,0,2025-08-15 16:41:31,nor_roster_turnover_detailed.csv,2025-08-17 08:45:20,32
NOR,2017,2018,RB,7,6,3,4,3,42.86,57.14,50.0,-1,2025-08-15 16:41:31,nor_roster_turnover_detailed.csv,2025-08-17 08:45:20,32
NOR,2017,2018,ST,3,3,3,0,0,100.0,0.0,0.0,0,2025-08-15 16:41:31,nor_roster_turnover_detailed.csv,2025-08-17 08:45:20,32
NOR,2017,2018,TE,5,3,2,3,1,40.0,60.0,33.33,-2,2025-08-15 16:41:31,nor_roster_turnover_detailed.csv,2025-08-17 08:45:20,32
NOR,2017,2018,WR,7,10,5,2,5,71.43,28.57,50.0,3,2025-08-15 16:41:31,nor_roster_turnover_detailed.csv,2025-08-17 08:45:20,32
NOR,2018,2019,DB,8,13,4,4,9,50.0,50.0,69.23,5,2025-08-15 16:41:31,nor_roster_turnover_detailed.csv,2025-08-17 08:45:20,32
NOR,2018,2019,DL,5,6,2,3,4,40.0,60.0,66.67,1,2025-08-15 16:41:31,nor_roster_turnover_detailed.csv,2025-08-17 08:45:20,32
NOR,2018,2019,LB,6,7,4,2,3,66.67,33.33,42.86,1,2025-08-15 16:41:31,nor_roster_turnover_detailed.csv,2025-08-17 08:45:20,32
NOR,2018,2019,OL,7,4,2,5,2,28.57,71.43,50.0,-3,2025-08-15 16:41:31,nor_roster_turnover_detailed.csv,2025-08-17 08:45:20,32
NOR,2018,2019,OTHER,14,13,9,5,4,64.29,35.71,30.77,-1,2025-08-15 16:41:31,nor_roster_turnover_detailed.csv,2025-08-17 08:45:20,32
NOR,2018,2019,QB,3,2,2,1,0,66.67,33.33,0.0,-1,2025-08-15 16:41:31,nor_roster_turnover_detailed.csv,2025-08-17 08:45:20,32
NOR,2018,2019,RB,6,6,3,3,3,50.0,50.0,50.0,0,2025-08-15 16:41:31,nor_roster_turnover_detailed.csv,2025-08-17 08:45:20,32
NOR,2018,2019,ST,3,3,3,0,0,100.0,0.0,0.0,0,2025-08-15 16:41:31,nor_roster_turnover_detailed.csv,2025-08-17 08:45:20,32
NOR,2018,2019,TE,3,3,1,2,2,33.33,66.67,66.67,0,2025-08-15 16:41:31,nor_roster_turnover_detailed.csv,2025-08-17 08:45:20,32
NOR,2018,2019,WR,10,11,7,3,4,70.0,30.0,36.36,1,2025-08-15 16:41:31,nor_roster_turnover_detailed.csv,2025-08-17 08:45:20,32
NOR,2019,2020,DB,13,9,7,6,2,53.85,46.15,22.22,-4,2025-08-15 16:41:31,nor_roster_turnover_detailed.csv,2025-08-17 08:45:20,32
NOR,2019,2020,DL,6,8,3,3,5,50.0,50.0,62.5,2,2025-08-15 16:41:31,nor_roster_turnover_detailed.csv,2025-08-17 08:45:20,32
NOR,2019,2020,LB,7,7,3,4,4,42.86,57.14,57.14,0,2025-08-15 16:41:31,nor_roster_turnover_detailed.csv,2025-08-17 08:45:20,32
NOR,2019,2020,OL,4,6,2,2,4,50.0,50.0,66.67,2,2025-08-15 16:41:31,nor_roster_turnover_detailed.csv,2025-08-17 08:45:20,32
NOR,2019,2020,OTHER,13,12,8,5,4,61.54,38.46,33.33,-1,2025-08-15 16:41:31,nor_roster_turnover_detailed.csv,2025-08-17 08:45:20,32
NOR,2019,2020,QB,2,3,1,1,2,50.0,50.0,66.67,1,2025-08-15 16:41:31,nor_roster_turnover_detailed.csv,2025-08-17 08:45:20,32
NOR,2019,2020,RB,6,5,3,3,2,50.0,50.0,40.0,-1,2025-08-15 16:41:31,nor_roster_turnover_detailed.csv,2025-08-17 08:45:20,32
NOR,2019,2020,ST,3,3,3,0,0,100.0,0.0,0.0,0,2025-08-15 16:41:31,nor_roster_turnover_detailed.csv,2025-08-17 08:45:20,32
NOR,2019,2020,TE,3,4,2,1,2,66.67,33.33,50.0,1,2025-08-15 16:41:31,nor_roster_turnover_detailed.csv,2025-08-17 08:45:20,32
NOR,2019,2020,WR,11,12,6,5,6,54.55,45.45,50.0,1,2025-08-15 16:41:31,nor_roster_turnover_detailed.csv,2025-08-17 08:45:20,32
NOR,2020,2021,DB,9,12,5,4,7,55.56,44.44,58.33,3,2025-08-15 16:41:31,nor_roster_turnover_detailed.csv,2025-08-17 08:45:20,32
NOR,2020,2021,DL,8,10,2,6,8,25.0,75.0,80.0,2,2025-08-15 16:41:31,nor_roster_turnover_detailed.csv,2025-08-17 08:45:20,32
NOR,2020,2021,LB,7,8,5,2,3,71.43,28.57,37.5,1,2025-08-15 16:41:31,nor_roster_turnover_detailed.csv,2025-08-17 08:45:20,32
NOR,2020,2021,OL,6,8,2,4,6,33.33,66.67,75.0,2,2025-08-15 16:41:31,nor_roster_turnover_detailed.csv,2025-08-17 08:45:20,32
NOR,2020,2021,OTHER,12,15,8,4,7,66.67,33.33,46.67,3,2025-08-15 16:41:31,nor_roster_turnover_detailed.csv,2025-08-17 08:45:20,32
NOR,2020,2021,QB,3,4,2,1,2,66.67,33.33,50.0,1,2025-08-15 16:41:31,nor_roster_turnover_detailed.csv,2025-08-17 08:45:20,32
NOR,2020,2021,RB,5,7,3,2,4,60.0,40.0,57.14,2,2025-08-15 16:41:31,nor_roster_turnover_detailed.csv,2025-08-17 08:45:20,32
NOR,2020,2021,ST,3,6,1,2,5,33.33,66.67,83.33,3,2025-08-15 16:41:31,nor_roster_turnover_detailed.csv,2025-08-17 08:45:20,32
NOR,2020,2021,TE,4,4,2,2,2,50.0,50.0,50.0,0,2025-08-15 16:41:31,nor_roster_turnover_detailed.csv,2025-08-17 08:45:20,32
NOR,2020,2021,WR,12,11,6,6,5,50.0,50.0,45.45,-1,2025-08-15 16:41:31,nor_roster_turnover_detailed.csv,2025-08-17 08:45:20,32
NOR,2021,2022,DB,12,10,3,9,7,25.0,75.0,70.0,-2,2025-08-15 16:41:31,nor_roster_turnover_detailed.csv,2025-08-17 08:45:20,32
NOR,2021,2022,DL,10,7,4,6,3,40.0,60.0,42.86,-3,2025-08-15 16:41:31,nor_roster_turnover_detailed.csv,2025-08-17 08:45:20,32
NOR,2021,2022,LB,8,6,4,4,2,50.0,50.0,33.33,-2,2025-08-15 16:41:31,nor_roster_turnover_detailed.csv,2025-08-17 08:45:20,32
NOR,2021,2022,OL,8,8,2,6,6,25.0,75.0,75.0,0,2025-08-15 16:41:31,nor_roster_turnover_detailed.csv,2025-08-17 08:45:20,32
NOR,2021,2022,OTHER,15,14,10,5,4,66.67,33.33,28.57,-1,2025-08-15 16:41:31,nor_roster_turnover_detailed.csv,2025-08-17 08:45:20,32
NOR,2021,2022,QB,4,2,1,3,1,25.0,75.0,50.0,-2,2025-08-15 16:41:31,nor_roster_turnover_detailed.csv,2025-08-17 08:45:20,32
NOR,2021,2022,RB,7,9,5,2,4,71.43,28.57,44.44,2,2025-08-15 16:41:31,nor_roster_turnover_detailed.csv,2025-08-17 08:45:20,32
NOR,2021,2022,ST,6,3,2,4,1,33.33,66.67,33.33,-3,2025-08-15 16:41:31,nor_roster_turnover_detailed.csv,2025-08-17 08:45:20,32
NOR,2021,2022,TE,4,6,2,2,4,50.0,50.0,66.67,2,2025-08-15 16:41:31,nor_roster_turnover_detailed.csv,2025-08-17 08:45:20,32
NOR,2021,2022,WR,11,10,4,7,6,36.36,63.64,60.0,-1,2025-08-15 16:41:31,nor_roster_turnover_detailed.csv,2025-08-17 08:45:20,32
NOR,2022,2023,DB,10,14,5,5,9,50.0,50.0,64.29,4,2025-08-15 16:41:31,nor_roster_turnover_detailed.csv,2025-08-17 08:45:20,32
NOR,2022,2023,DL,7,13,4,3,9,57.14,42.86,69.23,6,2025-08-15 16:41:31,nor_roster_turnover_detailed.csv,2025-08-17 08:45:20,32
NOR,2022,2023,LB,6,7,3,3,4,50.0,50.0,57.14,1,2025-08-15 16:41:31,nor_roster_turnover_detailed.csv,2025-08-17 08:45:20,32
NOR,2022,2023,OL,8,11,3,5,8,37.5,62.5,72.73,3,2025-08-15 16:41:31,nor_roster_turnover_detailed.csv,2025-08-17 08:45:20,32
NOR,2022,2023,OTHER,14,1,0,14,1,0.0,100.0,100.0,-13,2025-08-15 16:41:31,nor_roster_turnover_detailed.csv,2025-08-17 08:45:20,32
NOR,2022,2023,QB,2,2,1,1,1,50.0,50.0,50.0,0,2025-08-15 16:41:31,nor_roster_turnover_detailed.csv,2025-08-17 08:45:20,32
NOR,2022,2023,RB,9,6,3,6,3,33.33,66.67,50.0,-3,2025-08-15 16:41:31,nor_roster_turnover_detailed.csv,2025-08-17 08:45:20,32
NOR,2022,2023,ST,3,3,1,2,2,33.33,66.67,66.67,0,2025-08-15 16:41:31,nor_roster_turnover_detailed.csv,2025-08-17 08:45:20,32
NOR,2022,2023,TE,6,5,3,3,2,50.0,50.0,40.0,-1,2025-08-15 16:41:31,nor_roster_turnover_detailed.csv,2025-08-17 08:45:20,32
NOR,2022,2023,WR,10,8,6,4,2,60.0,40.0,25.0,-2,2025-08-15 16:41:31,nor_roster_turnover_detailed.csv,2025-08-17 08:45:20,32
NOR,2023,2024,DB,14,13,8,6,5,57.14,42.86,38.46,-1,2025-08-15 16:41:31,nor_roster_turnover_detailed.csv,2025-08-17 08:45:20,32
NOR,2023,2024,DL,13,8,4,9,4,30.77,69.23,50.0,-5,2025-08-15 16:41:31,nor_roster_turnover_detailed.csv,2025-08-17 08:45:20,32
NOR,2023,2024,LB,7,7,3,4,4,42.86,57.14,57.14,0,2025-08-15 16:41:31,nor_roster_turnover_detailed.csv,2025-08-17 08:45:20,32
NOR,2023,2024,OL,11,8,3,8,5,27.27,72.73,62.5,-3,2025-08-15 16:41:31,nor_roster_turnover_detailed.csv,2025-08-17 08:45:20,32
NOR,2023,2024,OTHER,1,12,0,1,12,0.0,100.0,100.0,11,2025-08-15 16:41:31,nor_roster_turnover_detailed.csv,2025-08-17 08:45:20,32
NOR,2023,2024,QB,2,3,1,1,2,50.0,50.0,66.67,1,2025-08-15 16:41:31,nor_roster_turnover_detailed.csv,2025-08-17 08:45:20,32
NOR,2023,2024,RB,6,6,5,1,1,83.33,16.67,16.67,0,2025-08-15 16:41:31,nor_roster_turnover_detailed.csv,2025-08-17 08:45:20,32
NOR,2023,2024,ST,3,3,2,1,1,66.67,33.33,33.33,0,2025-08-15 16:41:31,nor_roster_turnover_detailed.csv,2025-08-17 08:45:20,32
NOR,2023,2024,TE,5,4,3,2,1,60.0,40.0,25.0,-1,2025-08-15 16:41:31,nor_roster_turnover_detailed.csv,2025-08-17 08:45:20,32
NOR,2023,2024,WR,8,10,2,6,8,25.0,75.0,80.0,2,2025-08-15 16:41:31,nor_roster_turnover_detailed.csv,2025-08-17 08:45:20,32
NWE,2011,2012,DB,12,9,4,8,5,33.33,66.67,55.56,-3,2025-08-15 16:41:27,nwe_roster_turnover_detailed.csv,2025-08-17 08:45:20,32
NWE,2011,2012,DL,10,6,1,9,5,10.0,90.0,83.33,-4,2025-08-15 16:41:27,nwe_roster_turnover_detailed.csv,2025-08-17 08:45:20,32
NWE,2011,2012,LB,7,7,4,3,3,57.14,42.86,42.86,0,2025-08-15 16:41:27,nwe_roster_turnover_detailed.csv,2025-08-17 08:45:20,32
NWE,2011,2012,OL,7,4,3,4,1,42.86,57.14,25.0,-3,2025-08-15 16:41:27,nwe_roster_turnover_detailed.csv,2025-08-17 08:45:20,32
NWE,2011,2012,OTHER,14,16,8,6,8,57.14,42.86,50.0,2,2025-08-15 16:41:27,nwe_roster_turnover_detailed.csv,2025-08-17 08:45:20,32
NWE,2011,2012,QB,2,2,1,1,1,50.0,50.0,50.0,0,2025-08-15 16:41:27,nwe_roster_turnover_detailed.csv,2025-08-17 08:45:20,32
NWE,2011,2012,RB,6,6,3,3,3,50.0,50.0,50.0,0,2025-08-15 16:41:27,nwe_roster_turnover_detailed.csv,2025-08-17 08:45:20,32
NWE,2011,2012,ST,3,3,3,0,0,100.0,0.0,0.0,0,2025-08-15 16:41:27,nwe_roster_turnover_detailed.csv,2025-08-17 08:45:20,32
NWE,2011,2012,TE,3,6,2,1,4,66.67,33.33,66.67,3,2025-08-15 16:41:27,nwe_roster_turnover_detailed.csv,2025-08-17 08:45:20,32
NWE,2011,2012,WR,7,8,4,3,4,57.14,42.86,50.0,1,2025-08-15 16:41:27,nwe_roster_turnover_detailed.csv,2025-08-17 08:45:20,32
NWE,2012,2013,DB,9,9,4,5,5,44.44,55.56,55.56,0,2025-08-15 16:41:27,nwe_roster_turnover_detailed.csv,2025-08-17 08:45:20,32
NWE,2012,2013,DL,6,9,2,4,7,33.33,66.67,77.78,3,2025-08-15 16:41:27,nwe_roster_turnover_detailed.csv,2025-08-17 08:45:20,32
NWE,2012,2013,LB,7,4,1,6,3,14.29,85.71,75.0,-3,2025-08-15 16:41:27,nwe_roster_turnover_detailed.csv,2025-08-17 08:45:20,32
NWE,2012,2013,OL,4,4,1,3,3,25.0,75.0,75.0,0,2025-08-15 16:41:27,nwe_roster_turnover_detailed.csv,2025-08-17 08:45:20,32
NWE,2012,2013,OTHER,16,16,10,6,6,62.5,37.5,37.5,0,2025-08-15 16:41:27,nwe_roster_turnover_detailed.csv,2025-08-17 08:45:20,32
NWE,2012,2013,QB,2,1,1,1,0,50.0,50.0,0.0,-1,2025-08-15 16:41:27,nwe_roster_turnover_detailed.csv,2025-08-17 08:45:20,32
NWE,2012,2013,RB,6,6,3,3,3,50.0,50.0,50.0,0,2025-08-15 16:41:27,nwe_roster_turnover_detailed.csv,2025-08-17 08:45:20,32
NWE,2012,2013,ST,3,3,2,1,1,66.67,33.33,33.33,0,2025-08-15 16:41:27,nwe_roster_turnover_detailed.csv,2025-08-17 08:45:20,32
NWE,2012,2013,TE,6,6,2,4,4,33.33,66.67,66.67,0,2025-08-15 16:41:27,nwe_roster_turnover_detailed.csv,2025-08-17 08:45:20,32
NWE,2012,2013,WR,8,7,2,6,5,25.0,75.0,71.43,-1,2025-08-15 16:41:27,nwe_roster_turnover_detailed.csv,2025-08-17 08:45:20,32
NWE,2013,2014,DB,9,9,5,4,4,55.56,44.44,44.44,0,2025-08-15 16:41:27,nwe_roster_turnover_detailed.csv,2025-08-17 08:45:20,32
NWE,2013,2014,DL,9,6,1,8,5,11.11,88.89,83.33,-3,2025-08-15 16:41:27,nwe_roster_turnover_detailed.csv,2025-08-17 08:45:20,32
NWE,2013,2014,LB,4,7,2,2,5,50.0,50.0,71.43,3,2025-08-15 16:41:27,nwe_roster_turnover_detailed.csv,2025-08-17 08:45:20,32
NWE,2013,2014,OL,4,7,2,2,5,50.0,50.0,71.43,3,2025-08-15 16:41:27,nwe_roster_turnover_detailed.csv,2025-08-17 08:45:20,32
NWE,2013,2014,OTHER,16,14,9,7,5,56.25,43.75,35.71,-2,2025-08-15 16:41:27,nwe_roster_turnover_detailed.csv,2025-08-17 08:45:20,32
NWE,2013,2014,QB,1,2,1,0,1,100.0,0.0,50.0,1,2025-08-15 16:41:27,nwe_roster_turnover_detailed.csv,2025-08-17 08:45:20,32
NWE,2013,2014,RB,6,7,4,2,3,66.67,33.33,42.86,1,2025-08-15 16:41:27,nwe_roster_turnover_detailed.csv,2025-08-17 08:45:20,32
NWE,2013,2014,ST,3,3,3,0,0,100.0,0.0,0.0,0,2025-08-15 16:41:27,nwe_roster_turnover_detailed.csv,2025-08-17 08:45:20,32
NWE,2013,2014,TE,6,3,2,4,1,33.33,66.67,33.33,-3,2025-08-15 16:41:27,nwe_roster_turnover_detailed.csv,2025-08-17 08:45:20,32
NWE,2013,2014,WR,7,8,6,1,2,85.71,14.29,25.0,1,2025-08-15 16:41:27,nwe_roster_turnover_detailed.csv,2025-08-17 08:45:20,32
NWE,2014,2015,DB,9,13,5,4,8,55.56,44.44,61.54,4,2025-08-15 16:41:27,nwe_roster_turnover_detailed.csv,2025-08-17 08:45:20,32
NWE,2014,2015,DL,6,7,1,5,6,16.67,83.33,85.71,1,2025-08-15 16:41:27,nwe_roster_turnover_detailed.csv,2025-08-17 08:45:20,32
NWE,2014,2015,LB,7,6,2,5,4,28.57,71.43,66.67,-1,2025-08-15 16:41:27,nwe_roster_turnover_detailed.csv,2025-08-17 08:45:20,32
NWE,2014,2015,OL,7,6,2,5,4,28.57,71.43,66.67,-1,2025-08-15 16:41:27,nwe_roster_turnover_detailed.csv,2025-08-17 08:45:20,32
NWE,2014,2015,OTHER,14,15,6,8,9,42.86,57.14,60.0,1,2025-08-15 16:41:27,nwe_roster_turnover_detailed.csv,2025-08-17 08:45:20,32
NWE,2014,2015,QB,2,2,2,0,0,100.0,0.0,0.0,0,2025-08-15 16:41:27,nwe_roster_turnover_detailed.csv,2025-08-17 08:45:20,32
NWE,2014,2015,RB,7,7,3,4,4,42.86,57.14,57.14,0,2025-08-15 16:41:27,nwe_roster_turnover_detailed.csv,2025-08-17 08:45:20,32
NWE,2014,2015,ST,3,3,2,1,1,66.67,33.33,33.33,0,2025-08-15 16:41:27,nwe_roster_turnover_detailed.csv,2025-08-17 08:45:20,32
NWE,2014,2015,TE,3,5,2,1,3,66.67,33.33,60.0,2,2025-08-15 16:41:27,nwe_roster_turnover_detailed.csv,2025-08-17 08:45:20,32
NWE,2014,2015,WR,8,9,5,3,4,62.5,37.5,44.44,1,2025-08-15 16:41:27,nwe_roster_turnover_detailed.csv,2025-08-17 08:45:20,32
NWE,2015,2016,DB,13,9,7,6,2,53.85,46.15,22.22,-4,2025-08-15 16:41:27,nwe_roster_turnover_detailed.csv,2025-08-17 08:45:20,32
NWE,2015,2016,DL,7,5,0,7,5,0.0,100.0,100.0,-2,2025-08-15 16:41:27,nwe_roster_turnover_detailed.csv,2025-08-17 08:45:20,32
NWE,2015,2016,LB,6,4,1,5,3,16.67,83.33,75.0,-2,2025-08-15 16:41:27,nwe_roster_turnover_detailed.csv,2025-08-17 08:45:20,32
NWE,2015,2016,OL,6,4,2,4,2,33.33,66.67,50.0,-2,2025-08-15 16:41:27,nwe_roster_turnover_detailed.csv,2025-08-17 08:45:20,32
NWE,2015,2016,OTHER,15,15,8,7,7,53.33,46.67,46.67,0,2025-08-15 16:41:27,nwe_roster_turnover_detailed.csv,2025-08-17 08:45:20,32
NWE,2015,2016,QB,2,3,2,0,1,100.0,0.0,33.33,1,2025-08-15 16:41:27,nwe_roster_turnover_detailed.csv,2025-08-17 08:45:20,32
NWE,2015,2016,RB,7,5,4,3,1,57.14,42.86,20.0,-2,2025-08-15 16:41:27,nwe_roster_turnover_detailed.csv,2025-08-17 08:45:20,32
NWE,2015,2016,ST,3,3,3,0,0,100.0,0.0,0.0,0,2025-08-15 16:41:27,nwe_roster_turnover_detailed.csv,2025-08-17 08:45:20,32
NWE,2015,2016,TE,5,5,1,4,4,20.0,80.0,80.0,0,2025-08-15 16:41:27,nwe_roster_turnover_detailed.csv,2025-08-17 08:45:20,32
NWE,2015,2016,WR,9,7,3,6,4,33.33,66.67,57.14,-2,2025-08-15 16:41:27,nwe_roster_turnover_detailed.csv,2025-08-17 08:45:20,32
NWE,2016,2017,DB,9,9,7,2,2,77.78,22.22,22.22,0,2025-08-15 16:41:27,nwe_roster_turnover_detailed.csv,2025-08-17 08:45:20,32
NWE,2016,2017,DL,5,6,1,4,5,20.0,80.0,83.33,1,2025-08-15 16:41:27,nwe_roster_turnover_detailed.csv,2025-08-17 08:45:20,32
NWE,2016,2017,LB,4,8,2,2,6,50.0,50.0,75.0,4,2025-08-15 16:41:27,nwe_roster_turnover_detailed.csv,2025-08-17 08:45:20,32
NWE,2016,2017,OL,4,4,3,1,1,75.0,25.0,25.0,0,2025-08-15 16:41:27,nwe_roster_turnover_detailed.csv,2025-08-17 08:45:20,32
NWE,2016,2017,OTHER,15,13,7,8,6,46.67,53.33,46.15,-2,2025-08-15 16:41:27,nwe_roster_turnover_detailed.csv,2025-08-17 08:45:20,32
NWE,2016,2017,QB,3,2,1,2,1,33.33,66.67,50.0,-1,2025-08-15 16:41:27,nwe_roster_turnover_detailed.csv,2025-08-17 08:45:20,32
NWE,2016,2017,RB,5,6,4,1,2,80.0,20.0,33.33,1,2025-08-15 16:41:27,nwe_roster_turnover_detailed.csv,2025-08-17 08:45:20,32
NWE,2016,2017,ST,3,3,3,0,0,100.0,0.0,0.0,0,2025-08-15 16:41:27,nwe_roster_turnover_detailed.csv,2025-08-17 08:45:20,32
NWE,2016,2017,TE,5,4,2,3,2,40.0,60.0,50.0,-1,2025-08-15 16:41:27,nwe_roster_turnover_detailed.csv,2025-08-17 08:45:20,32
NWE,2016,2017,WR,7,7,3,4,4,42.86,57.14,57.14,0,2025-08-15 16:41:27,nwe_roster_turnover_detailed.csv,2025-08-17 08:45:20,32
NWE,2017,2018,DB,9,11,7,2,4,77.78,22.22,36.36,2,2025-08-15 16:41:27,nwe_roster_turnover_detailed.csv,2025-08-17 08:45:20,32
NWE,2017,2018,DL,6,7,0,6,7,0.0,100.0,100.0,1,2025-08-15 16:41:27,nwe_roster_turnover_detailed.csv,2025-08-17 08:45:20,32
NWE,2017,2018,LB,8,6,2,6,4,25.0,75.0,66.67,-2,2025-08-15 16:41:27,nwe_roster_turnover_detailed.csv,2025-08-17 08:45:20,32
NWE,2017,2018,OL,4,6,4,0,2,100.0,0.0,33.33,2,2025-08-15 16:41:27,nwe_roster_turnover_detailed.csv,2025-08-17 08:45:20,32
NWE,2017,2018,OTHER,13,12,6,7,6,46.15,53.85,50.0,-1,2025-08-15 16:41:27,nwe_roster_turnover_detailed.csv,2025-08-17 08:45:20,32
NWE,2017,2018,QB,2,2,2,0,0,100.0,0.0,0.0,0,2025-08-15 16:41:27,nwe_roster_turnover_detailed.csv,2025-08-17 08:45:20,32
NWE,2017,2018,RB,6,6,3,3,3,50.0,50.0,50.0,0,2025-08-15 16:41:27,nwe_roster_turnover_detailed.csv,2025-08-17 08:45:20,32
NWE,2017,2018,ST,3,3,3,0,0,100.0,0.0,0.0,0,2025-08-15 16:41:27,nwe_roster_turnover_detailed.csv,2025-08-17 08:45:20,32
NWE,2017,2018,TE,4,3,3,1,0,75.0,25.0,0.0,-1,2025-08-15 16:41:27,nwe_roster_turnover_detailed.csv,2025-08-17 08:45:20,32
NWE,2017,2018,WR,7,7,3,4,4,42.86,57.14,57.14,0,2025-08-15 16:41:27,nwe_roster_turnover_detailed.csv,2025-08-17 08:45:20,32
NWE,2018,2019,DB,11,10,6,5,4,54.55,45.45,40.0,-1,2025-08-15 16:41:27,nwe_roster_turnover_detailed.csv,2025-08-17 08:45:20,32
NWE,2018,2019,DL,7,6,1,6,5,14.29,85.71,83.33,-1,2025-08-15 16:41:27,nwe_roster_turnover_detailed.csv,2025-08-17 08:45:20,32
NWE,2018,2019,LB,6,4,1,5,3,16.67,83.33,75.0,-2,2025-08-15 16:41:27,nwe_roster_turnover_detailed.csv,2025-08-17 08:45:20,32
NWE,2018,2019,OL,6,3,2,4,1,33.33,66.67,33.33,-3,2025-08-15 16:41:27,nwe_roster_turnover_detailed.csv,2025-08-17 08:45:20,32
NWE,2018,2019,OTHER,12,12,6,6,6,50.0,50.0,50.0,0,2025-08-15 16:41:27,nwe_roster_turnover_detailed.csv,2025-08-17 08:45:20,32
NWE,2018,2019,QB,2,2,1,1,1,50.0,50.0,50.0,0,2025-08-15 16:41:27,nwe_roster_turnover_detailed.csv,2025-08-17 08:45:20,32
NWE,2018,2019,RB,6,7,4,2,3,66.67,33.33,42.86,1,2025-08-15 16:41:27,nwe_roster_turnover_detailed.csv,2025-08-17 08:45:20,32
NWE,2018,2019,ST,3,6,2,1,4,66.67,33.33,66.67,3,2025-08-15 16:41:27,nwe_roster_turnover_detailed.csv,2025-08-17 08:45:20,32
NWE,2018,2019,TE,3,4,0,3,4,0.0,100.0,100.0,1,2025-08-15 16:41:27,nwe_roster_turnover_detailed.csv,2025-08-17 08:45:20,32
NWE,2018,2019,WR,7,9,4,3,5,57.14,42.86,55.56,2,2025-08-15 16:41:27,nwe_roster_turnover_detailed.csv,2025-08-17 08:45:20,32
NWE,2019,2020,DB,10,10,5,5,5,50.0,50.0,50.0,0,2025-08-15 16:41:27,nwe_roster_turnover_detailed.csv,2025-08-17 08:45:20,32
NWE,2019,2020,DL,6,10,3,3,7,50.0,50.0,70.0,4,2025-08-15 16:41:27,nwe_roster_turnover_detailed.csv,2025-08-17 08:45:20,32
NWE,2019,2020,LB,4,5,0,4,5,0.0,100.0,100.0,1,2025-08-15 16:41:27,nwe_roster_turnover_detailed.csv,2025-08-17 08:45:20,32
NWE,2019,2020,OL,3,4,1,2,3,33.33,66.67,75.0,1,2025-08-15 16:41:27,nwe_roster_turnover_detailed.csv,2025-08-17 08:45:20,32
NWE,2019,2020,OTHER,12,15,7,5,8,58.33,41.67,53.33,3,2025-08-15 16:41:27,nwe_roster_turnover_detailed.csv,2025-08-17 08:45:20,32
NWE,2019,2020,QB,2,3,1,1,2,50.0,50.0,66.67,1,2025-08-15 16:41:27,nwe_roster_turnover_detailed.csv,2025-08-17 08:45:20,32
NWE,2019,2020,RB,7,6,5,2,1,71.43,28.57,16.67,-1,2025-08-15 16:41:27,nwe_roster_turnover_detailed.csv,2025-08-17 08:45:20,32
NWE,2019,2020,ST,6,3,3,3,0,50.0,50.0,0.0,-3,2025-08-15 16:41:27,nwe_roster_turnover_detailed.csv,2025-08-17 08:45:20,32
NWE,2019,2020,TE,4,5,1,3,4,25.0,75.0,80.0,1,2025-08-15 16:41:27,nwe_roster_turnover_detailed.csv,2025-08-17 08:45:20,32
NWE,2019,2020,WR,9,9,5,4,4,55.56,44.44,44.44,0,2025-08-15 16:41:27,nwe_roster_turnover_detailed.csv,2025-08-17 08:45:20,32
NWE,2020,2021,DB,10,13,8,2,5,80.0,20.0,38.46,3,2025-08-15 16:41:27,nwe_roster_turnover_detailed.csv,2025-08-17 08:45:20,32
NWE,2020,2021,DL,10,7,2,8,5,20.0,80.0,71.43,-3,2025-08-15 16:41:27,nwe_roster_turnover_detailed.csv,2025-08-17 08:45:20,32
NWE,2020,2021,LB,5,5,1,4,4,20.0,80.0,80.0,0,2025-08-15 16:41:27,nwe_roster_turnover_detailed.csv,2025-08-17 08:45:20,32
NWE,2020,2021,OL,4,6,2,2,4,50.0,50.0,66.67,2,2025-08-15 16:41:27,nwe_roster_turnover_detailed.csv,2025-08-17 08:45:20,32
NWE,2020,2021,OTHER,15,13,7,8,6,46.67,53.33,46.15,-2,2025-08-15 16:41:27,nwe_roster_turnover_detailed.csv,2025-08-17 08:45:20,32
NWE,2020,2021,QB,3,2,1,2,1,33.33,66.67,50.0,-1,2025-08-15 16:41:27,nwe_roster_turnover_detailed.csv,2025-08-17 08:45:20,32
NWE,2020,2021,RB,6,6,4,2,2,66.67,33.33,33.33,0,2025-08-15 16:41:27,nwe_roster_turnover_detailed.csv,2025-08-17 08:45:20,32
NWE,2020,2021,ST,3,3,3,0,0,100.0,0.0,0.0,0,2025-08-15 16:41:27,nwe_roster_turnover_detailed.csv,2025-08-17 08:45:20,32
NWE,2020,2021,TE,5,4,1,4,3,20.0,80.0,75.0,-1,2025-08-15 16:41:27,nwe_roster_turnover_detailed.csv,2025-08-17 08:45:20,32
NWE,2020,2021,WR,9,7,5,4,2,55.56,44.44,28.57,-2,2025-08-15 16:41:27,nwe_roster_turnover_detailed.csv,2025-08-17 08:45:20,32
NWE,2021,2022,DB,13,12,5,8,7,38.46,61.54,58.33,-1,2025-08-15 16:41:27,nwe_roster_turnover_detailed.csv,2025-08-17 08:45:20,32
NWE,2021,2022,DL,7,6,4,3,2,57.14,42.86,33.33,-1,2025-08-15 16:41:27,nwe_roster_turnover_detailed.csv,2025-08-17 08:45:20,32
NWE,2021,2022,LB,5,7,3,2,4,60.0,40.0,57.14,2,2025-08-15 16:41:27,nwe_roster_turnover_detailed.csv,2025-08-17 08:45:20,32
NWE,2021,2022,OL,6,5,3,3,2,50.0,50.0,40.0,-1,2025-08-15 16:41:27,nwe_roster_turnover_detailed.csv,2025-08-17 08:45:20,32
NWE,2021,2022,OTHER,13,13,8,5,5,61.54,38.46,38.46,0,2025-08-15 16:41:27,nwe_roster_turnover_detailed.csv,2025-08-17 08:45:20,32
NWE,2021,2022,QB,2,3,2,0,1,100.0,0.0,33.33,1,2025-08-15 16:41:27,nwe_roster_turnover_detailed.csv,2025-08-17 08:45:20,32
NWE,2021,2022,RB,6,5,3,3,2,50.0,50.0,40.0,-1,2025-08-15 16:41:27,nwe_roster_turnover_detailed.csv,2025-08-17 08:45:20,32
NWE,2021,2022,ST,3,6,3,0,3,100.0,0.0,50.0,3,2025-08-15 16:41:27,nwe_roster_turnover_detailed.csv,2025-08-17 08:45:20,32
NWE,2021,2022,TE,4,3,2,2,1,50.0,50.0,33.33,-1,2025-08-15 16:41:27,nwe_roster_turnover_detailed.csv,2025-08-17 08:45:20,32
NWE,2021,2022,WR,7,11,4,3,7,57.14,42.86,63.64,4,2025-08-15 16:41:27,nwe_roster_turnover_detailed.csv,2025-08-17 08:45:20,32
NWE,2022,2023,DB,12,15,9,3,6,75.0,25.0,40.0,3,2025-08-15 16:41:27,nwe_roster_turnover_detailed.csv,2025-08-17 08:45:20,32
NWE,2022,2023,DL,6,9,4,2,5,66.67,33.33,55.56,3,2025-08-15 16:41:27,nwe_roster_turnover_detailed.csv,2025-08-17 08:45:20,32
NWE,2022,2023,LB,7,10,4,3,6,57.14,42.86,60.0,3,2025-08-15 16:41:27,nwe_roster_turnover_detailed.csv,2025-08-17 08:45:20,32
NWE,2022,2023,OL,5,12,2,3,10,40.0,60.0,83.33,7,2025-08-15 16:41:27,nwe_roster_turnover_detailed.csv,2025-08-17 08:45:20,32
NWE,2022,2023,OTHER,13,3,1,12,2,7.69,92.31,66.67,-10,2025-08-15 16:41:27,nwe_roster_turnover_detailed.csv,2025-08-17 08:45:20,32
NWE,2022,2023,QB,3,3,2,1,1,66.67,33.33,33.33,0,2025-08-15 16:41:27,nwe_roster_turnover_detailed.csv,2025-08-17 08:45:20,32
NWE,2022,2023,RB,5,5,2,3,3,40.0,60.0,60.0,0,2025-08-15 16:41:27,nwe_roster_turnover_detailed.csv,2025-08-17 08:45:20,32
NWE,2022,2023,ST,6,3,1,5,2,16.67,83.33,66.67,-3,2025-08-15 16:41:27,nwe_roster_turnover_detailed.csv,2025-08-17 08:45:20,32
NWE,2022,2023,TE,3,4,2,1,2,66.67,33.33,50.0,1,2025-08-15 16:41:27,nwe_roster_turnover_detailed.csv,2025-08-17 08:45:20,32
NWE,2022,2023,WR,11,8,4,7,4,36.36,63.64,50.0,-3,2025-08-15 16:41:27,nwe_roster_turnover_detailed.csv,2025-08-17 08:45:20,32
NWE,2023,2024,DB,15,12,6,9,6,40.0,60.0,50.0,-3,2025-08-15 16:41:27,nwe_roster_turnover_detailed.csv,2025-08-17 08:45:20,32
NWE,2023,2024,DL,9,8,5,4,3,55.56,44.44,37.5,-1,2025-08-15 16:41:27,nwe_roster_turnover_detailed.csv,2025-08-17 08:45:20,32
NWE,2023,2024,LB,10,12,2,8,10,20.0,80.0,83.33,2,2025-08-15 16:41:27,nwe_roster_turnover_detailed.csv,2025-08-17 08:45:20,32
NWE,2023,2024,OL,12,12,2,10,10,16.67,83.33,83.33,0,2025-08-15 16:41:27,nwe_roster_turnover_detailed.csv,2025-08-17 08:45:20,32
NWE,2023,2024,OTHER,3,11,0,3,11,0.0,100.0,100.0,8,2025-08-15 16:41:27,nwe_roster_turnover_detailed.csv,2025-08-17 08:45:20,32
NWE,2023,2024,QB,3,3,0,3,3,0.0,100.0,100.0,0,2025-08-15 16:41:27,nwe_roster_turnover_detailed.csv,2025-08-17 08:45:20,32
NWE,2023,2024,RB,5,4,2,3,2,40.0,60.0,50.0,-1,2025-08-15 16:41:27,nwe_roster_turnover_detailed.csv,2025-08-17 08:45:20,32
NWE,2023,2024,ST,3,4,2,1,2,66.67,33.33,50.0,1,2025-08-15 16:41:27,nwe_roster_turnover_detailed.csv,2025-08-17 08:45:20,32
NWE,2023,2024,TE,4,5,1,3,4,25.0,75.0,80.0,1,2025-08-15 16:41:27,nwe_roster_turnover_detailed.csv,2025-08-17 08:45:20,32
NWE,2023,2024,WR,8,8,4,4,4,50.0,50.0,50.0,0,2025-08-15 16:41:27,nwe_roster_turnover_detailed.csv,2025-08-17 08:45:20,32
NYG,2011,2012,DB,10,8,5,5,3,50.0,50.0,37.5,-2,2025-08-15 16:41:28,nyg_roster_turnover_detailed.csv,2025-08-17 08:45:20,32
NYG,2011,2012,DL,5,4,0,5,4,0.0,100.0,100.0,-1,2025-08-15 16:41:28,nyg_roster_turnover_detailed.csv,2025-08-17 08:45:20,32
NYG,2011,2012,LB,7,7,5,2,2,71.43,28.57,28.57,0,2025-08-15 16:41:28,nyg_roster_turnover_detailed.csv,2025-08-17 08:45:20,32
NYG,2011,2012,OL,6,5,3,3,2,50.0,50.0,40.0,-1,2025-08-15 16:41:28,nyg_roster_turnover_detailed.csv,2025-08-17 08:45:20,32
NYG,2011,2012,OTHER,12,16,9,3,7,75.0,25.0,43.75,4,2025-08-15 16:41:28,nyg_roster_turnover_detailed.csv,2025-08-17 08:45:20,32
NYG,2011,2012,QB,1,2,1,0,1,100.0,0.0,50.0,1,2025-08-15 16:41:28,nyg_roster_turnover_detailed.csv,2025-08-17 08:45:20,32
NYG,2011,2012,RB,5,7,3,2,4,60.0,40.0,57.14,2,2025-08-15 16:41:28,nyg_roster_turnover_detailed.csv,2025-08-17 08:45:20,32
NYG,2011,2012,ST,2,2,2,0,0,100.0,0.0,0.0,0,2025-08-15 16:41:28,nyg_roster_turnover_detailed.csv,2025-08-17 08:45:20,32
NYG,2011,2012,TE,3,3,2,1,1,66.67,33.33,33.33,0,2025-08-15 16:41:28,nyg_roster_turnover_detailed.csv,2025-08-17 08:45:20,32
NYG,2011,2012,WR,9,6,5,4,1,55.56,44.44,16.67,-3,2025-08-15 16:41:28,nyg_roster_turnover_detailed.csv,2025-08-17 08:45:20,32
NYG,2012,2013,DB,8,9,2,6,7,25.0,75.0,77.78,1,2025-08-15 16:41:28,nyg_roster_turnover_detailed.csv,2025-08-17 08:45:20,32
NYG,2012,2013,DL,4,6,1,3,5,25.0,75.0,83.33,2,2025-08-15 16:41:28,nyg_roster_turnover_detailed.csv,2025-08-17 08:45:20,32
NYG,2012,2013,LB,7,6,3,4,3,42.86,57.14,50.0,-1,2025-08-15 16:41:28,nyg_roster_turnover_detailed.csv,2025-08-17 08:45:20,32
NYG,2012,2013,OL,5,6,2,3,4,40.0,60.0,66.67,1,2025-08-15 16:41:28,nyg_roster_turnover_detailed.csv,2025-08-17 08:45:20,32
NYG,2012,2013,OTHER,16,15,9,7,6,56.25,43.75,40.0,-1,2025-08-15 16:41:28,nyg_roster_turnover_detailed.csv,2025-08-17 08:45:20,32
NYG,2012,2013,QB,2,2,1,1,1,50.0,50.0,50.0,0,2025-08-15 16:41:28,nyg_roster_turnover_detailed.csv,2025-08-17 08:45:20,32
NYG,2012,2013,RB,7,9,4,3,5,57.14,42.86,55.56,2,2025-08-15 16:41:28,nyg_roster_turnover_detailed.csv,2025-08-17 08:45:20,32
NYG,2012,2013,ST,2,2,1,1,1,50.0,50.0,50.0,0,2025-08-15 16:41:28,nyg_roster_turnover_detailed.csv,2025-08-17 08:45:20,32
NYG,2012,2013,TE,3,3,1,2,2,33.33,66.67,66.67,0,2025-08-15 16:41:28,nyg_roster_turnover_detailed.csv,2025-08-17 08:45:20,32
NYG,2012,2013,WR,6,6,4,2,2,66.67,33.33,33.33,0,2025-08-15 16:41:28,nyg_roster_turnover_detailed.csv,2025-08-17 08:45:20,32
NYG,2013,2014,DB,9,10,2,7,8,22.22,77.78,80.0,1,2025-08-15 16:41:28,nyg_roster_turnover_detailed.csv,2025-08-17 08:45:20,32
NYG,2013,2014,DL,6,6,2,4,4,33.33,66.67,66.67,0,2025-08-15 16:41:28,nyg_roster_turnover_detailed.csv,2025-08-17 08:45:20,32
NYG,2013,2014,LB,6,9,3,3,6,50.0,50.0,66.67,3,2025-08-15 16:41:28,nyg_roster_turnover_detailed.csv,2025-08-17 08:45:20,32
NYG,2013,2014,OL,6,7,2,4,5,33.33,66.67,71.43,1,2025-08-15 16:41:28,nyg_roster_turnover_detailed.csv,2025-08-17 08:45:20,32
NYG,2013,2014,OTHER,15,15,7,8,8,46.67,53.33,53.33,0,2025-08-15 16:41:28,nyg_roster_turnover_detailed.csv,2025-08-17 08:45:20,32
NYG,2013,2014,QB,2,2,1,1,1,50.0,50.0,50.0,0,2025-08-15 16:41:28,nyg_roster_turnover_detailed.csv,2025-08-17 08:45:20,32
NYG,2013,2014,RB,9,7,3,6,4,33.33,66.67,57.14,-2,2025-08-15 16:41:28,nyg_roster_turnover_detailed.csv,2025-08-17 08:45:20,32
NYG,2013,2014,ST,2,2,2,0,0,100.0,0.0,0.0,0,2025-08-15 16:41:28,nyg_roster_turnover_detailed.csv,2025-08-17 08:45:20,32
NYG,2013,2014,TE,3,2,1,2,1,33.33,66.67,50.0,-1,2025-08-15 16:41:28,nyg_roster_turnover_detailed.csv,2025-08-17 08:45:20,32
NYG,2013,2014,WR,6,8,4,2,4,66.67,33.33,50.0,2,2025-08-15 16:41:28,nyg_roster_turnover_detailed.csv,2025-08-17 08:45:20,32
NYG,2014,2015,DB,10,9,1,9,8,10.0,90.0,88.89,-1,2025-08-15 16:41:28,nyg_roster_turnover_detailed.csv,2025-08-17 08:45:20,32
NYG,2014,2015,DL,6,8,2,4,6,33.33,66.67,75.0,2,2025-08-15 16:41:28,nyg_roster_turnover_detailed.csv,2025-08-17 08:45:20,32
NYG,2014,2015,LB,9,8,2,7,6,22.22,77.78,75.0,-1,2025-08-15 16:41:28,nyg_roster_turnover_detailed.csv,2025-08-17 08:45:20,32
NYG,2014,2015,OL,7,4,1,6,3,14.29,85.71,75.0,-3,2025-08-15 16:41:28,nyg_roster_turnover_detailed.csv,2025-08-17 08:45:20,32
NYG,2014,2015,OTHER,15,17,8,7,9,53.33,46.67,52.94,2,2025-08-15 16:41:28,nyg_roster_turnover_detailed.csv,2025-08-17 08:45:20,32
NYG,2014,2015,QB,2,2,2,0,0,100.0,0.0,0.0,0,2025-08-15 16:41:28,nyg_roster_turnover_detailed.csv,2025-08-17 08:45:20,32
NYG,2014,2015,RB,7,4,3,4,1,42.86,57.14,25.0,-3,2025-08-15 16:41:28,nyg_roster_turnover_detailed.csv,2025-08-17 08:45:20,32
NYG,2014,2015,ST,2,4,1,1,3,50.0,50.0,75.0,2,2025-08-15 16:41:28,nyg_roster_turnover_detailed.csv,2025-08-17 08:45:20,32
NYG,2014,2015,TE,2,6,2,0,4,100.0,0.0,66.67,4,2025-08-15 16:41:28,nyg_roster_turnover_detailed.csv,2025-08-17 08:45:20,32
NYG,2014,2015,WR,8,8,3,5,5,37.5,62.5,62.5,0,2025-08-15 16:41:28,nyg_roster_turnover_detailed.csv,2025-08-17 08:45:20,32
NYG,2015,2016,DB,9,10,2,7,8,22.22,77.78,80.0,1,2025-08-15 16:41:28,nyg_roster_turnover_detailed.csv,2025-08-17 08:45:20,32
NYG,2015,2016,DL,8,6,3,5,3,37.5,62.5,50.0,-2,2025-08-15 16:41:28,nyg_roster_turnover_detailed.csv,2025-08-17 08:45:20,32
NYG,2015,2016,LB,8,7,2,6,5,25.0,75.0,71.43,-1,2025-08-15 16:41:28,nyg_roster_turnover_detailed.csv,2025-08-17 08:45:20,32
NYG,2015,2016,OL,4,5,2,2,3,50.0,50.0,60.0,1,2025-08-15 16:41:28,nyg_roster_turnover_detailed.csv,2025-08-17 08:45:20,32
NYG,2015,2016,OTHER,17,14,9,8,5,52.94,47.06,35.71,-3,2025-08-15 16:41:28,nyg_roster_turnover_detailed.csv,2025-08-17 08:45:20,32
NYG,2015,2016,QB,2,1,1,1,0,50.0,50.0,0.0,-1,2025-08-15 16:41:28,nyg_roster_turnover_detailed.csv,2025-08-17 08:45:20,32
NYG,2015,2016,RB,4,5,3,1,2,75.0,25.0,40.0,1,2025-08-15 16:41:28,nyg_roster_turnover_detailed.csv,2025-08-17 08:45:20,32
NYG,2015,2016,ST,4,4,2,2,2,50.0,50.0,50.0,0,2025-08-15 16:41:28,nyg_roster_turnover_detailed.csv,2025-08-17 08:45:20,32
NYG,2015,2016,TE,6,3,2,4,1,33.33,66.67,33.33,-3,2025-08-15 16:41:28,nyg_roster_turnover_detailed.csv,2025-08-17 08:45:20,32
NYG,2015,2016,WR,8,6,2,6,4,25.0,75.0,66.67,-2,2025-08-15 16:41:28,nyg_roster_turnover_detailed.csv,2025-08-17 08:45:20,32
NYG,2016,2017,DB,10,12,5,5,7,50.0,50.0,58.33,2,2025-08-15 16:41:28,nyg_roster_turnover_detailed.csv,2025-08-17 08:45:20,32
NYG,2016,2017,DL,6,8,4,2,4,66.67,33.33,50.0,2,2025-08-15 16:41:28,nyg_roster_turnover_detailed.csv,2025-08-17 08:45:20,32
NYG,2016,2017,LB,7,10,5,2,5,71.43,28.57,50.0,3,2025-08-15 16:41:28,nyg_roster_turnover_detailed.csv,2025-08-17 08:45:20,32
NYG,2016,2017,OL,5,7,2,3,5,40.0,60.0,71.43,2,2025-08-15 16:41:28,nyg_roster_turnover_detailed.csv,2025-08-17 08:45:20,32
NYG,2016,2017,OTHER,14,14,10,4,4,71.43,28.57,28.57,0,2025-08-15 16:41:28,nyg_roster_turnover_detailed.csv,2025-08-17 08:45:20,32
NYG,2016,2017,QB,1,2,1,0,1,100.0,0.0,50.0,1,2025-08-15 16:41:28,nyg_roster_turnover_detailed.csv,2025-08-17 08:45:20,32
NYG,2016,2017,RB,5,5,3,2,2,60.0,40.0,40.0,0,2025-08-15 16:41:28,nyg_roster_turnover_detailed.csv,2025-08-17 08:45:20,32
NYG,2016,2017,ST,4,2,1,3,1,25.0,75.0,50.0,-2,2025-08-15 16:41:28,nyg_roster_turnover_detailed.csv,2025-08-17 08:45:20,32
NYG,2016,2017,TE,3,5,1,2,4,33.33,66.67,80.0,2,2025-08-15 16:41:28,nyg_roster_turnover_detailed.csv,2025-08-17 08:45:20,32
NYG,2016,2017,WR,6,12,5,1,7,83.33,16.67,58.33,6,2025-08-15 16:41:28,nyg_roster_turnover_detailed.csv,2025-08-17 08:45:20,32
NYG,2017,2018,DB,12,10,3,9,7,25.0,75.0,70.0,-2,2025-08-15 16:41:28,nyg_roster_turnover_detailed.csv,2025-08-17 08:45:20,32
NYG,2017,2018,DL,8,7,1,7,6,12.5,87.5,85.71,-1,2025-08-15 16:41:28,nyg_roster_turnover_detailed.csv,2025-08-17 08:45:20,32
NYG,2017,2018,LB,10,6,1,9,5,10.0,90.0,83.33,-4,2025-08-15 16:41:28,nyg_roster_turnover_detailed.csv,2025-08-17 08:45:20,32
NYG,2017,2018,OL,7,4,1,6,3,14.29,85.71,75.0,-3,2025-08-15 16:41:28,nyg_roster_turnover_detailed.csv,2025-08-17 08:45:20,32
NYG,2017,2018,OTHER,14,15,4,10,11,28.57,71.43,73.33,1,2025-08-15 16:41:28,nyg_roster_turnover_detailed.csv,2025-08-17 08:45:20,32
NYG,2017,2018,QB,2,2,1,1,1,50.0,50.0,50.0,0,2025-08-15 16:41:28,nyg_roster_turnover_detailed.csv,2025-08-17 08:45:20,32
NYG,2017,2018,RB,5,5,2,3,3,40.0,60.0,60.0,0,2025-08-15 16:41:28,nyg_roster_turnover_detailed.csv,2025-08-17 08:45:20,32
NYG,2017,2018,ST,2,2,1,1,1,50.0,50.0,50.0,0,2025-08-15 16:41:28,nyg_roster_turnover_detailed.csv,2025-08-17 08:45:20,32
NYG,2017,2018,TE,5,4,2,3,2,40.0,60.0,50.0,-1,2025-08-15 16:41:28,nyg_roster_turnover_detailed.csv,2025-08-17 08:45:20,32
NYG,2017,2018,WR,12,12,2,10,10,16.67,83.33,83.33,0,2025-08-15 16:41:28,nyg_roster_turnover_detailed.csv,2025-08-17 08:45:20,32
NYG,2018,2019,DB,10,10,3,7,7,30.0,70.0,70.0,0,2025-08-15 16:41:28,nyg_roster_turnover_detailed.csv,2025-08-17 08:45:20,32
NYG,2018,2019,DL,7,5,1,6,4,14.29,85.71,80.0,-2,2025-08-15 16:41:28,nyg_roster_turnover_detailed.csv,2025-08-17 08:45:20,32
NYG,2018,2019,LB,6,9,3,3,6,50.0,50.0,66.67,3,2025-08-15 16:41:28,nyg_roster_turnover_detailed.csv,2025-08-17 08:45:20,32
NYG,2018,2019,OL,4,5,2,2,3,50.0,50.0,60.0,1,2025-08-15 16:41:28,nyg_roster_turnover_detailed.csv,2025-08-17 08:45:20,32
NYG,2018,2019,OTHER,15,13,5,10,8,33.33,66.67,61.54,-2,2025-08-15 16:41:28,nyg_roster_turnover_detailed.csv,2025-08-17 08:45:20,32
NYG,2018,2019,QB,2,3,1,1,2,50.0,50.0,66.67,1,2025-08-15 16:41:28,nyg_roster_turnover_detailed.csv,2025-08-17 08:45:20,32
NYG,2018,2019,RB,5,7,3,2,4,60.0,40.0,57.14,2,2025-08-15 16:41:28,nyg_roster_turnover_detailed.csv,2025-08-17 08:45:20,32
NYG,2018,2019,ST,2,3,2,0,1,100.0,0.0,33.33,1,2025-08-15 16:41:28,nyg_roster_turnover_detailed.csv,2025-08-17 08:45:20,32
NYG,2018,2019,TE,4,5,3,1,2,75.0,25.0,40.0,1,2025-08-15 16:41:28,nyg_roster_turnover_detailed.csv,2025-08-17 08:45:20,32
NYG,2018,2019,WR,12,9,4,8,5,33.33,66.67,55.56,-3,2025-08-15 16:41:28,nyg_roster_turnover_detailed.csv,2025-08-17 08:45:20,32
NYG,2019,2020,DB,10,14,4,6,10,40.0,60.0,71.43,4,2025-08-15 16:41:28,nyg_roster_turnover_detailed.csv,2025-08-17 08:45:20,32
NYG,2019,2020,DL,5,8,2,3,6,40.0,60.0,75.0,3,2025-08-15 16:41:28,nyg_roster_turnover_detailed.csv,2025-08-17 08:45:20,32
NYG,2019,2020,LB,9,6,1,8,5,11.11,88.89,83.33,-3,2025-08-15 16:41:28,nyg_roster_turnover_detailed.csv,2025-08-17 08:45:20,32
NYG,2019,2020,OL,5,3,1,4,2,20.0,80.0,66.67,-2,2025-08-15 16:41:28,nyg_roster_turnover_detailed.csv,2025-08-17 08:45:20,32
NYG,2019,2020,OTHER,13,12,4,9,8,30.77,69.23,66.67,-1,2025-08-15 16:41:28,nyg_roster_turnover_detailed.csv,2025-08-17 08:45:20,32
NYG,2019,2020,QB,3,2,1,2,1,33.33,66.67,50.0,-1,2025-08-15 16:41:28,nyg_roster_turnover_detailed.csv,2025-08-17 08:45:20,32
NYG,2019,2020,RB,7,6,3,4,3,42.86,57.14,50.0,-1,2025-08-15 16:41:28,nyg_roster_turnover_detailed.csv,2025-08-17 08:45:20,32
NYG,2019,2020,ST,3,3,1,2,2,33.33,66.67,66.67,0,2025-08-15 16:41:28,nyg_roster_turnover_detailed.csv,2025-08-17 08:45:20,32
NYG,2019,2020,TE,5,4,3,2,1,60.0,40.0,25.0,-1,2025-08-15 16:41:28,nyg_roster_turnover_detailed.csv,2025-08-17 08:45:20,32
NYG,2019,2020,WR,9,10,3,6,7,33.33,66.67,70.0,1,2025-08-15 16:41:28,nyg_roster_turnover_detailed.csv,2025-08-17 08:45:20,32
NYG,2020,2021,DB,14,14,7,7,7,50.0,50.0,50.0,0,2025-08-15 16:41:28,nyg_roster_turnover_detailed.csv,2025-08-17 08:45:20,32
NYG,2020,2021,DL,8,9,3,5,6,37.5,62.5,66.67,1,2025-08-15 16:41:28,nyg_roster_turnover_detailed.csv,2025-08-17 08:45:20,32
NYG,2020,2021,LB,6,7,2,4,5,33.33,66.67,71.43,1,2025-08-15 16:41:28,nyg_roster_turnover_detailed.csv,2025-08-17 08:45:20,32
NYG,2020,2021,OL,3,6,1,2,5,33.33,66.67,83.33,3,2025-08-15 16:41:28,nyg_roster_turnover_detailed.csv,2025-08-17 08:45:20,32
NYG,2020,2021,OTHER,12,13,6,6,7,50.0,50.0,53.85,1,2025-08-15 16:41:28,nyg_roster_turnover_detailed.csv,2025-08-17 08:45:20,32
NYG,2020,2021,QB,2,3,1,1,2,50.0,50.0,66.67,1,2025-08-15 16:41:28,nyg_roster_turnover_detailed.csv,2025-08-17 08:45:20,32
NYG,2020,2021,RB,6,5,2,4,3,33.33,66.67,60.0,-1,2025-08-15 16:41:28,nyg_roster_turnover_detailed.csv,2025-08-17 08:45:20,32
NYG,2020,2021,ST,3,3,3,0,0,100.0,0.0,0.0,0,2025-08-15 16:41:28,nyg_roster_turnover_detailed.csv,2025-08-17 08:45:20,32
NYG,2020,2021,TE,4,4,2,2,2,50.0,50.0,50.0,0,2025-08-15 16:41:28,nyg_roster_turnover_detailed.csv,2025-08-17 08:45:20,32
NYG,2020,2021,WR,10,11,5,5,6,50.0,50.0,54.55,1,2025-08-15 16:41:28,nyg_roster_turnover_detailed.csv,2025-08-17 08:45:20,32
NYG,2021,2022,DB,14,14,5,9,9,35.71,64.29,64.29,0,2025-08-15 16:41:28,nyg_roster_turnover_detailed.csv,2025-08-17 08:45:20,32
NYG,2021,2022,DL,9,8,0,9,8,0.0,100.0,100.0,-1,2025-08-15 16:41:28,nyg_roster_turnover_detailed.csv,2025-08-17 08:45:20,32
NYG,2021,2022,LB,7,8,3,4,5,42.86,57.14,62.5,1,2025-08-15 16:41:28,nyg_roster_turnover_detailed.csv,2025-08-17 08:45:20,32
NYG,2021,2022,OL,6,9,1,5,8,16.67,83.33,88.89,3,2025-08-15 16:41:28,nyg_roster_turnover_detailed.csv,2025-08-17 08:45:20,32
NYG,2021,2022,OTHER,13,15,4,9,11,30.77,69.23,73.33,2,2025-08-15 16:41:28,nyg_roster_turnover_detailed.csv,2025-08-17 08:45:20,32
NYG,2021,2022,QB,3,3,1,2,2,33.33,66.67,66.67,0,2025-08-15 16:41:28,nyg_roster_turnover_detailed.csv,2025-08-17 08:45:20,32
NYG,2021,2022,RB,5,5,2,3,3,40.0,60.0,60.0,0,2025-08-15 16:41:28,nyg_roster_turnover_detailed.csv,2025-08-17 08:45:20,32
NYG,2021,2022,ST,3,3,2,1,1,66.67,33.33,33.33,0,2025-08-15 16:41:28,nyg_roster_turnover_detailed.csv,2025-08-17 08:45:20,32
NYG,2021,2022,TE,4,3,0,4,3,0.0,100.0,100.0,-1,2025-08-15 16:41:28,nyg_roster_turnover_detailed.csv,2025-08-17 08:45:20,32
NYG,2021,2022,WR,11,10,5,6,5,45.45,54.55,50.0,-1,2025-08-15 16:41:28,nyg_roster_turnover_detailed.csv,2025-08-17 08:45:20,32
NYG,2022,2023,DB,14,12,5,9,7,35.71,64.29,58.33,-2,2025-08-15 16:41:28,nyg_roster_turnover_detailed.csv,2025-08-17 08:45:20,32
NYG,2022,2023,DL,8,7,2,6,5,25.0,75.0,71.43,-1,2025-08-15 16:41:28,nyg_roster_turnover_detailed.csv,2025-08-17 08:45:20,32
NYG,2022,2023,LB,8,13,4,4,9,50.0,50.0,69.23,5,2025-08-15 16:41:28,nyg_roster_turnover_detailed.csv,2025-08-17 08:45:20,32
NYG,2022,2023,OL,9,13,4,5,9,44.44,55.56,69.23,4,2025-08-15 16:41:28,nyg_roster_turnover_detailed.csv,2025-08-17 08:45:20,32
NYG,2022,2023,OTHER,15,1,1,14,0,6.67,93.33,0.0,-14,2025-08-15 16:41:28,nyg_roster_turnover_detailed.csv,2025-08-17 08:45:20,32
NYG,2022,2023,QB,3,3,2,1,1,66.67,33.33,33.33,0,2025-08-15 16:41:28,nyg_roster_turnover_detailed.csv,2025-08-17 08:45:20,32
NYG,2022,2023,RB,5,7,3,2,4,60.0,40.0,57.14,2,2025-08-15 16:41:28,nyg_roster_turnover_detailed.csv,2025-08-17 08:45:20,32
NYG,2022,2023,ST,3,5,3,0,2,100.0,0.0,40.0,2,2025-08-15 16:41:28,nyg_roster_turnover_detailed.csv,2025-08-17 08:45:20,32
NYG,2022,2023,TE,3,4,1,2,3,33.33,66.67,75.0,1,2025-08-15 16:41:28,nyg_roster_turnover_detailed.csv,2025-08-17 08:45:20,32
NYG,2022,2023,WR,10,7,4,6,3,40.0,60.0,42.86,-3,2025-08-15 16:41:28,nyg_roster_turnover_detailed.csv,2025-08-17 08:45:20,32
NYG,2023,2024,DB,12,15,6,6,9,50.0,50.0,60.0,3,2025-08-15 16:41:28,nyg_roster_turnover_detailed.csv,2025-08-17 08:45:20,32
NYG,2023,2024,DL,7,7,2,5,5,28.57,71.43,71.43,0,2025-08-15 16:41:28,nyg_roster_turnover_detailed.csv,2025-08-17 08:45:20,32
NYG,2023,2024,LB,13,11,5,8,6,38.46,61.54,54.55,-2,2025-08-15 16:41:28,nyg_roster_turnover_detailed.csv,2025-08-17 08:45:20,32
NYG,2023,2024,OL,13,9,4,9,5,30.77,69.23,55.56,-4,2025-08-15 16:41:28,nyg_roster_turnover_detailed.csv,2025-08-17 08:45:20,32
NYG,2023,2024,OTHER,1,12,0,1,12,0.0,100.0,100.0,11,2025-08-15 16:41:28,nyg_roster_turnover_detailed.csv,2025-08-17 08:45:20,32
NYG,2023,2024,QB,3,4,2,1,2,66.67,33.33,50.0,1,2025-08-15 16:41:28,nyg_roster_turnover_detailed.csv,2025-08-17 08:45:20,32
NYG,2023,2024,RB,7,5,1,6,4,14.29,85.71,80.0,-2,2025-08-15 16:41:28,nyg_roster_turnover_detailed.csv,2025-08-17 08:45:20,32
NYG,2023,2024,ST,5,6,3,2,3,60.0,40.0,50.0,1,2025-08-15 16:41:28,nyg_roster_turnover_detailed.csv,2025-08-17 08:45:20,32
NYG,2023,2024,TE,4,4,1,3,3,25.0,75.0,75.0,0,2025-08-15 16:41:28,nyg_roster_turnover_detailed.csv,2025-08-17 08:45:20,32
NYG,2023,2024,WR,7,7,4,3,3,57.14,42.86,42.86,0,2025-08-15 16:41:28,nyg_roster_turnover_detailed.csv,2025-08-17 08:45:20,32
NYJ,2011,2012,DB,11,11,3,8,8,27.27,72.73,72.73,0,2025-08-15 16:41:28,nyj_roster_turnover_detailed.csv,2025-08-17 08:45:20,32
NYJ,2011,2012,DL,8,7,4,4,3,50.0,50.0,42.86,-1,2025-08-15 16:41:28,nyj_roster_turnover_detailed.csv,2025-08-17 08:45:20,32
NYJ,2011,2012,LB,4,6,3,1,3,75.0,25.0,50.0,2,2025-08-15 16:41:28,nyj_roster_turnover_detailed.csv,2025-08-17 08:45:20,32
NYJ,2011,2012,OL,4,3,2,2,1,50.0,50.0,33.33,-1,2025-08-15 16:41:28,nyj_roster_turnover_detailed.csv,2025-08-17 08:45:20,32
NYJ,2011,2012,OTHER,11,12,9,2,3,81.82,18.18,25.0,1,2025-08-15 16:41:28,nyj_roster_turnover_detailed.csv,2025-08-17 08:45:20,32
NYJ,2011,2012,QB,2,3,1,1,2,50.0,50.0,66.67,1,2025-08-15 16:41:28,nyj_roster_turnover_detailed.csv,2025-08-17 08:45:20,32
NYJ,2011,2012,RB,5,8,4,1,4,80.0,20.0,50.0,3,2025-08-15 16:41:28,nyj_roster_turnover_detailed.csv,2025-08-17 08:45:20,32
NYJ,2011,2012,ST,3,3,2,1,1,66.67,33.33,33.33,0,2025-08-15 16:41:28,nyj_roster_turnover_detailed.csv,2025-08-17 08:45:20,32
NYJ,2011,2012,TE,4,5,2,2,3,50.0,50.0,60.0,1,2025-08-15 16:41:28,nyj_roster_turnover_detailed.csv,2025-08-17 08:45:20,32
NYJ,2011,2012,WR,6,10,3,3,7,50.0,50.0,70.0,4,2025-08-15 16:41:28,nyj_roster_turnover_detailed.csv,2025-08-17 08:45:20,32
NYJ,2012,2013,DB,11,11,5,6,6,45.45,54.55,54.55,0,2025-08-15 16:41:28,nyj_roster_turnover_detailed.csv,2025-08-17 08:45:20,32
NYJ,2012,2013,DL,7,4,2,5,2,28.57,71.43,50.0,-3,2025-08-15 16:41:28,nyj_roster_turnover_detailed.csv,2025-08-17 08:45:20,32
NYJ,2012,2013,LB,6,6,3,3,3,50.0,50.0,50.0,0,2025-08-15 16:41:28,nyj_roster_turnover_detailed.csv,2025-08-17 08:45:20,32
NYJ,2012,2013,OL,3,3,2,1,1,66.67,33.33,33.33,0,2025-08-15 16:41:28,nyj_roster_turnover_detailed.csv,2025-08-17 08:45:20,32
NYJ,2012,2013,OTHER,12,12,6,6,6,50.0,50.0,50.0,0,2025-08-15 16:41:28,nyj_roster_turnover_detailed.csv,2025-08-17 08:45:20,32
NYJ,2012,2013,QB,3,2,0,3,2,0.0,100.0,100.0,-1,2025-08-15 16:41:28,nyj_roster_turnover_detailed.csv,2025-08-17 08:45:20,32
NYJ,2012,2013,RB,8,5,1,7,4,12.5,87.5,80.0,-3,2025-08-15 16:41:28,nyj_roster_turnover_detailed.csv,2025-08-17 08:45:20,32
NYJ,2012,2013,ST,3,4,3,0,1,100.0,0.0,25.0,1,2025-08-15 16:41:28,nyj_roster_turnover_detailed.csv,2025-08-17 08:45:20,32
NYJ,2012,2013,TE,5,4,2,3,2,40.0,60.0,50.0,-1,2025-08-15 16:41:28,nyj_roster_turnover_detailed.csv,2025-08-17 08:45:20,32
NYJ,2012,2013,WR,10,11,4,6,7,40.0,60.0,63.64,1,2025-08-15 16:41:28,nyj_roster_turnover_detailed.csv,2025-08-17 08:45:20,32
NYJ,2013,2014,DB,11,11,6,5,5,54.55,45.45,45.45,0,2025-08-15 16:41:28,nyj_roster_turnover_detailed.csv,2025-08-17 08:45:20,32
NYJ,2013,2014,DL,4,5,3,1,2,75.0,25.0,40.0,1,2025-08-15 16:41:28,nyj_roster_turnover_detailed.csv,2025-08-17 08:45:20,32
NYJ,2013,2014,LB,6,5,2,4,3,33.33,66.67,60.0,-1,2025-08-15 16:41:28,nyj_roster_turnover_detailed.csv,2025-08-17 08:45:20,32
NYJ,2013,2014,OL,3,3,1,2,2,33.33,66.67,66.67,0,2025-08-15 16:41:28,nyj_roster_turnover_detailed.csv,2025-08-17 08:45:20,32
NYJ,2013,2014,OTHER,12,14,9,3,5,75.0,25.0,35.71,2,2025-08-15 16:41:28,nyj_roster_turnover_detailed.csv,2025-08-17 08:45:20,32
NYJ,2013,2014,QB,2,3,2,0,1,100.0,0.0,33.33,1,2025-08-15 16:41:28,nyj_roster_turnover_detailed.csv,2025-08-17 08:45:20,32
NYJ,2013,2014,RB,5,5,3,2,2,60.0,40.0,40.0,0,2025-08-15 16:41:28,nyj_roster_turnover_detailed.csv,2025-08-17 08:45:20,32
NYJ,2013,2014,ST,4,3,3,1,0,75.0,25.0,0.0,-1,2025-08-15 16:41:28,nyj_roster_turnover_detailed.csv,2025-08-17 08:45:20,32
NYJ,2013,2014,TE,4,4,2,2,2,50.0,50.0,50.0,0,2025-08-15 16:41:28,nyj_roster_turnover_detailed.csv,2025-08-17 08:45:20,32
NYJ,2013,2014,WR,11,10,3,8,7,27.27,72.73,70.0,-1,2025-08-15 16:41:28,nyj_roster_turnover_detailed.csv,2025-08-17 08:45:20,32
NYJ,2014,2015,DB,11,11,3,8,8,27.27,72.73,72.73,0,2025-08-15 16:41:28,nyj_roster_turnover_detailed.csv,2025-08-17 08:45:20,32
NYJ,2014,2015,DL,5,6,3,2,3,60.0,40.0,50.0,1,2025-08-15 16:41:28,nyj_roster_turnover_detailed.csv,2025-08-17 08:45:20,32
NYJ,2014,2015,LB,5,4,1,4,3,20.0,80.0,75.0,-1,2025-08-15 16:41:28,nyj_roster_turnover_detailed.csv,2025-08-17 08:45:20,32
NYJ,2014,2015,OL,3,4,1,2,3,33.33,66.67,75.0,1,2025-08-15 16:41:28,nyj_roster_turnover_detailed.csv,2025-08-17 08:45:20,32
NYJ,2014,2015,OTHER,14,13,9,5,4,64.29,35.71,30.77,-1,2025-08-15 16:41:28,nyj_roster_turnover_detailed.csv,2025-08-17 08:45:20,32
NYJ,2014,2015,QB,3,2,1,2,1,33.33,66.67,50.0,-1,2025-08-15 16:41:28,nyj_roster_turnover_detailed.csv,2025-08-17 08:45:20,32
NYJ,2014,2015,RB,5,5,3,2,2,60.0,40.0,40.0,0,2025-08-15 16:41:28,nyj_roster_turnover_detailed.csv,2025-08-17 08:45:20,32
NYJ,2014,2015,ST,3,5,3,0,2,100.0,0.0,40.0,2,2025-08-15 16:41:28,nyj_roster_turnover_detailed.csv,2025-08-17 08:45:20,32
NYJ,2014,2015,TE,4,3,1,3,2,25.0,75.0,66.67,-1,2025-08-15 16:41:28,nyj_roster_turnover_detailed.csv,2025-08-17 08:45:20,32
NYJ,2014,2015,WR,10,7,4,6,3,40.0,60.0,42.86,-3,2025-08-15 16:41:28,nyj_roster_turnover_detailed.csv,2025-08-17 08:45:20,32
NYJ,2015,2016,DB,11,12,6,5,6,54.55,45.45,50.0,1,2025-08-15 16:41:28,nyj_roster_turnover_detailed.csv,2025-08-17 08:45:20,32
NYJ,2015,2016,DL,6,8,1,5,7,16.67,83.33,87.5,2,2025-08-15 16:41:28,nyj_roster_turnover_detailed.csv,2025-08-17 08:45:20,32
NYJ,2015,2016,LB,4,10,2,2,8,50.0,50.0,80.0,6,2025-08-15 16:41:28,nyj_roster_turnover_detailed.csv,2025-08-17 08:45:20,32
NYJ,2015,2016,OL,4,5,3,1,2,75.0,25.0,40.0,1,2025-08-15 16:41:28,nyj_roster_turnover_detailed.csv,2025-08-17 08:45:20,32
NYJ,2015,2016,OTHER,13,14,8,5,6,61.54,38.46,42.86,1,2025-08-15 16:41:28,nyj_roster_turnover_detailed.csv,2025-08-17 08:45:20,32
NYJ,2015,2016,QB,2,3,2,0,1,100.0,0.0,33.33,1,2025-08-15 16:41:28,nyj_roster_turnover_detailed.csv,2025-08-17 08:45:20,32
NYJ,2015,2016,RB,5,7,1,4,6,20.0,80.0,85.71,2,2025-08-15 16:41:28,nyj_roster_turnover_detailed.csv,2025-08-17 08:45:20,32
NYJ,2015,2016,ST,5,3,2,3,1,40.0,60.0,33.33,-2,2025-08-15 16:41:28,nyj_roster_turnover_detailed.csv,2025-08-17 08:45:20,32
NYJ,2015,2016,TE,3,5,1,2,4,33.33,66.67,80.0,2,2025-08-15 16:41:28,nyj_roster_turnover_detailed.csv,2025-08-17 08:45:20,32
NYJ,2015,2016,WR,7,8,4,3,4,57.14,42.86,50.0,1,2025-08-15 16:41:28,nyj_roster_turnover_detailed.csv,2025-08-17 08:45:20,32
NYJ,2016,2017,DB,12,12,4,8,8,33.33,66.67,66.67,0,2025-08-15 16:41:28,nyj_roster_turnover_detailed.csv,2025-08-17 08:45:20,32
NYJ,2016,2017,DL,8,10,3,5,7,37.5,62.5,70.0,2,2025-08-15 16:41:28,nyj_roster_turnover_detailed.csv,2025-08-17 08:45:20,32
NYJ,2016,2017,LB,10,4,2,8,2,20.0,80.0,50.0,-6,2025-08-15 16:41:28,nyj_roster_turnover_detailed.csv,2025-08-17 08:45:20,32
NYJ,2016,2017,OL,5,4,2,3,2,40.0,60.0,50.0,-1,2025-08-15 16:41:28,nyj_roster_turnover_detailed.csv,2025-08-17 08:45:20,32
NYJ,2016,2017,OTHER,14,13,8,6,5,57.14,42.86,38.46,-1,2025-08-15 16:41:28,nyj_roster_turnover_detailed.csv,2025-08-17 08:45:20,32
NYJ,2016,2017,QB,3,2,1,2,1,33.33,66.67,50.0,-1,2025-08-15 16:41:28,nyj_roster_turnover_detailed.csv,2025-08-17 08:45:20,32
NYJ,2016,2017,RB,7,4,2,5,2,28.57,71.43,50.0,-3,2025-08-15 16:41:28,nyj_roster_turnover_detailed.csv,2025-08-17 08:45:20,32
NYJ,2016,2017,ST,3,3,1,2,2,33.33,66.67,66.67,0,2025-08-15 16:41:28,nyj_roster_turnover_detailed.csv,2025-08-17 08:45:20,32
NYJ,2016,2017,TE,5,3,2,3,1,40.0,60.0,33.33,-2,2025-08-15 16:41:28,nyj_roster_turnover_detailed.csv,2025-08-17 08:45:20,32
NYJ,2016,2017,WR,8,9,2,6,7,25.0,75.0,77.78,1,2025-08-15 16:41:28,nyj_roster_turnover_detailed.csv,2025-08-17 08:45:20,32
NYJ,2017,2018,DB,12,13,8,4,5,66.67,33.33,38.46,1,2025-08-15 16:41:28,nyj_roster_turnover_detailed.csv,2025-08-17 08:45:20,32
NYJ,2017,2018,DL,10,4,1,9,3,10.0,90.0,75.0,-6,2025-08-15 16:41:28,nyj_roster_turnover_detailed.csv,2025-08-17 08:45:20,32
NYJ,2017,2018,LB,4,8,0,4,8,0.0,100.0,100.0,4,2025-08-15 16:41:28,nyj_roster_turnover_detailed.csv,2025-08-17 08:45:20,32
NYJ,2017,2018,OL,4,5,2,2,3,50.0,50.0,60.0,1,2025-08-15 16:41:28,nyj_roster_turnover_detailed.csv,2025-08-17 08:45:20,32
NYJ,2017,2018,OTHER,13,14,8,5,6,61.54,38.46,42.86,1,2025-08-15 16:41:28,nyj_roster_turnover_detailed.csv,2025-08-17 08:45:20,32
NYJ,2017,2018,QB,2,2,1,1,1,50.0,50.0,50.0,0,2025-08-15 16:41:28,nyj_roster_turnover_detailed.csv,2025-08-17 08:45:20,32
NYJ,2017,2018,RB,4,5,2,2,3,50.0,50.0,60.0,1,2025-08-15 16:41:28,nyj_roster_turnover_detailed.csv,2025-08-17 08:45:20,32
NYJ,2017,2018,ST,3,3,2,1,1,66.67,33.33,33.33,0,2025-08-15 16:41:28,nyj_roster_turnover_detailed.csv,2025-08-17 08:45:20,32
NYJ,2017,2018,TE,3,4,1,2,3,33.33,66.67,75.0,1,2025-08-15 16:41:28,nyj_roster_turnover_detailed.csv,2025-08-17 08:45:20,32
NYJ,2017,2018,WR,9,10,4,5,6,44.44,55.56,60.0,1,2025-08-15 16:41:28,nyj_roster_turnover_detailed.csv,2025-08-17 08:45:20,32
NYJ,2018,2019,DB,13,9,3,10,6,23.08,76.92,66.67,-4,2025-08-15 16:41:28,nyj_roster_turnover_detailed.csv,2025-08-17 08:45:20,32
NYJ,2018,2019,DL,4,5,2,2,3,50.0,50.0,60.0,1,2025-08-15 16:41:28,nyj_roster_turnover_detailed.csv,2025-08-17 08:45:20,32
NYJ,2018,2019,LB,8,10,2,6,8,25.0,75.0,80.0,2,2025-08-15 16:41:28,nyj_roster_turnover_detailed.csv,2025-08-17 08:45:20,32
NYJ,2018,2019,OL,5,6,3,2,3,60.0,40.0,50.0,1,2025-08-15 16:41:28,nyj_roster_turnover_detailed.csv,2025-08-17 08:45:20,32
NYJ,2018,2019,OTHER,14,17,7,7,10,50.0,50.0,58.82,3,2025-08-15 16:41:28,nyj_roster_turnover_detailed.csv,2025-08-17 08:45:20,32
NYJ,2018,2019,QB,2,4,1,1,3,50.0,50.0,75.0,2,2025-08-15 16:41:28,nyj_roster_turnover_detailed.csv,2025-08-17 08:45:20,32
NYJ,2018,2019,RB,5,5,2,3,3,40.0,60.0,60.0,0,2025-08-15 16:41:28,nyj_roster_turnover_detailed.csv,2025-08-17 08:45:20,32
NYJ,2018,2019,ST,3,4,2,1,2,66.67,33.33,50.0,1,2025-08-15 16:41:28,nyj_roster_turnover_detailed.csv,2025-08-17 08:45:20,32
NYJ,2018,2019,TE,4,2,1,3,1,25.0,75.0,50.0,-2,2025-08-15 16:41:28,nyj_roster_turnover_detailed.csv,2025-08-17 08:45:20,32
NYJ,2018,2019,WR,10,11,2,8,9,20.0,80.0,81.82,1,2025-08-15 16:41:28,nyj_roster_turnover_detailed.csv,2025-08-17 08:45:20,32
NYJ,2019,2020,DB,9,16,4,5,12,44.44,55.56,75.0,7,2025-08-15 16:41:28,nyj_roster_turnover_detailed.csv,2025-08-17 08:45:20,32
NYJ,2019,2020,DL,5,7,3,2,4,60.0,40.0,57.14,2,2025-08-15 16:41:28,nyj_roster_turnover_detailed.csv,2025-08-17 08:45:20,32
NYJ,2019,2020,LB,10,12,3,7,9,30.0,70.0,75.0,2,2025-08-15 16:41:28,nyj_roster_turnover_detailed.csv,2025-08-17 08:45:20,32
NYJ,2019,2020,OL,6,4,1,5,3,16.67,83.33,75.0,-2,2025-08-15 16:41:28,nyj_roster_turnover_detailed.csv,2025-08-17 08:45:20,32
NYJ,2019,2020,OTHER,17,14,6,11,8,35.29,64.71,57.14,-3,2025-08-15 16:41:28,nyj_roster_turnover_detailed.csv,2025-08-17 08:45:20,32
NYJ,2019,2020,QB,4,2,1,3,1,25.0,75.0,50.0,-2,2025-08-15 16:41:28,nyj_roster_turnover_detailed.csv,2025-08-17 08:45:20,32
NYJ,2019,2020,RB,5,6,2,3,4,40.0,60.0,66.67,1,2025-08-15 16:41:28,nyj_roster_turnover_detailed.csv,2025-08-17 08:45:20,32
NYJ,2019,2020,ST,4,5,2,2,3,50.0,50.0,60.0,1,2025-08-15 16:41:28,nyj_roster_turnover_detailed.csv,2025-08-17 08:45:20,32
NYJ,2019,2020,TE,2,3,2,0,1,100.0,0.0,33.33,1,2025-08-15 16:41:28,nyj_roster_turnover_detailed.csv,2025-08-17 08:45:20,32
NYJ,2019,2020,WR,11,11,6,5,5,54.55,45.45,45.45,0,2025-08-15 16:41:28,nyj_roster_turnover_detailed.csv,2025-08-17 08:45:20,32
NYJ,2020,2021,DB,16,17,4,12,13,25.0,75.0,76.47,1,2025-08-15 16:41:28,nyj_roster_turnover_detailed.csv,2025-08-17 08:45:20,32
NYJ,2020,2021,DL,7,8,3,4,5,42.86,57.14,62.5,1,2025-08-15 16:41:28,nyj_roster_turnover_detailed.csv,2025-08-17 08:45:20,32
NYJ,2020,2021,LB,12,10,2,10,8,16.67,83.33,80.0,-2,2025-08-15 16:41:28,nyj_roster_turnover_detailed.csv,2025-08-17 08:45:20,32
NYJ,2020,2021,OL,4,5,3,1,2,75.0,25.0,40.0,1,2025-08-15 16:41:28,nyj_roster_turnover_detailed.csv,2025-08-17 08:45:20,32
NYJ,2020,2021,OTHER,14,13,4,10,9,28.57,71.43,69.23,-1,2025-08-15 16:41:28,nyj_roster_turnover_detailed.csv,2025-08-17 08:45:20,32
NYJ,2020,2021,QB,2,4,1,1,3,50.0,50.0,75.0,2,2025-08-15 16:41:28,nyj_roster_turnover_detailed.csv,2025-08-17 08:45:20,32
NYJ,2020,2021,RB,6,7,3,3,4,50.0,50.0,57.14,1,2025-08-15 16:41:28,nyj_roster_turnover_detailed.csv,2025-08-17 08:45:20,32
NYJ,2020,2021,ST,5,6,2,3,4,40.0,60.0,66.67,1,2025-08-15 16:41:28,nyj_roster_turnover_detailed.csv,2025-08-17 08:45:20,32
NYJ,2020,2021,TE,3,5,2,1,3,66.67,33.33,60.0,2,2025-08-15 16:41:28,nyj_roster_turnover_detailed.csv,2025-08-17 08:45:20,32
NYJ,2020,2021,WR,11,12,6,5,6,54.55,45.45,50.0,1,2025-08-15 16:41:28,nyj_roster_turnover_detailed.csv,2025-08-17 08:45:20,32
NYJ,2021,2022,DB,17,8,4,13,4,23.53,76.47,50.0,-9,2025-08-15 16:41:28,nyj_roster_turnover_detailed.csv,2025-08-17 08:45:20,32
NYJ,2021,2022,DL,8,9,2,6,7,25.0,75.0,77.78,1,2025-08-15 16:41:28,nyj_roster_turnover_detailed.csv,2025-08-17 08:45:20,32
NYJ,2021,2022,LB,10,4,1,9,3,10.0,90.0,75.0,-6,2025-08-15 16:41:28,nyj_roster_turnover_detailed.csv,2025-08-17 08:45:20,32
NYJ,2021,2022,OL,5,7,2,3,5,40.0,60.0,71.43,2,2025-08-15 16:41:28,nyj_roster_turnover_detailed.csv,2025-08-17 08:45:20,32
NYJ,2021,2022,OTHER,13,14,4,9,10,30.77,69.23,71.43,1,2025-08-15 16:41:28,nyj_roster_turnover_detailed.csv,2025-08-17 08:45:20,32
NYJ,2021,2022,QB,4,4,3,1,1,75.0,25.0,25.0,0,2025-08-15 16:41:28,nyj_roster_turnover_detailed.csv,2025-08-17 08:45:20,32
NYJ,2021,2022,RB,7,5,2,5,3,28.57,71.43,60.0,-2,2025-08-15 16:41:28,nyj_roster_turnover_detailed.csv,2025-08-17 08:45:20,32
NYJ,2021,2022,ST,6,3,2,4,1,33.33,66.67,33.33,-3,2025-08-15 16:41:28,nyj_roster_turnover_detailed.csv,2025-08-17 08:45:20,32
NYJ,2021,2022,TE,5,4,1,4,3,20.0,80.0,75.0,-1,2025-08-15 16:41:28,nyj_roster_turnover_detailed.csv,2025-08-17 08:45:20,32
NYJ,2021,2022,WR,12,8,6,6,2,50.0,50.0,25.0,-4,2025-08-15 16:41:28,nyj_roster_turnover_detailed.csv,2025-08-17 08:45:20,32
NYJ,2022,2023,DB,8,13,6,2,7,75.0,25.0,53.85,5,2025-08-15 16:41:28,nyj_roster_turnover_detailed.csv,2025-08-17 08:45:20,32
NYJ,2022,2023,DL,9,12,3,6,9,33.33,66.67,75.0,3,2025-08-15 16:41:28,nyj_roster_turnover_detailed.csv,2025-08-17 08:45:20,32
NYJ,2022,2023,LB,4,9,2,2,7,50.0,50.0,77.78,5,2025-08-15 16:41:28,nyj_roster_turnover_detailed.csv,2025-08-17 08:45:20,32
NYJ,2022,2023,OL,7,13,2,5,11,28.57,71.43,84.62,6,2025-08-15 16:41:28,nyj_roster_turnover_detailed.csv,2025-08-17 08:45:20,32
NYJ,2022,2023,OTHER,14,1,1,13,0,7.14,92.86,0.0,-13,2025-08-15 16:41:28,nyj_roster_turnover_detailed.csv,2025-08-17 08:45:20,32
NYJ,2022,2023,QB,4,4,1,3,3,25.0,75.0,75.0,0,2025-08-15 16:41:28,nyj_roster_turnover_detailed.csv,2025-08-17 08:45:20,32
NYJ,2022,2023,RB,5,6,2,3,4,40.0,60.0,66.67,1,2025-08-15 16:41:28,nyj_roster_turnover_detailed.csv,2025-08-17 08:45:20,32
NYJ,2022,2023,ST,3,4,2,1,2,66.67,33.33,50.0,1,2025-08-15 16:41:28,nyj_roster_turnover_detailed.csv,2025-08-17 08:45:20,32
NYJ,2022,2023,TE,4,5,4,0,1,100.0,0.0,20.0,1,2025-08-15 16:41:28,nyj_roster_turnover_detailed.csv,2025-08-17 08:45:20,32
NYJ,2022,2023,WR,8,8,1,7,7,12.5,87.5,87.5,0,2025-08-15 16:41:28,nyj_roster_turnover_detailed.csv,2025-08-17 08:45:20,32
NYJ,2023,2024,DB,13,12,5,8,7,38.46,61.54,58.33,-1,2025-08-15 16:41:28,nyj_roster_turnover_detailed.csv,2025-08-17 08:45:20,32
NYJ,2023,2024,DL,12,9,4,8,5,33.33,66.67,55.56,-3,2025-08-15 16:41:28,nyj_roster_turnover_detailed.csv,2025-08-17 08:45:20,32
NYJ,2023,2024,LB,9,5,4,5,1,44.44,55.56,20.0,-4,2025-08-15 16:41:28,nyj_roster_turnover_detailed.csv,2025-08-17 08:45:20,32
NYJ,2023,2024,OL,13,10,7,6,3,53.85,46.15,30.0,-3,2025-08-15 16:41:28,nyj_roster_turnover_detailed.csv,2025-08-17 08:45:20,32
NYJ,2023,2024,OTHER,1,12,0,1,12,0.0,100.0,100.0,11,2025-08-15 16:41:28,nyj_roster_turnover_detailed.csv,2025-08-17 08:45:20,32
NYJ,2023,2024,QB,4,2,1,3,1,25.0,75.0,50.0,-2,2025-08-15 16:41:28,nyj_roster_turnover_detailed.csv,2025-08-17 08:45:20,32
NYJ,2023,2024,RB,6,4,1,5,3,16.67,83.33,75.0,-2,2025-08-15 16:41:28,nyj_roster_turnover_detailed.csv,2025-08-17 08:45:20,32
NYJ,2023,2024,ST,4,7,3,1,4,75.0,25.0,57.14,3,2025-08-15 16:41:28,nyj_roster_turnover_detailed.csv,2025-08-17 08:45:20,32
NYJ,2023,2024,TE,5,6,4,1,2,80.0,20.0,33.33,1,2025-08-15 16:41:28,nyj_roster_turnover_detailed.csv,2025-08-17 08:45:20,32
NYJ,2023,2024,WR,8,8,4,4,4,50.0,50.0,50.0,0,2025-08-15 16:41:28,nyj_roster_turnover_detailed.csv,2025-08-17 08:45:20,32
OTI,2011,2012,DB,8,8,4,4,4,50.0,50.0,50.0,0,2025-08-15 16:41:32,oti_roster_turnover_detailed.csv,2025-08-17 08:45:20,32
OTI,2011,2012,DL,4,7,1,3,6,25.0,75.0,85.71,3,2025-08-15 16:41:32,oti_roster_turnover_detailed.csv,2025-08-17 08:45:20,32
OTI,2011,2012,LB,6,6,3,3,3,50.0,50.0,50.0,0,2025-08-15 16:41:32,oti_roster_turnover_detailed.csv,2025-08-17 08:45:20,32
OTI,2011,2012,OL,3,7,2,1,5,66.67,33.33,71.43,4,2025-08-15 16:41:32,oti_roster_turnover_detailed.csv,2025-08-17 08:45:20,32
OTI,2011,2012,OTHER,14,13,8,6,5,57.14,42.86,38.46,-1,2025-08-15 16:41:32,oti_roster_turnover_detailed.csv,2025-08-17 08:45:20,32
OTI,2011,2012,QB,2,3,2,0,1,100.0,0.0,33.33,1,2025-08-15 16:41:32,oti_roster_turnover_detailed.csv,2025-08-17 08:45:20,32
OTI,2011,2012,RB,5,6,4,1,2,80.0,20.0,33.33,1,2025-08-15 16:41:32,oti_roster_turnover_detailed.csv,2025-08-17 08:45:20,32
OTI,2011,2012,ST,3,2,2,1,0,66.67,33.33,0.0,-1,2025-08-15 16:41:32,oti_roster_turnover_detailed.csv,2025-08-17 08:45:20,32
OTI,2011,2012,TE,3,5,2,1,3,66.67,33.33,60.0,2,2025-08-15 16:41:32,oti_roster_turnover_detailed.csv,2025-08-17 08:45:20,32
OTI,2011,2012,WR,6,7,4,2,3,66.67,33.33,42.86,1,2025-08-15 16:41:32,oti_roster_turnover_detailed.csv,2025-08-17 08:45:20,32
OTI,2012,2013,DB,8,9,3,5,6,37.5,62.5,66.67,1,2025-08-15 16:41:32,oti_roster_turnover_detailed.csv,2025-08-17 08:45:20,32
OTI,2012,2013,DL,7,5,3,4,2,42.86,57.14,40.0,-2,2025-08-15 16:41:32,oti_roster_turnover_detailed.csv,2025-08-17 08:45:20,32
OTI,2012,2013,LB,6,5,3,3,2,50.0,50.0,40.0,-1,2025-08-15 16:41:32,oti_roster_turnover_detailed.csv,2025-08-17 08:45:20,32
OTI,2012,2013,OL,7,5,2,5,3,28.57,71.43,60.0,-2,2025-08-15 16:41:32,oti_roster_turnover_detailed.csv,2025-08-17 08:45:20,32
OTI,2012,2013,OTHER,13,13,8,5,5,61.54,38.46,38.46,0,2025-08-15 16:41:32,oti_roster_turnover_detailed.csv,2025-08-17 08:45:20,32
OTI,2012,2013,QB,3,2,1,2,1,33.33,66.67,50.0,-1,2025-08-15 16:41:32,oti_roster_turnover_detailed.csv,2025-08-17 08:45:20,32
OTI,2012,2013,RB,6,6,3,3,3,50.0,50.0,50.0,0,2025-08-15 16:41:32,oti_roster_turnover_detailed.csv,2025-08-17 08:45:20,32
OTI,2012,2013,ST,2,2,2,0,0,100.0,0.0,0.0,0,2025-08-15 16:41:32,oti_roster_turnover_detailed.csv,2025-08-17 08:45:20,32
OTI,2012,2013,TE,5,5,3,2,2,60.0,40.0,40.0,0,2025-08-15 16:41:32,oti_roster_turnover_detailed.csv,2025-08-17 08:45:20,32
OTI,2012,2013,WR,7,9,6,1,3,85.71,14.29,33.33,2,2025-08-15 16:41:32,oti_roster_turnover_detailed.csv,2025-08-17 08:45:20,32
OTI,2013,2014,DB,9,9,3,6,6,33.33,66.67,66.67,0,2025-08-15 16:41:32,oti_roster_turnover_detailed.csv,2025-08-17 08:45:20,32
OTI,2013,2014,DL,5,7,2,3,5,40.0,60.0,71.43,2,2025-08-15 16:41:32,oti_roster_turnover_detailed.csv,2025-08-17 08:45:20,32
OTI,2013,2014,LB,5,7,1,4,6,20.0,80.0,85.71,2,2025-08-15 16:41:32,oti_roster_turnover_detailed.csv,2025-08-17 08:45:20,32
OTI,2013,2014,OL,5,6,2,3,4,40.0,60.0,66.67,1,2025-08-15 16:41:32,oti_roster_turnover_detailed.csv,2025-08-17 08:45:20,32
OTI,2013,2014,OTHER,13,15,7,6,8,53.85,46.15,53.33,2,2025-08-15 16:41:32,oti_roster_turnover_detailed.csv,2025-08-17 08:45:20,32
OTI,2013,2014,QB,2,4,1,1,3,50.0,50.0,75.0,2,2025-08-15 16:41:32,oti_roster_turnover_detailed.csv,2025-08-17 08:45:20,32
OTI,2013,2014,RB,6,5,3,3,2,50.0,50.0,40.0,-1,2025-08-15 16:41:32,oti_roster_turnover_detailed.csv,2025-08-17 08:45:20,32
OTI,2013,2014,ST,2,2,1,1,1,50.0,50.0,50.0,0,2025-08-15 16:41:32,oti_roster_turnover_detailed.csv,2025-08-17 08:45:20,32
OTI,2013,2014,TE,5,8,4,1,4,80.0,20.0,50.0,3,2025-08-15 16:41:32,oti_roster_turnover_detailed.csv,2025-08-17 08:45:20,32
OTI,2013,2014,WR,9,7,3,6,4,33.33,66.67,57.14,-2,2025-08-15 16:41:32,oti_roster_turnover_detailed.csv,2025-08-17 08:45:20,32
OTI,2014,2015,DB,9,9,3,6,6,33.33,66.67,66.67,0,2025-08-15 16:41:32,oti_roster_turnover_detailed.csv,2025-08-17 08:45:20,32
OTI,2014,2015,DL,7,7,5,2,2,71.43,28.57,28.57,0,2025-08-15 16:41:32,oti_roster_turnover_detailed.csv,2025-08-17 08:45:20,32
OTI,2014,2015,LB,7,4,0,7,4,0.0,100.0,100.0,-3,2025-08-15 16:41:32,oti_roster_turnover_detailed.csv,2025-08-17 08:45:20,32
OTI,2014,2015,OL,6,4,2,4,2,33.33,66.67,50.0,-2,2025-08-15 16:41:32,oti_roster_turnover_detailed.csv,2025-08-17 08:45:20,32
OTI,2014,2015,OTHER,15,15,7,8,8,46.67,53.33,53.33,0,2025-08-15 16:41:32,oti_roster_turnover_detailed.csv,2025-08-17 08:45:20,32
OTI,2014,2015,QB,4,3,1,3,2,25.0,75.0,66.67,-1,2025-08-15 16:41:32,oti_roster_turnover_detailed.csv,2025-08-17 08:45:20,32
OTI,2014,2015,RB,5,5,2,3,3,40.0,60.0,60.0,0,2025-08-15 16:41:32,oti_roster_turnover_detailed.csv,2025-08-17 08:45:20,32
OTI,2014,2015,ST,2,2,2,0,0,100.0,0.0,0.0,0,2025-08-15 16:41:32,oti_roster_turnover_detailed.csv,2025-08-17 08:45:20,32
OTI,2014,2015,TE,8,6,4,4,2,50.0,50.0,33.33,-2,2025-08-15 16:41:32,oti_roster_turnover_detailed.csv,2025-08-17 08:45:20,32
OTI,2014,2015,WR,7,8,4,3,4,57.14,42.86,50.0,1,2025-08-15 16:41:32,oti_roster_turnover_detailed.csv,2025-08-17 08:45:20,32
OTI,2015,2016,DB,9,11,3,6,8,33.33,66.67,72.73,2,2025-08-15 16:41:32,oti_roster_turnover_detailed.csv,2025-08-17 08:45:20,32
OTI,2015,2016,DL,7,9,4,3,5,57.14,42.86,55.56,2,2025-08-15 16:41:32,oti_roster_turnover_detailed.csv,2025-08-17 08:45:20,32
OTI,2015,2016,LB,4,2,0,4,2,0.0,100.0,100.0,-2,2025-08-15 16:41:32,oti_roster_turnover_detailed.csv,2025-08-17 08:45:20,32
OTI,2015,2016,OL,4,5,1,3,4,25.0,75.0,80.0,1,2025-08-15 16:41:32,oti_roster_turnover_detailed.csv,2025-08-17 08:45:20,32
OTI,2015,2016,OTHER,15,13,9,6,4,60.0,40.0,30.77,-2,2025-08-15 16:41:32,oti_roster_turnover_detailed.csv,2025-08-17 08:45:20,32
OTI,2015,2016,QB,3,2,1,2,1,33.33,66.67,50.0,-1,2025-08-15 16:41:32,oti_roster_turnover_detailed.csv,2025-08-17 08:45:20,32
OTI,2015,2016,RB,5,4,2,3,2,40.0,60.0,50.0,-1,2025-08-15 16:41:32,oti_roster_turnover_detailed.csv,2025-08-17 08:45:20,32
OTI,2015,2016,ST,2,2,2,0,0,100.0,0.0,0.0,0,2025-08-15 16:41:32,oti_roster_turnover_detailed.csv,2025-08-17 08:45:20,32
OTI,2015,2016,TE,6,5,4,2,1,66.67,33.33,20.0,-1,2025-08-15 16:41:32,oti_roster_turnover_detailed.csv,2025-08-17 08:45:20,32
OTI,2015,2016,WR,8,7,3,5,4,37.5,62.5,57.14,-1,2025-08-15 16:41:32,oti_roster_turnover_detailed.csv,2025-08-17 08:45:20,32
OTI,2016,2017,DB,11,9,6,5,3,54.55,45.45,33.33,-2,2025-08-15 16:41:32,oti_roster_turnover_detailed.csv,2025-08-17 08:45:20,32
OTI,2016,2017,DL,9,5,3,6,2,33.33,66.67,40.0,-4,2025-08-15 16:41:32,oti_roster_turnover_detailed.csv,2025-08-17 08:45:20,32
OTI,2016,2017,LB,2,6,2,0,4,100.0,0.0,66.67,4,2025-08-15 16:41:32,oti_roster_turnover_detailed.csv,2025-08-17 08:45:20,32
OTI,2016,2017,OL,5,3,3,2,0,60.0,40.0,0.0,-2,2025-08-15 16:41:32,oti_roster_turnover_detailed.csv,2025-08-17 08:45:20,32
OTI,2016,2017,OTHER,13,12,10,3,2,76.92,23.08,16.67,-1,2025-08-15 16:41:32,oti_roster_turnover_detailed.csv,2025-08-17 08:45:20,32
OTI,2016,2017,QB,2,2,2,0,0,100.0,0.0,0.0,0,2025-08-15 16:41:32,oti_roster_turnover_detailed.csv,2025-08-17 08:45:20,32
OTI,2016,2017,RB,4,4,3,1,1,75.0,25.0,25.0,0,2025-08-15 16:41:32,oti_roster_turnover_detailed.csv,2025-08-17 08:45:20,32
OTI,2016,2017,ST,2,2,2,0,0,100.0,0.0,0.0,0,2025-08-15 16:41:32,oti_roster_turnover_detailed.csv,2025-08-17 08:45:20,32
OTI,2016,2017,TE,5,5,3,2,2,60.0,40.0,40.0,0,2025-08-15 16:41:32,oti_roster_turnover_detailed.csv,2025-08-17 08:45:20,32
OTI,2016,2017,WR,7,6,2,5,4,28.57,71.43,66.67,-1,2025-08-15 16:41:32,oti_roster_turnover_detailed.csv,2025-08-17 08:45:20,32
OTI,2017,2018,DB,9,9,3,6,6,33.33,66.67,66.67,0,2025-08-15 16:41:32,oti_roster_turnover_detailed.csv,2025-08-17 08:45:20,32
OTI,2017,2018,DL,5,4,1,4,3,20.0,80.0,75.0,-1,2025-08-15 16:41:32,oti_roster_turnover_detailed.csv,2025-08-17 08:45:20,32
OTI,2017,2018,LB,6,8,2,4,6,33.33,66.67,75.0,2,2025-08-15 16:41:32,oti_roster_turnover_detailed.csv,2025-08-17 08:45:20,32
OTI,2017,2018,OL,3,6,1,2,5,33.33,66.67,83.33,3,2025-08-15 16:41:32,oti_roster_turnover_detailed.csv,2025-08-17 08:45:20,32
OTI,2017,2018,OTHER,12,14,11,1,3,91.67,8.33,21.43,2,2025-08-15 16:41:32,oti_roster_turnover_detailed.csv,2025-08-17 08:45:20,32
OTI,2017,2018,QB,2,2,1,1,1,50.0,50.0,50.0,0,2025-08-15 16:41:32,oti_roster_turnover_detailed.csv,2025-08-17 08:45:20,32
OTI,2017,2018,RB,4,5,2,2,3,50.0,50.0,60.0,1,2025-08-15 16:41:32,oti_roster_turnover_detailed.csv,2025-08-17 08:45:20,32
OTI,2017,2018,ST,2,2,2,0,0,100.0,0.0,0.0,0,2025-08-15 16:41:32,oti_roster_turnover_detailed.csv,2025-08-17 08:45:20,32
OTI,2017,2018,TE,5,5,4,1,1,80.0,20.0,20.0,0,2025-08-15 16:41:32,oti_roster_turnover_detailed.csv,2025-08-17 08:45:20,32
OTI,2017,2018,WR,6,7,3,3,4,50.0,50.0,57.14,1,2025-08-15 16:41:32,oti_roster_turnover_detailed.csv,2025-08-17 08:45:20,32
OTI,2018,2019,DB,9,10,5,4,5,55.56,44.44,50.0,1,2025-08-15 16:41:32,oti_roster_turnover_detailed.csv,2025-08-17 08:45:20,32
OTI,2018,2019,DL,4,7,2,2,5,50.0,50.0,71.43,3,2025-08-15 16:41:32,oti_roster_turnover_detailed.csv,2025-08-17 08:45:20,32
OTI,2018,2019,LB,8,6,3,5,3,37.5,62.5,50.0,-2,2025-08-15 16:41:32,oti_roster_turnover_detailed.csv,2025-08-17 08:45:20,32
OTI,2018,2019,OL,6,4,2,4,2,33.33,66.67,50.0,-2,2025-08-15 16:41:32,oti_roster_turnover_detailed.csv,2025-08-17 08:45:20,32
OTI,2018,2019,OTHER,14,15,7,7,8,50.0,50.0,53.33,1,2025-08-15 16:41:32,oti_roster_turnover_detailed.csv,2025-08-17 08:45:20,32
OTI,2018,2019,QB,2,2,1,1,1,50.0,50.0,50.0,0,2025-08-15 16:41:32,oti_roster_turnover_detailed.csv,2025-08-17 08:45:20,32
OTI,2018,2019,RB,5,7,5,0,2,100.0,0.0,28.57,2,2025-08-15 16:41:32,oti_roster_turnover_detailed.csv,2025-08-17 08:45:20,32
OTI,2018,2019,ST,2,6,2,0,4,100.0,0.0,66.67,4,2025-08-15 16:41:32,oti_roster_turnover_detailed.csv,2025-08-17 08:45:20,32
OTI,2018,2019,TE,5,5,4,1,1,80.0,20.0,20.0,0,2025-08-15 16:41:32,oti_roster_turnover_detailed.csv,2025-08-17 08:45:20,32
OTI,2018,2019,WR,7,7,2,5,5,28.57,71.43,71.43,0,2025-08-15 16:41:32,oti_roster_turnover_detailed.csv,2025-08-17 08:45:20,32
OTI,2019,2020,DB,10,11,8,2,3,80.0,20.0,27.27,1,2025-08-15 16:41:32,oti_roster_turnover_detailed.csv,2025-08-17 08:45:20,32
OTI,2019,2020,DL,7,9,4,3,5,57.14,42.86,55.56,2,2025-08-15 16:41:32,oti_roster_turnover_detailed.csv,2025-08-17 08:45:20,32
OTI,2019,2020,LB,6,7,1,5,6,16.67,83.33,85.71,1,2025-08-15 16:41:32,oti_roster_turnover_detailed.csv,2025-08-17 08:45:20,32
OTI,2019,2020,OL,4,6,1,3,5,25.0,75.0,83.33,2,2025-08-15 16:41:32,oti_roster_turnover_detailed.csv,2025-08-17 08:45:20,32
OTI,2019,2020,OTHER,15,15,7,8,8,46.67,53.33,53.33,0,2025-08-15 16:41:32,oti_roster_turnover_detailed.csv,2025-08-17 08:45:20,32
OTI,2019,2020,QB,2,2,1,1,1,50.0,50.0,50.0,0,2025-08-15 16:41:32,oti_roster_turnover_detailed.csv,2025-08-17 08:45:20,32
OTI,2019,2020,RB,7,7,3,4,4,42.86,57.14,57.14,0,2025-08-15 16:41:32,oti_roster_turnover_detailed.csv,2025-08-17 08:45:20,32
OTI,2019,2020,ST,6,6,1,5,5,16.67,83.33,83.33,0,2025-08-15 16:41:32,oti_roster_turnover_detailed.csv,2025-08-17 08:45:20,32
OTI,2019,2020,TE,5,3,3,2,0,60.0,40.0,0.0,-2,2025-08-15 16:41:32,oti_roster_turnover_detailed.csv,2025-08-17 08:45:20,32
OTI,2019,2020,WR,7,8,4,3,4,57.14,42.86,50.0,1,2025-08-15 16:41:32,oti_roster_turnover_detailed.csv,2025-08-17 08:45:20,32
OTI,2020,2021,DB,11,14,4,7,10,36.36,63.64,71.43,3,2025-08-15 16:41:32,oti_roster_turnover_detailed.csv,2025-08-17 08:45:20,32
OTI,2020,2021,DL,9,14,4,5,10,44.44,55.56,71.43,5,2025-08-15 16:41:32,oti_roster_turnover_detailed.csv,2025-08-17 08:45:20,32
OTI,2020,2021,LB,7,9,1,6,8,14.29,85.71,88.89,2,2025-08-15 16:41:32,oti_roster_turnover_detailed.csv,2025-08-17 08:45:20,32
OTI,2020,2021,OL,6,8,2,4,6,33.33,66.67,75.0,2,2025-08-15 16:41:32,oti_roster_turnover_detailed.csv,2025-08-17 08:45:20,32
OTI,2020,2021,OTHER,15,12,8,7,4,53.33,46.67,33.33,-3,2025-08-15 16:41:32,oti_roster_turnover_detailed.csv,2025-08-17 08:45:20,32
OTI,2020,2021,QB,2,3,2,0,1,100.0,0.0,33.33,1,2025-08-15 16:41:32,oti_roster_turnover_detailed.csv,2025-08-17 08:45:20,32
OTI,2020,2021,RB,7,11,6,1,5,85.71,14.29,45.45,4,2025-08-15 16:41:32,oti_roster_turnover_detailed.csv,2025-08-17 08:45:20,32
OTI,2020,2021,ST,6,5,1,5,4,16.67,83.33,80.0,-1,2025-08-15 16:41:32,oti_roster_turnover_detailed.csv,2025-08-17 08:45:20,32
OTI,2020,2021,TE,3,4,1,2,3,33.33,66.67,75.0,1,2025-08-15 16:41:32,oti_roster_turnover_detailed.csv,2025-08-17 08:45:20,32
OTI,2020,2021,WR,8,11,4,4,7,50.0,50.0,63.64,3,2025-08-15 16:41:32,oti_roster_turnover_detailed.csv,2025-08-17 08:45:20,32
OTI,2021,2022,DB,14,15,6,8,9,42.86,57.14,60.0,1,2025-08-15 16:41:32,oti_roster_turnover_detailed.csv,2025-08-17 08:45:20,32
OTI,2021,2022,DL,14,11,6,8,5,42.86,57.14,45.45,-3,2025-08-15 16:41:32,oti_roster_turnover_detailed.csv,2025-08-17 08:45:20,32
OTI,2021,2022,LB,9,9,2,7,7,22.22,77.78,77.78,0,2025-08-15 16:41:32,oti_roster_turnover_detailed.csv,2025-08-17 08:45:20,32
OTI,2021,2022,OL,8,9,3,5,6,37.5,62.5,66.67,1,2025-08-15 16:41:32,oti_roster_turnover_detailed.csv,2025-08-17 08:45:20,32
OTI,2021,2022,OTHER,12,12,4,8,8,33.33,66.67,66.67,0,2025-08-15 16:41:32,oti_roster_turnover_detailed.csv,2025-08-17 08:45:20,32
OTI,2021,2022,QB,3,3,1,2,2,33.33,66.67,66.67,0,2025-08-15 16:41:32,oti_roster_turnover_detailed.csv,2025-08-17 08:45:20,32
OTI,2021,2022,RB,11,7,3,8,4,27.27,72.73,57.14,-4,2025-08-15 16:41:32,oti_roster_turnover_detailed.csv,2025-08-17 08:45:20,32
OTI,2021,2022,ST,5,5,2,3,3,40.0,60.0,60.0,0,2025-08-15 16:41:32,oti_roster_turnover_detailed.csv,2025-08-17 08:45:20,32
OTI,2021,2022,TE,4,4,1,3,3,25.0,75.0,75.0,0,2025-08-15 16:41:32,oti_roster_turnover_detailed.csv,2025-08-17 08:45:20,32
OTI,2021,2022,WR,11,11,5,6,6,45.45,54.55,54.55,0,2025-08-15 16:41:32,oti_roster_turnover_detailed.csv,2025-08-17 08:45:20,32
OTI,2022,2023,DB,15,17,4,11,13,26.67,73.33,76.47,2,2025-08-15 16:41:32,oti_roster_turnover_detailed.csv,2025-08-17 08:45:20,32
OTI,2022,2023,DL,11,11,3,8,8,27.27,72.73,72.73,0,2025-08-15 16:41:32,oti_roster_turnover_detailed.csv,2025-08-17 08:45:20,32
OTI,2022,2023,LB,9,14,3,6,11,33.33,66.67,78.57,5,2025-08-15 16:41:32,oti_roster_turnover_detailed.csv,2025-08-17 08:45:20,32
OTI,2022,2023,OL,9,14,3,6,11,33.33,66.67,78.57,5,2025-08-15 16:41:32,oti_roster_turnover_detailed.csv,2025-08-17 08:45:20,32
OTI,2022,2023,OTHER,12,4,0,12,4,0.0,100.0,100.0,-8,2025-08-15 16:41:32,oti_roster_turnover_detailed.csv,2025-08-17 08:45:20,32
OTI,2022,2023,QB,3,3,2,1,1,66.67,33.33,33.33,0,2025-08-15 16:41:32,oti_roster_turnover_detailed.csv,2025-08-17 08:45:20,32
OTI,2022,2023,RB,7,4,3,4,1,42.86,57.14,25.0,-3,2025-08-15 16:41:32,oti_roster_turnover_detailed.csv,2025-08-17 08:45:20,32
OTI,2022,2023,ST,5,4,2,3,2,40.0,60.0,50.0,-1,2025-08-15 16:41:32,oti_roster_turnover_detailed.csv,2025-08-17 08:45:20,32
OTI,2022,2023,TE,4,4,2,2,2,50.0,50.0,50.0,0,2025-08-15 16:41:32,oti_roster_turnover_detailed.csv,2025-08-17 08:45:20,32
OTI,2022,2023,WR,11,8,4,7,4,36.36,63.64,50.0,-3,2025-08-15 16:41:32,oti_roster_turnover_detailed.csv,2025-08-17 08:45:20,32
OTI,2023,2024,DB,17,14,4,13,10,23.53,76.47,71.43,-3,2025-08-15 16:41:32,oti_roster_turnover_detailed.csv,2025-08-17 08:45:20,32
OTI,2023,2024,DL,11,5,2,9,3,18.18,81.82,60.0,-6,2025-08-15 16:41:32,oti_roster_turnover_detailed.csv,2025-08-17 08:45:20,32
OTI,2023,2024,LB,14,11,4,10,7,28.57,71.43,63.64,-3,2025-08-15 16:41:32,oti_roster_turnover_detailed.csv,2025-08-17 08:45:20,32
OTI,2023,2024,OL,14,11,5,9,6,35.71,64.29,54.55,-3,2025-08-15 16:41:32,oti_roster_turnover_detailed.csv,2025-08-17 08:45:20,32
OTI,2023,2024,OTHER,4,11,0,4,11,0.0,100.0,100.0,7,2025-08-15 16:41:32,oti_roster_turnover_detailed.csv,2025-08-17 08:45:20,32
OTI,2023,2024,QB,3,2,1,2,1,33.33,66.67,50.0,-1,2025-08-15 16:41:32,oti_roster_turnover_detailed.csv,2025-08-17 08:45:20,32
OTI,2023,2024,RB,4,4,2,2,2,50.0,50.0,50.0,0,2025-08-15 16:41:32,oti_roster_turnover_detailed.csv,2025-08-17 08:45:20,32
OTI,2023,2024,ST,4,5,3,1,2,75.0,25.0,40.0,1,2025-08-15 16:41:32,oti_roster_turnover_detailed.csv,2025-08-17 08:45:20,32
OTI,2023,2024,TE,4,5,2,2,3,50.0,50.0,60.0,1,2025-08-15 16:41:32,oti_roster_turnover_detailed.csv,2025-08-17 08:45:20,32
OTI,2023,2024,WR,8,9,4,4,5,50.0,50.0,55.56,1,2025-08-15 16:41:32,oti_roster_turnover_detailed.csv,2025-08-17 08:45:20,32
PHI,2011,2012,DB,10,8,6,4,2,60.0,40.0,25.0,-2,2025-08-15 16:41:30,phi_roster_turnover_detailed.csv,2025-08-17 08:45:20,32
PHI,2011,2012,DL,7,6,3,4,3,42.86,57.14,50.0,-1,2025-08-15 16:41:30,phi_roster_turnover_detailed.csv,2025-08-17 08:45:20,32
PHI,2011,2012,LB,3,6,1,2,5,33.33,66.67,83.33,3,2025-08-15 16:41:30,phi_roster_turnover_detailed.csv,2025-08-17 08:45:20,32
PHI,2011,2012,OL,6,4,1,5,3,16.67,83.33,75.0,-2,2025-08-15 16:41:30,phi_roster_turnover_detailed.csv,2025-08-17 08:45:20,32
PHI,2011,2012,OTHER,13,18,8,5,10,61.54,38.46,55.56,5,2025-08-15 16:41:30,phi_roster_turnover_detailed.csv,2025-08-17 08:45:20,32
PHI,2011,2012,QB,3,3,1,2,2,33.33,66.67,66.67,0,2025-08-15 16:41:30,phi_roster_turnover_detailed.csv,2025-08-17 08:45:20,32
PHI,2011,2012,RB,4,5,2,2,3,50.0,50.0,60.0,1,2025-08-15 16:41:30,phi_roster_turnover_detailed.csv,2025-08-17 08:45:20,32
PHI,2011,2012,ST,3,4,3,0,1,100.0,0.0,25.0,1,2025-08-15 16:41:30,phi_roster_turnover_detailed.csv,2025-08-17 08:45:20,32
PHI,2011,2012,TE,2,3,2,0,1,100.0,0.0,33.33,1,2025-08-15 16:41:30,phi_roster_turnover_detailed.csv,2025-08-17 08:45:20,32
PHI,2011,2012,WR,6,8,4,2,4,66.67,33.33,50.0,2,2025-08-15 16:41:30,phi_roster_turnover_detailed.csv,2025-08-17 08:45:20,32
PHI,2012,2013,DB,8,12,6,2,6,75.0,25.0,50.0,4,2025-08-15 16:41:30,phi_roster_turnover_detailed.csv,2025-08-17 08:45:20,32
PHI,2012,2013,DL,6,6,1,5,5,16.67,83.33,83.33,0,2025-08-15 16:41:30,phi_roster_turnover_detailed.csv,2025-08-17 08:45:20,32
PHI,2012,2013,LB,6,4,1,5,3,16.67,83.33,75.0,-2,2025-08-15 16:41:30,phi_roster_turnover_detailed.csv,2025-08-17 08:45:20,32
PHI,2012,2013,OL,4,4,1,3,3,25.0,75.0,75.0,0,2025-08-15 16:41:30,phi_roster_turnover_detailed.csv,2025-08-17 08:45:20,32
PHI,2012,2013,OTHER,18,12,5,13,7,27.78,72.22,58.33,-6,2025-08-15 16:41:30,phi_roster_turnover_detailed.csv,2025-08-17 08:45:20,32
PHI,2012,2013,QB,3,3,2,1,1,66.67,33.33,33.33,0,2025-08-15 16:41:30,phi_roster_turnover_detailed.csv,2025-08-17 08:45:20,32
PHI,2012,2013,RB,5,4,3,2,1,60.0,40.0,25.0,-1,2025-08-15 16:41:30,phi_roster_turnover_detailed.csv,2025-08-17 08:45:20,32
PHI,2012,2013,ST,4,3,2,2,1,50.0,50.0,33.33,-1,2025-08-15 16:41:30,phi_roster_turnover_detailed.csv,2025-08-17 08:45:20,32
PHI,2012,2013,TE,3,3,1,2,2,33.33,66.67,66.67,0,2025-08-15 16:41:30,phi_roster_turnover_detailed.csv,2025-08-17 08:45:20,32
PHI,2012,2013,WR,8,7,4,4,3,50.0,50.0,42.86,-1,2025-08-15 16:41:30,phi_roster_turnover_detailed.csv,2025-08-17 08:45:20,32
PHI,2013,2014,DB,12,8,3,9,5,25.0,75.0,62.5,-4,2025-08-15 16:41:30,phi_roster_turnover_detailed.csv,2025-08-17 08:45:20,32
PHI,2013,2014,DL,6,5,3,3,2,50.0,50.0,40.0,-1,2025-08-15 16:41:30,phi_roster_turnover_detailed.csv,2025-08-17 08:45:20,32
PHI,2013,2014,LB,4,4,2,2,2,50.0,50.0,50.0,0,2025-08-15 16:41:30,phi_roster_turnover_detailed.csv,2025-08-17 08:45:20,32
PHI,2013,2014,OL,4,6,3,1,3,75.0,25.0,50.0,2,2025-08-15 16:41:30,phi_roster_turnover_detailed.csv,2025-08-17 08:45:20,32
PHI,2013,2014,OTHER,12,15,12,0,3,100.0,0.0,20.0,3,2025-08-15 16:41:30,phi_roster_turnover_detailed.csv,2025-08-17 08:45:20,32
PHI,2013,2014,QB,3,3,2,1,1,66.67,33.33,33.33,0,2025-08-15 16:41:30,phi_roster_turnover_detailed.csv,2025-08-17 08:45:20,32
PHI,2013,2014,RB,4,3,2,2,1,50.0,50.0,33.33,-1,2025-08-15 16:41:30,phi_roster_turnover_detailed.csv,2025-08-17 08:45:20,32
PHI,2013,2014,ST,3,3,2,1,1,66.67,33.33,33.33,0,2025-08-15 16:41:30,phi_roster_turnover_detailed.csv,2025-08-17 08:45:20,32
PHI,2013,2014,TE,3,4,3,0,1,100.0,0.0,25.0,1,2025-08-15 16:41:30,phi_roster_turnover_detailed.csv,2025-08-17 08:45:20,32
PHI,2013,2014,WR,7,6,3,4,3,42.86,57.14,50.0,-1,2025-08-15 16:41:30,phi_roster_turnover_detailed.csv,2025-08-17 08:45:20,32
PHI,2014,2015,DB,8,9,3,5,6,37.5,62.5,66.67,1,2025-08-15 16:41:30,phi_roster_turnover_detailed.csv,2025-08-17 08:45:20,32
PHI,2014,2015,DL,5,5,4,1,1,80.0,20.0,20.0,0,2025-08-15 16:41:30,phi_roster_turnover_detailed.csv,2025-08-17 08:45:20,32
PHI,2014,2015,LB,4,5,3,1,2,75.0,25.0,40.0,1,2025-08-15 16:41:30,phi_roster_turnover_detailed.csv,2025-08-17 08:45:20,32
PHI,2014,2015,OL,6,6,4,2,2,66.67,33.33,33.33,0,2025-08-15 16:41:30,phi_roster_turnover_detailed.csv,2025-08-17 08:45:20,32
PHI,2014,2015,OTHER,15,14,8,7,6,53.33,46.67,42.86,-1,2025-08-15 16:41:30,phi_roster_turnover_detailed.csv,2025-08-17 08:45:20,32
PHI,2014,2015,QB,3,2,1,2,1,33.33,66.67,50.0,-1,2025-08-15 16:41:30,phi_roster_turnover_detailed.csv,2025-08-17 08:45:20,32
PHI,2014,2015,RB,3,4,1,2,3,33.33,66.67,75.0,1,2025-08-15 16:41:30,phi_roster_turnover_detailed.csv,2025-08-17 08:45:20,32
PHI,2014,2015,ST,3,4,3,0,1,100.0,0.0,25.0,1,2025-08-15 16:41:30,phi_roster_turnover_detailed.csv,2025-08-17 08:45:20,32
PHI,2014,2015,TE,4,3,3,1,0,75.0,25.0,0.0,-1,2025-08-15 16:41:30,phi_roster_turnover_detailed.csv,2025-08-17 08:45:20,32
PHI,2014,2015,WR,6,7,3,3,4,50.0,50.0,57.14,1,2025-08-15 16:41:30,phi_roster_turnover_detailed.csv,2025-08-17 08:45:20,32
PHI,2015,2016,DB,9,9,3,6,6,33.33,66.67,66.67,0,2025-08-15 16:41:30,phi_roster_turnover_detailed.csv,2025-08-17 08:45:20,32
PHI,2015,2016,DL,5,4,2,3,2,40.0,60.0,50.0,-1,2025-08-15 16:41:30,phi_roster_turnover_detailed.csv,2025-08-17 08:45:20,32
PHI,2015,2016,LB,5,6,3,2,3,60.0,40.0,50.0,1,2025-08-15 16:41:30,phi_roster_turnover_detailed.csv,2025-08-17 08:45:20,32
PHI,2015,2016,OL,6,4,2,4,2,33.33,66.67,50.0,-2,2025-08-15 16:41:30,phi_roster_turnover_detailed.csv,2025-08-17 08:45:20,32
PHI,2015,2016,OTHER,14,14,8,6,6,57.14,42.86,42.86,0,2025-08-15 16:41:30,phi_roster_turnover_detailed.csv,2025-08-17 08:45:20,32
PHI,2015,2016,QB,2,2,0,2,2,0.0,100.0,100.0,0,2025-08-15 16:41:30,phi_roster_turnover_detailed.csv,2025-08-17 08:45:20,32
PHI,2015,2016,RB,4,6,3,1,3,75.0,25.0,50.0,2,2025-08-15 16:41:30,phi_roster_turnover_detailed.csv,2025-08-17 08:45:20,32
PHI,2015,2016,ST,4,4,3,1,1,75.0,25.0,25.0,0,2025-08-15 16:41:30,phi_roster_turnover_detailed.csv,2025-08-17 08:45:20,32
PHI,2015,2016,TE,3,4,3,0,1,100.0,0.0,25.0,1,2025-08-15 16:41:30,phi_roster_turnover_detailed.csv,2025-08-17 08:45:20,32
PHI,2015,2016,WR,7,6,3,4,3,42.86,57.14,50.0,-1,2025-08-15 16:41:30,phi_roster_turnover_detailed.csv,2025-08-17 08:45:20,32
PHI,2016,2017,DB,9,9,4,5,5,44.44,55.56,55.56,0,2025-08-15 16:41:30,phi_roster_turnover_detailed.csv,2025-08-17 08:45:20,32
PHI,2016,2017,DL,4,7,3,1,4,75.0,25.0,57.14,3,2025-08-15 16:41:30,phi_roster_turnover_detailed.csv,2025-08-17 08:45:20,32
PHI,2016,2017,LB,6,6,4,2,2,66.67,33.33,33.33,0,2025-08-15 16:41:30,phi_roster_turnover_detailed.csv,2025-08-17 08:45:20,32
PHI,2016,2017,OL,4,4,2,2,2,50.0,50.0,50.0,0,2025-08-15 16:41:30,phi_roster_turnover_detailed.csv,2025-08-17 08:45:20,32
PHI,2016,2017,OTHER,14,15,9,5,6,64.29,35.71,40.0,1,2025-08-15 16:41:30,phi_roster_turnover_detailed.csv,2025-08-17 08:45:20,32
PHI,2016,2017,QB,2,3,1,1,2,50.0,50.0,66.67,1,2025-08-15 16:41:30,phi_roster_turnover_detailed.csv,2025-08-17 08:45:20,32
PHI,2016,2017,RB,6,6,3,3,3,50.0,50.0,50.0,0,2025-08-15 16:41:30,phi_roster_turnover_detailed.csv,2025-08-17 08:45:20,32
PHI,2016,2017,ST,4,4,3,1,1,75.0,25.0,25.0,0,2025-08-15 16:41:30,phi_roster_turnover_detailed.csv,2025-08-17 08:45:20,32
PHI,2016,2017,TE,4,3,3,1,0,75.0,25.0,0.0,-1,2025-08-15 16:41:30,phi_roster_turnover_detailed.csv,2025-08-17 08:45:20,32
PHI,2016,2017,WR,6,6,1,5,5,16.67,83.33,83.33,0,2025-08-15 16:41:30,phi_roster_turnover_detailed.csv,2025-08-17 08:45:20,32
PHI,2017,2018,DB,9,12,6,3,6,66.67,33.33,50.0,3,2025-08-15 16:41:30,phi_roster_turnover_detailed.csv,2025-08-17 08:45:20,32
PHI,2017,2018,DL,7,8,2,5,6,28.57,71.43,75.0,1,2025-08-15 16:41:30,phi_roster_turnover_detailed.csv,2025-08-17 08:45:20,32
PHI,2017,2018,LB,6,4,1,5,3,16.67,83.33,75.0,-2,2025-08-15 16:41:30,phi_roster_turnover_detailed.csv,2025-08-17 08:45:20,32
PHI,2017,2018,OL,4,3,2,2,1,50.0,50.0,33.33,-1,2025-08-15 16:41:30,phi_roster_turnover_detailed.csv,2025-08-17 08:45:20,32
PHI,2017,2018,OTHER,15,16,10,5,6,66.67,33.33,37.5,1,2025-08-15 16:41:30,phi_roster_turnover_detailed.csv,2025-08-17 08:45:20,32
PHI,2017,2018,QB,3,3,3,0,0,100.0,0.0,0.0,0,2025-08-15 16:41:30,phi_roster_turnover_detailed.csv,2025-08-17 08:45:20,32
PHI,2017,2018,RB,6,6,4,2,2,66.67,33.33,33.33,0,2025-08-15 16:41:30,phi_roster_turnover_detailed.csv,2025-08-17 08:45:20,32
PHI,2017,2018,ST,4,3,2,2,1,50.0,50.0,33.33,-1,2025-08-15 16:41:30,phi_roster_turnover_detailed.csv,2025-08-17 08:45:20,32
PHI,2017,2018,TE,3,4,1,2,3,33.33,66.67,75.0,1,2025-08-15 16:41:30,phi_roster_turnover_detailed.csv,2025-08-17 08:45:20,32
PHI,2017,2018,WR,6,9,3,3,6,50.0,50.0,66.67,3,2025-08-15 16:41:30,phi_roster_turnover_detailed.csv,2025-08-17 08:45:20,32
PHI,2018,2019,DB,12,11,4,8,7,33.33,66.67,63.64,-1,2025-08-15 16:41:30,phi_roster_turnover_detailed.csv,2025-08-17 08:45:20,32
PHI,2018,2019,DL,8,9,3,5,6,37.5,62.5,66.67,1,2025-08-15 16:41:30,phi_roster_turnover_detailed.csv,2025-08-17 08:45:20,32
PHI,2018,2019,LB,4,7,0,4,7,0.0,100.0,100.0,3,2025-08-15 16:41:30,phi_roster_turnover_detailed.csv,2025-08-17 08:45:20,32
PHI,2018,2019,OL,3,5,2,1,3,66.67,33.33,60.0,2,2025-08-15 16:41:30,phi_roster_turnover_detailed.csv,2025-08-17 08:45:20,32
PHI,2018,2019,OTHER,16,15,12,4,3,75.0,25.0,20.0,-1,2025-08-15 16:41:30,phi_roster_turnover_detailed.csv,2025-08-17 08:45:20,32
PHI,2018,2019,QB,3,2,1,2,1,33.33,66.67,50.0,-1,2025-08-15 16:41:30,phi_roster_turnover_detailed.csv,2025-08-17 08:45:20,32
PHI,2018,2019,RB,6,6,4,2,2,66.67,33.33,33.33,0,2025-08-15 16:41:30,phi_roster_turnover_detailed.csv,2025-08-17 08:45:20,32
PHI,2018,2019,ST,3,3,3,0,0,100.0,0.0,0.0,0,2025-08-15 16:41:30,phi_roster_turnover_detailed.csv,2025-08-17 08:45:20,32
PHI,2018,2019,TE,4,5,4,0,1,100.0,0.0,20.0,1,2025-08-15 16:41:30,phi_roster_turnover_detailed.csv,2025-08-17 08:45:20,32
PHI,2018,2019,WR,9,10,4,5,6,44.44,55.56,60.0,1,2025-08-15 16:41:30,phi_roster_turnover_detailed.csv,2025-08-17 08:45:20,32
PHI,2019,2020,DB,11,15,5,6,10,45.45,54.55,66.67,4,2025-08-15 16:41:30,phi_roster_turnover_detailed.csv,2025-08-17 08:45:20,32
PHI,2019,2020,DL,9,7,2,7,5,22.22,77.78,71.43,-2,2025-08-15 16:41:30,phi_roster_turnover_detailed.csv,2025-08-17 08:45:20,32
PHI,2019,2020,LB,7,6,2,5,4,28.57,71.43,66.67,-1,2025-08-15 16:41:30,phi_roster_turnover_detailed.csv,2025-08-17 08:45:20,32
PHI,2019,2020,OL,5,8,1,4,7,20.0,80.0,87.5,3,2025-08-15 16:41:30,phi_roster_turnover_detailed.csv,2025-08-17 08:45:20,32
PHI,2019,2020,OTHER,15,17,8,7,9,53.33,46.67,52.94,2,2025-08-15 16:41:30,phi_roster_turnover_detailed.csv,2025-08-17 08:45:20,32
PHI,2019,2020,QB,2,3,1,1,2,50.0,50.0,66.67,1,2025-08-15 16:41:30,phi_roster_turnover_detailed.csv,2025-08-17 08:45:20,32
PHI,2019,2020,RB,6,7,4,2,3,66.67,33.33,42.86,1,2025-08-15 16:41:30,phi_roster_turnover_detailed.csv,2025-08-17 08:45:20,32
PHI,2019,2020,ST,3,3,3,0,0,100.0,0.0,0.0,0,2025-08-15 16:41:30,phi_roster_turnover_detailed.csv,2025-08-17 08:45:20,32
PHI,2019,2020,TE,5,5,3,2,2,60.0,40.0,40.0,0,2025-08-15 16:41:30,phi_roster_turnover_detailed.csv,2025-08-17 08:45:20,32
PHI,2019,2020,WR,10,10,5,5,5,50.0,50.0,50.0,0,2025-08-15 16:41:30,phi_roster_turnover_detailed.csv,2025-08-17 08:45:20,32
PHI,2020,2021,DB,15,13,4,11,9,26.67,73.33,69.23,-2,2025-08-15 16:41:30,phi_roster_turnover_detailed.csv,2025-08-17 08:45:20,32
PHI,2020,2021,DL,7,10,2,5,8,28.57,71.43,80.0,3,2025-08-15 16:41:30,phi_roster_turnover_detailed.csv,2025-08-17 08:45:20,32
PHI,2020,2021,LB,6,5,2,4,3,33.33,66.67,60.0,-1,2025-08-15 16:41:30,phi_roster_turnover_detailed.csv,2025-08-17 08:45:20,32
PHI,2020,2021,OL,8,9,3,5,6,37.5,62.5,66.67,1,2025-08-15 16:41:30,phi_roster_turnover_detailed.csv,2025-08-17 08:45:20,32
PHI,2020,2021,OTHER,17,15,8,9,7,47.06,52.94,46.67,-2,2025-08-15 16:41:30,phi_roster_turnover_detailed.csv,2025-08-17 08:45:20,32
PHI,2020,2021,QB,3,2,1,2,1,33.33,66.67,50.0,-1,2025-08-15 16:41:30,phi_roster_turnover_detailed.csv,2025-08-17 08:45:20,32
PHI,2020,2021,RB,7,5,4,3,1,57.14,42.86,20.0,-2,2025-08-15 16:41:30,phi_roster_turnover_detailed.csv,2025-08-17 08:45:20,32
PHI,2020,2021,ST,3,3,2,1,1,66.67,33.33,33.33,0,2025-08-15 16:41:30,phi_roster_turnover_detailed.csv,2025-08-17 08:45:20,32
PHI,2020,2021,TE,5,6,3,2,3,60.0,40.0,50.0,1,2025-08-15 16:41:30,phi_roster_turnover_detailed.csv,2025-08-17 08:45:20,32
PHI,2020,2021,WR,10,7,5,5,2,50.0,50.0,28.57,-3,2025-08-15 16:41:30,phi_roster_turnover_detailed.csv,2025-08-17 08:45:20,32
PHI,2021,2022,DB,13,10,5,8,5,38.46,61.54,50.0,-3,2025-08-15 16:41:30,phi_roster_turnover_detailed.csv,2025-08-17 08:45:20,32
PHI,2021,2022,DL,10,10,6,4,4,60.0,40.0,40.0,0,2025-08-15 16:41:30,phi_roster_turnover_detailed.csv,2025-08-17 08:45:20,32
PHI,2021,2022,LB,5,4,2,3,2,40.0,60.0,50.0,-1,2025-08-15 16:41:30,phi_roster_turnover_detailed.csv,2025-08-17 08:45:20,32
PHI,2021,2022,OL,9,6,2,7,4,22.22,77.78,66.67,-3,2025-08-15 16:41:30,phi_roster_turnover_detailed.csv,2025-08-17 08:45:20,32
PHI,2021,2022,OTHER,15,12,7,8,5,46.67,53.33,41.67,-3,2025-08-15 16:41:30,phi_roster_turnover_detailed.csv,2025-08-17 08:45:20,32
PHI,2021,2022,QB,2,2,2,0,0,100.0,0.0,0.0,0,2025-08-15 16:41:30,phi_roster_turnover_detailed.csv,2025-08-17 08:45:20,32
PHI,2021,2022,RB,5,4,3,2,1,60.0,40.0,25.0,-1,2025-08-15 16:41:30,phi_roster_turnover_detailed.csv,2025-08-17 08:45:20,32
PHI,2021,2022,ST,3,5,3,0,2,100.0,0.0,40.0,2,2025-08-15 16:41:30,phi_roster_turnover_detailed.csv,2025-08-17 08:45:20,32
PHI,2021,2022,TE,6,5,4,2,1,66.67,33.33,20.0,-1,2025-08-15 16:41:30,phi_roster_turnover_detailed.csv,2025-08-17 08:45:20,32
PHI,2021,2022,WR,7,5,2,5,3,28.57,71.43,60.0,-2,2025-08-15 16:41:30,phi_roster_turnover_detailed.csv,2025-08-17 08:45:20,32
PHI,2022,2023,DB,10,16,4,6,12,40.0,60.0,75.0,6,2025-08-15 16:41:30,phi_roster_turnover_detailed.csv,2025-08-17 08:45:20,32
PHI,2022,2023,DL,10,9,5,5,4,50.0,50.0,44.44,-1,2025-08-15 16:41:30,phi_roster_turnover_detailed.csv,2025-08-17 08:45:20,32
PHI,2022,2023,LB,4,10,2,2,8,50.0,50.0,80.0,6,2025-08-15 16:41:30,phi_roster_turnover_detailed.csv,2025-08-17 08:45:20,32
PHI,2022,2023,OL,6,9,4,2,5,66.67,33.33,55.56,3,2025-08-15 16:41:30,phi_roster_turnover_detailed.csv,2025-08-17 08:45:20,32
PHI,2022,2023,OTHER,12,1,1,11,0,8.33,91.67,0.0,-11,2025-08-15 16:41:30,phi_roster_turnover_detailed.csv,2025-08-17 08:45:20,32
PHI,2022,2023,QB,2,2,1,1,1,50.0,50.0,50.0,0,2025-08-15 16:41:30,phi_roster_turnover_detailed.csv,2025-08-17 08:45:20,32
PHI,2022,2023,RB,4,4,2,2,2,50.0,50.0,50.0,0,2025-08-15 16:41:30,phi_roster_turnover_detailed.csv,2025-08-17 08:45:20,32
PHI,2022,2023,ST,5,4,3,2,1,60.0,40.0,25.0,-1,2025-08-15 16:41:30,phi_roster_turnover_detailed.csv,2025-08-17 08:45:20,32
PHI,2022,2023,TE,5,5,4,1,1,80.0,20.0,20.0,0,2025-08-15 16:41:30,phi_roster_turnover_detailed.csv,2025-08-17 08:45:20,32
PHI,2022,2023,WR,5,7,4,1,3,80.0,20.0,42.86,2,2025-08-15 16:41:30,phi_roster_turnover_detailed.csv,2025-08-17 08:45:20,32
PHI,2023,2024,DB,16,10,6,10,4,37.5,62.5,40.0,-6,2025-08-15 16:41:30,phi_roster_turnover_detailed.csv,2025-08-17 08:45:20,32
PHI,2023,2024,DL,9,6,3,6,3,33.33,66.67,50.0,-3,2025-08-15 16:41:30,phi_roster_turnover_detailed.csv,2025-08-17 08:45:20,32
PHI,2023,2024,LB,10,9,4,6,5,40.0,60.0,55.56,-1,2025-08-15 16:41:30,phi_roster_turnover_detailed.csv,2025-08-17 08:45:20,32
PHI,2023,2024,OL,9,8,4,5,4,44.44,55.56,50.0,-1,2025-08-15 16:41:30,phi_roster_turnover_detailed.csv,2025-08-17 08:45:20,32
PHI,2023,2024,OTHER,1,11,0,1,11,0.0,100.0,100.0,10,2025-08-15 16:41:30,phi_roster_turnover_detailed.csv,2025-08-17 08:45:20,32
PHI,2023,2024,QB,2,3,1,1,2,50.0,50.0,66.67,1,2025-08-15 16:41:30,phi_roster_turnover_detailed.csv,2025-08-17 08:45:20,32
PHI,2023,2024,RB,4,5,1,3,4,25.0,75.0,80.0,1,2025-08-15 16:41:30,phi_roster_turnover_detailed.csv,2025-08-17 08:45:20,32
PHI,2023,2024,ST,4,3,3,1,0,75.0,25.0,0.0,-1,2025-08-15 16:41:30,phi_roster_turnover_detailed.csv,2025-08-17 08:45:20,32
PHI,2023,2024,TE,5,5,3,2,2,60.0,40.0,40.0,0,2025-08-15 16:41:30,phi_roster_turnover_detailed.csv,2025-08-17 08:45:20,32
PHI,2023,2024,WR,7,8,3,4,5,42.86,57.14,62.5,1,2025-08-15 16:41:30,phi_roster_turnover_detailed.csv,2025-08-17 08:45:20,32
PIT,2011,2012,DB,9,10,7,2,3,77.78,22.22,30.0,1,2025-08-15 16:41:31,pit_roster_turnover_detailed.csv,2025-08-17 08:45:20,32
PIT,2011,2012,DL,6,5,3,3,2,50.0,50.0,40.0,-1,2025-08-15 16:41:31,pit_roster_turnover_detailed.csv,2025-08-17 08:45:20,32
PIT,2011,2012,LB,3,5,2,1,3,66.67,33.33,60.0,2,2025-08-15 16:41:31,pit_roster_turnover_detailed.csv,2025-08-17 08:45:20,32
PIT,2011,2012,OL,5,4,1,4,3,20.0,80.0,75.0,-1,2025-08-15 16:41:31,pit_roster_turnover_detailed.csv,2025-08-17 08:45:20,32
PIT,2011,2012,OTHER,16,14,10,6,4,62.5,37.5,28.57,-2,2025-08-15 16:41:31,pit_roster_turnover_detailed.csv,2025-08-17 08:45:20,32
PIT,2011,2012,QB,2,3,2,0,1,100.0,0.0,33.33,1,2025-08-15 16:41:31,pit_roster_turnover_detailed.csv,2025-08-17 08:45:20,32
PIT,2011,2012,RB,6,7,3,3,4,50.0,50.0,57.14,1,2025-08-15 16:41:31,pit_roster_turnover_detailed.csv,2025-08-17 08:45:20,32
PIT,2011,2012,ST,4,3,2,2,1,50.0,50.0,33.33,-1,2025-08-15 16:41:31,pit_roster_turnover_detailed.csv,2025-08-17 08:45:20,32
PIT,2011,2012,TE,2,3,1,1,2,50.0,50.0,66.67,1,2025-08-15 16:41:31,pit_roster_turnover_detailed.csv,2025-08-17 08:45:20,32
PIT,2011,2012,WR,7,6,4,3,2,57.14,42.86,33.33,-1,2025-08-15 16:41:31,pit_roster_turnover_detailed.csv,2025-08-17 08:45:20,32
PIT,2012,2013,DB,10,9,7,3,2,70.0,30.0,22.22,-1,2025-08-15 16:41:31,pit_roster_turnover_detailed.csv,2025-08-17 08:45:20,32
PIT,2012,2013,DL,5,7,2,3,5,40.0,60.0,71.43,2,2025-08-15 16:41:31,pit_roster_turnover_detailed.csv,2025-08-17 08:45:20,32
PIT,2012,2013,LB,5,6,2,3,4,40.0,60.0,66.67,1,2025-08-15 16:41:31,pit_roster_turnover_detailed.csv,2025-08-17 08:45:20,32
PIT,2012,2013,OL,4,3,1,3,2,25.0,75.0,66.67,-1,2025-08-15 16:41:31,pit_roster_turnover_detailed.csv,2025-08-17 08:45:20,32
PIT,2012,2013,OTHER,14,14,8,6,6,57.14,42.86,42.86,0,2025-08-15 16:41:31,pit_roster_turnover_detailed.csv,2025-08-17 08:45:20,32
PIT,2012,2013,QB,3,1,1,2,0,33.33,66.67,0.0,-2,2025-08-15 16:41:31,pit_roster_turnover_detailed.csv,2025-08-17 08:45:20,32
PIT,2012,2013,RB,7,7,3,4,4,42.86,57.14,57.14,0,2025-08-15 16:41:31,pit_roster_turnover_detailed.csv,2025-08-17 08:45:20,32
PIT,2012,2013,ST,3,4,2,1,2,66.67,33.33,50.0,1,2025-08-15 16:41:31,pit_roster_turnover_detailed.csv,2025-08-17 08:45:20,32
PIT,2012,2013,TE,3,5,2,1,3,66.67,33.33,60.0,2,2025-08-15 16:41:31,pit_roster_turnover_detailed.csv,2025-08-17 08:45:20,32
PIT,2012,2013,WR,6,5,3,3,2,50.0,50.0,40.0,-1,2025-08-15 16:41:31,pit_roster_turnover_detailed.csv,2025-08-17 08:45:20,32
PIT,2013,2014,DB,9,9,5,4,4,55.56,44.44,44.44,0,2025-08-15 16:41:31,pit_roster_turnover_detailed.csv,2025-08-17 08:45:20,32
PIT,2013,2014,DL,7,4,1,6,3,14.29,85.71,75.0,-3,2025-08-15 16:41:31,pit_roster_turnover_detailed.csv,2025-08-17 08:45:20,32
PIT,2013,2014,LB,6,4,2,4,2,33.33,66.67,50.0,-2,2025-08-15 16:41:31,pit_roster_turnover_detailed.csv,2025-08-17 08:45:20,32
PIT,2013,2014,OL,3,4,2,1,2,66.67,33.33,50.0,1,2025-08-15 16:41:31,pit_roster_turnover_detailed.csv,2025-08-17 08:45:20,32
PIT,2013,2014,OTHER,14,14,9,5,5,64.29,35.71,35.71,0,2025-08-15 16:41:31,pit_roster_turnover_detailed.csv,2025-08-17 08:45:20,32
PIT,2013,2014,QB,1,2,1,0,1,100.0,0.0,50.0,1,2025-08-15 16:41:31,pit_roster_turnover_detailed.csv,2025-08-17 08:45:20,32
PIT,2013,2014,RB,7,5,2,5,3,28.57,71.43,60.0,-2,2025-08-15 16:41:31,pit_roster_turnover_detailed.csv,2025-08-17 08:45:20,32
PIT,2013,2014,ST,4,3,2,2,1,50.0,50.0,33.33,-1,2025-08-15 16:41:31,pit_roster_turnover_detailed.csv,2025-08-17 08:45:20,32
PIT,2013,2014,TE,5,3,3,2,0,60.0,40.0,0.0,-2,2025-08-15 16:41:31,pit_roster_turnover_detailed.csv,2025-08-17 08:45:20,32
PIT,2013,2014,WR,5,7,2,3,5,40.0,60.0,71.43,2,2025-08-15 16:41:31,pit_roster_turnover_detailed.csv,2025-08-17 08:45:20,32
PIT,2014,2015,DB,9,9,5,4,4,55.56,44.44,44.44,0,2025-08-15 16:41:31,pit_roster_turnover_detailed.csv,2025-08-17 08:45:20,32
PIT,2014,2015,DL,4,5,2,2,3,50.0,50.0,60.0,1,2025-08-15 16:41:31,pit_roster_turnover_detailed.csv,2025-08-17 08:45:20,32
PIT,2014,2015,LB,4,5,3,1,2,75.0,25.0,40.0,1,2025-08-15 16:41:31,pit_roster_turnover_detailed.csv,2025-08-17 08:45:20,32
PIT,2014,2015,OL,4,3,2,2,1,50.0,50.0,33.33,-1,2025-08-15 16:41:31,pit_roster_turnover_detailed.csv,2025-08-17 08:45:20,32
PIT,2014,2015,OTHER,14,14,9,5,5,64.29,35.71,35.71,0,2025-08-15 16:41:31,pit_roster_turnover_detailed.csv,2025-08-17 08:45:20,32
PIT,2014,2015,QB,2,4,1,1,3,50.0,50.0,75.0,2,2025-08-15 16:41:31,pit_roster_turnover_detailed.csv,2025-08-17 08:45:20,32
PIT,2014,2015,RB,5,6,2,3,4,40.0,60.0,66.67,1,2025-08-15 16:41:31,pit_roster_turnover_detailed.csv,2025-08-17 08:45:20,32
PIT,2014,2015,ST,3,4,1,2,3,33.33,66.67,75.0,1,2025-08-15 16:41:31,pit_roster_turnover_detailed.csv,2025-08-17 08:45:20,32
PIT,2014,2015,TE,3,3,2,1,1,66.67,33.33,33.33,0,2025-08-15 16:41:31,pit_roster_turnover_detailed.csv,2025-08-17 08:45:20,32
PIT,2014,2015,WR,7,7,5,2,2,71.43,28.57,28.57,0,2025-08-15 16:41:31,pit_roster_turnover_detailed.csv,2025-08-17 08:45:20,32
PIT,2015,2016,DB,9,7,3,6,4,33.33,66.67,57.14,-2,2025-08-15 16:41:31,pit_roster_turnover_detailed.csv,2025-08-17 08:45:20,32
PIT,2015,2016,DL,5,4,2,3,2,40.0,60.0,50.0,-1,2025-08-15 16:41:31,pit_roster_turnover_detailed.csv,2025-08-17 08:45:20,32
PIT,2015,2016,LB,5,5,2,3,3,40.0,60.0,60.0,0,2025-08-15 16:41:31,pit_roster_turnover_detailed.csv,2025-08-17 08:45:20,32
PIT,2015,2016,OL,3,4,1,2,3,33.33,66.67,75.0,1,2025-08-15 16:41:31,pit_roster_turnover_detailed.csv,2025-08-17 08:45:20,32
PIT,2015,2016,OTHER,14,16,11,3,5,78.57,21.43,31.25,2,2025-08-15 16:41:31,pit_roster_turnover_detailed.csv,2025-08-17 08:45:20,32
PIT,2015,2016,QB,4,2,2,2,0,50.0,50.0,0.0,-2,2025-08-15 16:41:31,pit_roster_turnover_detailed.csv,2025-08-17 08:45:20,32
PIT,2015,2016,RB,6,5,4,2,1,66.67,33.33,20.0,-1,2025-08-15 16:41:31,pit_roster_turnover_detailed.csv,2025-08-17 08:45:20,32
PIT,2015,2016,ST,4,4,3,1,1,75.0,25.0,25.0,0,2025-08-15 16:41:31,pit_roster_turnover_detailed.csv,2025-08-17 08:45:20,32
PIT,2015,2016,TE,3,4,1,2,3,33.33,66.67,75.0,1,2025-08-15 16:41:31,pit_roster_turnover_detailed.csv,2025-08-17 08:45:20,32
PIT,2015,2016,WR,7,7,4,3,3,57.14,42.86,42.86,0,2025-08-15 16:41:31,pit_roster_turnover_detailed.csv,2025-08-17 08:45:20,32
PIT,2016,2017,DB,7,9,3,4,6,42.86,57.14,66.67,2,2025-08-15 16:41:31,pit_roster_turnover_detailed.csv,2025-08-17 08:45:20,32
PIT,2016,2017,DL,4,5,3,1,2,75.0,25.0,40.0,1,2025-08-15 16:41:31,pit_roster_turnover_detailed.csv,2025-08-17 08:45:20,32
PIT,2016,2017,LB,5,6,3,2,3,60.0,40.0,50.0,1,2025-08-15 16:41:31,pit_roster_turnover_detailed.csv,2025-08-17 08:45:20,32
PIT,2016,2017,OL,4,4,2,2,2,50.0,50.0,50.0,0,2025-08-15 16:41:31,pit_roster_turnover_detailed.csv,2025-08-17 08:45:20,32
PIT,2016,2017,OTHER,16,13,8,8,5,50.0,50.0,38.46,-3,2025-08-15 16:41:31,pit_roster_turnover_detailed.csv,2025-08-17 08:45:20,32
PIT,2016,2017,QB,2,2,2,0,0,100.0,0.0,0.0,0,2025-08-15 16:41:31,pit_roster_turnover_detailed.csv,2025-08-17 08:45:20,32
PIT,2016,2017,RB,5,6,3,2,3,60.0,40.0,50.0,1,2025-08-15 16:41:31,pit_roster_turnover_detailed.csv,2025-08-17 08:45:20,32
PIT,2016,2017,ST,4,3,2,2,1,50.0,50.0,33.33,-1,2025-08-15 16:41:31,pit_roster_turnover_detailed.csv,2025-08-17 08:45:20,32
PIT,2016,2017,TE,4,3,2,2,1,50.0,50.0,33.33,-1,2025-08-15 16:41:31,pit_roster_turnover_detailed.csv,2025-08-17 08:45:20,32
PIT,2016,2017,WR,7,6,3,4,3,42.86,57.14,50.0,-1,2025-08-15 16:41:31,pit_roster_turnover_detailed.csv,2025-08-17 08:45:20,32
PIT,2017,2018,DB,9,9,4,5,5,44.44,55.56,55.56,0,2025-08-15 16:41:31,pit_roster_turnover_detailed.csv,2025-08-17 08:45:20,32
PIT,2017,2018,DL,5,6,5,0,1,100.0,0.0,16.67,1,2025-08-15 16:41:31,pit_roster_turnover_detailed.csv,2025-08-17 08:45:20,32
PIT,2017,2018,LB,6,4,2,4,2,33.33,66.67,50.0,-2,2025-08-15 16:41:31,pit_roster_turnover_detailed.csv,2025-08-17 08:45:20,32
PIT,2017,2018,OL,4,3,2,2,1,50.0,50.0,33.33,-1,2025-08-15 16:41:31,pit_roster_turnover_detailed.csv,2025-08-17 08:45:20,32
PIT,2017,2018,OTHER,13,13,10,3,3,76.92,23.08,23.08,0,2025-08-15 16:41:31,pit_roster_turnover_detailed.csv,2025-08-17 08:45:20,32
PIT,2017,2018,QB,2,2,1,1,1,50.0,50.0,50.0,0,2025-08-15 16:41:31,pit_roster_turnover_detailed.csv,2025-08-17 08:45:20,32
PIT,2017,2018,RB,6,5,3,3,2,50.0,50.0,40.0,-1,2025-08-15 16:41:31,pit_roster_turnover_detailed.csv,2025-08-17 08:45:20,32
PIT,2017,2018,ST,3,4,3,0,1,100.0,0.0,25.0,1,2025-08-15 16:41:31,pit_roster_turnover_detailed.csv,2025-08-17 08:45:20,32
PIT,2017,2018,TE,3,3,3,0,0,100.0,0.0,0.0,0,2025-08-15 16:41:31,pit_roster_turnover_detailed.csv,2025-08-17 08:45:20,32
PIT,2017,2018,WR,6,7,5,1,2,83.33,16.67,28.57,1,2025-08-15 16:41:31,pit_roster_turnover_detailed.csv,2025-08-17 08:45:20,32
PIT,2018,2019,DB,9,10,6,3,4,66.67,33.33,40.0,1,2025-08-15 16:41:31,pit_roster_turnover_detailed.csv,2025-08-17 08:45:20,32
PIT,2018,2019,DL,6,5,4,2,1,66.67,33.33,20.0,-1,2025-08-15 16:41:31,pit_roster_turnover_detailed.csv,2025-08-17 08:45:20,32
PIT,2018,2019,LB,4,5,2,2,3,50.0,50.0,60.0,1,2025-08-15 16:41:31,pit_roster_turnover_detailed.csv,2025-08-17 08:45:20,32
PIT,2018,2019,OL,3,4,3,0,1,100.0,0.0,25.0,1,2025-08-15 16:41:31,pit_roster_turnover_detailed.csv,2025-08-17 08:45:20,32
PIT,2018,2019,OTHER,13,13,9,4,4,69.23,30.77,30.77,0,2025-08-15 16:41:31,pit_roster_turnover_detailed.csv,2025-08-17 08:45:20,32
PIT,2018,2019,QB,2,3,1,1,2,50.0,50.0,66.67,1,2025-08-15 16:41:31,pit_roster_turnover_detailed.csv,2025-08-17 08:45:20,32
PIT,2018,2019,RB,5,7,4,1,3,80.0,20.0,42.86,2,2025-08-15 16:41:31,pit_roster_turnover_detailed.csv,2025-08-17 08:45:20,32
PIT,2018,2019,ST,4,3,3,1,0,75.0,25.0,0.0,-1,2025-08-15 16:41:31,pit_roster_turnover_detailed.csv,2025-08-17 08:45:20,32
PIT,2018,2019,TE,3,4,2,1,2,66.67,33.33,50.0,1,2025-08-15 16:41:31,pit_roster_turnover_detailed.csv,2025-08-17 08:45:20,32
PIT,2018,2019,WR,7,8,3,4,5,42.86,57.14,62.5,1,2025-08-15 16:41:31,pit_roster_turnover_detailed.csv,2025-08-17 08:45:20,32
PIT,2019,2020,DB,10,10,8,2,2,80.0,20.0,20.0,0,2025-08-15 16:41:31,pit_roster_turnover_detailed.csv,2025-08-17 08:45:20,32
PIT,2019,2020,DL,5,8,2,3,6,40.0,60.0,75.0,3,2025-08-15 16:41:31,pit_roster_turnover_detailed.csv,2025-08-17 08:45:20,32
PIT,2019,2020,LB,5,5,3,2,2,60.0,40.0,40.0,0,2025-08-15 16:41:31,pit_roster_turnover_detailed.csv,2025-08-17 08:45:20,32
PIT,2019,2020,OL,4,7,2,2,5,50.0,50.0,71.43,3,2025-08-15 16:41:31,pit_roster_turnover_detailed.csv,2025-08-17 08:45:20,32
PIT,2019,2020,OTHER,13,12,9,4,3,69.23,30.77,25.0,-1,2025-08-15 16:41:31,pit_roster_turnover_detailed.csv,2025-08-17 08:45:20,32
PIT,2019,2020,QB,3,3,2,1,1,66.67,33.33,33.33,0,2025-08-15 16:41:31,pit_roster_turnover_detailed.csv,2025-08-17 08:45:20,32
PIT,2019,2020,RB,7,7,4,3,3,57.14,42.86,42.86,0,2025-08-15 16:41:31,pit_roster_turnover_detailed.csv,2025-08-17 08:45:20,32
PIT,2019,2020,ST,3,5,3,0,2,100.0,0.0,40.0,2,2025-08-15 16:41:31,pit_roster_turnover_detailed.csv,2025-08-17 08:45:20,32
PIT,2019,2020,TE,4,4,2,2,2,50.0,50.0,50.0,0,2025-08-15 16:41:31,pit_roster_turnover_detailed.csv,2025-08-17 08:45:20,32
PIT,2019,2020,WR,8,6,4,4,2,50.0,50.0,33.33,-2,2025-08-15 16:41:31,pit_roster_turnover_detailed.csv,2025-08-17 08:45:20,32
PIT,2020,2021,DB,10,10,5,5,5,50.0,50.0,50.0,0,2025-08-15 16:41:31,pit_roster_turnover_detailed.csv,2025-08-17 08:45:20,32
PIT,2020,2021,DL,8,12,5,3,7,62.5,37.5,58.33,4,2025-08-15 16:41:31,pit_roster_turnover_detailed.csv,2025-08-17 08:45:20,32
PIT,2020,2021,LB,5,8,2,3,6,40.0,60.0,75.0,3,2025-08-15 16:41:31,pit_roster_turnover_detailed.csv,2025-08-17 08:45:20,32
PIT,2020,2021,OL,7,6,2,5,4,28.57,71.43,66.67,-1,2025-08-15 16:41:31,pit_roster_turnover_detailed.csv,2025-08-17 08:45:20,32
PIT,2020,2021,OTHER,12,12,5,7,7,41.67,58.33,58.33,0,2025-08-15 16:41:31,pit_roster_turnover_detailed.csv,2025-08-17 08:45:20,32
PIT,2020,2021,QB,3,2,2,1,0,66.67,33.33,0.0,-1,2025-08-15 16:41:31,pit_roster_turnover_detailed.csv,2025-08-17 08:45:20,32
PIT,2020,2021,RB,7,6,4,3,2,57.14,42.86,33.33,-1,2025-08-15 16:41:31,pit_roster_turnover_detailed.csv,2025-08-17 08:45:20,32
PIT,2020,2021,ST,5,3,1,4,2,20.0,80.0,66.67,-2,2025-08-15 16:41:31,pit_roster_turnover_detailed.csv,2025-08-17 08:45:20,32
PIT,2020,2021,TE,4,4,3,1,1,75.0,25.0,25.0,0,2025-08-15 16:41:31,pit_roster_turnover_detailed.csv,2025-08-17 08:45:20,32
PIT,2020,2021,WR,6,8,5,1,3,83.33,16.67,37.5,2,2025-08-15 16:41:31,pit_roster_turnover_detailed.csv,2025-08-17 08:45:20,32
PIT,2021,2022,DB,10,13,8,2,5,80.0,20.0,38.46,3,2025-08-15 16:41:31,pit_roster_turnover_detailed.csv,2025-08-17 08:45:20,32
PIT,2021,2022,DL,12,8,5,7,3,41.67,58.33,37.5,-4,2025-08-15 16:41:31,pit_roster_turnover_detailed.csv,2025-08-17 08:45:20,32
PIT,2021,2022,LB,8,5,2,6,3,25.0,75.0,60.0,-3,2025-08-15 16:41:31,pit_roster_turnover_detailed.csv,2025-08-17 08:45:20,32
PIT,2021,2022,OL,6,4,1,5,3,16.67,83.33,75.0,-2,2025-08-15 16:41:31,pit_roster_turnover_detailed.csv,2025-08-17 08:45:20,32
PIT,2021,2022,OTHER,12,11,7,5,4,58.33,41.67,36.36,-1,2025-08-15 16:41:31,pit_roster_turnover_detailed.csv,2025-08-17 08:45:20,32
PIT,2021,2022,QB,2,2,0,2,2,0.0,100.0,100.0,0,2025-08-15 16:41:31,pit_roster_turnover_detailed.csv,2025-08-17 08:45:20,32
PIT,2021,2022,RB,6,5,4,2,1,66.67,33.33,20.0,-1,2025-08-15 16:41:31,pit_roster_turnover_detailed.csv,2025-08-17 08:45:20,32
PIT,2021,2022,ST,3,5,2,1,3,66.67,33.33,60.0,2,2025-08-15 16:41:31,pit_roster_turnover_detailed.csv,2025-08-17 08:45:20,32
PIT,2021,2022,TE,4,3,2,2,1,50.0,50.0,33.33,-1,2025-08-15 16:41:31,pit_roster_turnover_detailed.csv,2025-08-17 08:45:20,32
PIT,2021,2022,WR,8,7,4,4,3,50.0,50.0,42.86,-1,2025-08-15 16:41:31,pit_roster_turnover_detailed.csv,2025-08-17 08:45:20,32
PIT,2022,2023,DB,13,13,5,8,8,38.46,61.54,61.54,0,2025-08-15 16:41:31,pit_roster_turnover_detailed.csv,2025-08-17 08:45:20,32
PIT,2022,2023,DL,8,7,4,4,3,50.0,50.0,42.86,-1,2025-08-15 16:41:31,pit_roster_turnover_detailed.csv,2025-08-17 08:45:20,32
PIT,2022,2023,LB,5,13,1,4,12,20.0,80.0,92.31,8,2025-08-15 16:41:31,pit_roster_turnover_detailed.csv,2025-08-17 08:45:20,32
PIT,2022,2023,OL,4,7,1,3,6,25.0,75.0,85.71,3,2025-08-15 16:41:31,pit_roster_turnover_detailed.csv,2025-08-17 08:45:20,32
PIT,2022,2023,OTHER,11,2,1,10,1,9.09,90.91,50.0,-9,2025-08-15 16:41:31,pit_roster_turnover_detailed.csv,2025-08-17 08:45:20,32
PIT,2022,2023,QB,2,3,2,0,1,100.0,0.0,33.33,1,2025-08-15 16:41:31,pit_roster_turnover_detailed.csv,2025-08-17 08:45:20,32
PIT,2022,2023,RB,5,5,3,2,2,60.0,40.0,40.0,0,2025-08-15 16:41:31,pit_roster_turnover_detailed.csv,2025-08-17 08:45:20,32
PIT,2022,2023,ST,5,4,3,2,1,60.0,40.0,25.0,-1,2025-08-15 16:41:31,pit_roster_turnover_detailed.csv,2025-08-17 08:45:20,32
PIT,2022,2023,TE,3,4,2,1,2,66.67,33.33,50.0,1,2025-08-15 16:41:31,pit_roster_turnover_detailed.csv,2025-08-17 08:45:20,32
PIT,2022,2023,WR,7,7,4,3,3,57.14,42.86,42.86,0,2025-08-15 16:41:31,pit_roster_turnover_detailed.csv,2025-08-17 08:45:20,32
PIT,2023,2024,DB,13,12,5,8,7,38.46,61.54,58.33,-1,2025-08-15 16:41:31,pit_roster_turnover_detailed.csv,2025-08-17 08:45:20,32
PIT,2023,2024,DL,7,5,4,3,1,57.14,42.86,20.0,-2,2025-08-15 16:41:31,pit_roster_turnover_detailed.csv,2025-08-17 08:45:20,32
PIT,2023,2024,LB,13,8,2,11,6,15.38,84.62,75.0,-5,2025-08-15 16:41:31,pit_roster_turnover_detailed.csv,2025-08-17 08:45:20,32
PIT,2023,2024,OL,7,7,2,5,5,28.57,71.43,71.43,0,2025-08-15 16:41:31,pit_roster_turnover_detailed.csv,2025-08-17 08:45:20,32
PIT,2023,2024,OTHER,2,12,0,2,12,0.0,100.0,100.0,10,2025-08-15 16:41:31,pit_roster_turnover_detailed.csv,2025-08-17 08:45:20,32
PIT,2023,2024,QB,3,3,0,3,3,0.0,100.0,100.0,0,2025-08-15 16:41:31,pit_roster_turnover_detailed.csv,2025-08-17 08:45:20,32
PIT,2023,2024,RB,5,5,2,3,3,40.0,60.0,60.0,0,2025-08-15 16:41:31,pit_roster_turnover_detailed.csv,2025-08-17 08:45:20,32
PIT,2023,2024,ST,4,4,2,2,2,50.0,50.0,50.0,0,2025-08-15 16:41:31,pit_roster_turnover_detailed.csv,2025-08-17 08:45:20,32
PIT,2023,2024,TE,4,5,4,0,1,100.0,0.0,20.0,1,2025-08-15 16:41:31,pit_roster_turnover_detailed.csv,2025-08-17 08:45:20,32
PIT,2023,2024,WR,7,8,2,5,6,28.57,71.43,75.0,1,2025-08-15 16:41:31,pit_roster_turnover_detailed.csv,2025-08-17 08:45:20,32
RAI,2011,2012,DB,12,10,4,8,6,33.33,66.67,60.0,-2,2025-08-15 16:41:29,rai_roster_turnover_detailed.csv,2025-08-17 08:45:20,32
RAI,2011,2012,DL,5,5,0,5,5,0.0,100.0,100.0,0,2025-08-15 16:41:29,rai_roster_turnover_detailed.csv,2025-08-17 08:45:20,32
RAI,2011,2012,LB,5,7,1,4,6,20.0,80.0,85.71,2,2025-08-15 16:41:29,rai_roster_turnover_detailed.csv,2025-08-17 08:45:20,32
RAI,2011,2012,OL,4,4,0,4,4,0.0,100.0,100.0,0,2025-08-15 16:41:29,rai_roster_turnover_detailed.csv,2025-08-17 08:45:20,32
RAI,2011,2012,OTHER,12,15,7,5,8,58.33,41.67,53.33,3,2025-08-15 16:41:29,rai_roster_turnover_detailed.csv,2025-08-17 08:45:20,32
RAI,2011,2012,QB,4,3,2,2,1,50.0,50.0,33.33,-1,2025-08-15 16:41:29,rai_roster_turnover_detailed.csv,2025-08-17 08:45:20,32
RAI,2011,2012,RB,6,7,3,3,4,50.0,50.0,57.14,1,2025-08-15 16:41:29,rai_roster_turnover_detailed.csv,2025-08-17 08:45:20,32
RAI,2011,2012,ST,4,3,3,1,0,75.0,25.0,0.0,-1,2025-08-15 16:41:29,rai_roster_turnover_detailed.csv,2025-08-17 08:45:20,32
RAI,2011,2012,TE,3,2,2,1,0,66.67,33.33,0.0,-1,2025-08-15 16:41:29,rai_roster_turnover_detailed.csv,2025-08-17 08:45:20,32
RAI,2011,2012,WR,9,6,4,5,2,44.44,55.56,33.33,-3,2025-08-15 16:41:29,rai_roster_turnover_detailed.csv,2025-08-17 08:45:20,32
RAI,2012,2013,DB,10,9,4,6,5,40.0,60.0,55.56,-1,2025-08-15 16:41:29,rai_roster_turnover_detailed.csv,2025-08-17 08:45:20,32
RAI,2012,2013,DL,5,7,3,2,4,60.0,40.0,57.14,2,2025-08-15 16:41:29,rai_roster_turnover_detailed.csv,2025-08-17 08:45:20,32
RAI,2012,2013,LB,7,5,0,7,5,0.0,100.0,100.0,-2,2025-08-15 16:41:29,rai_roster_turnover_detailed.csv,2025-08-17 08:45:20,32
RAI,2012,2013,OL,4,6,1,3,5,25.0,75.0,83.33,2,2025-08-15 16:41:29,rai_roster_turnover_detailed.csv,2025-08-17 08:45:20,32
RAI,2012,2013,OTHER,15,14,4,11,10,26.67,73.33,71.43,-1,2025-08-15 16:41:29,rai_roster_turnover_detailed.csv,2025-08-17 08:45:20,32
RAI,2012,2013,QB,3,3,1,2,2,33.33,66.67,66.67,0,2025-08-15 16:41:29,rai_roster_turnover_detailed.csv,2025-08-17 08:45:20,32
RAI,2012,2013,RB,7,6,5,2,1,71.43,28.57,16.67,-1,2025-08-15 16:41:29,rai_roster_turnover_detailed.csv,2025-08-17 08:45:20,32
RAI,2012,2013,ST,3,3,2,1,1,66.67,33.33,33.33,0,2025-08-15 16:41:29,rai_roster_turnover_detailed.csv,2025-08-17 08:45:20,32
RAI,2012,2013,TE,2,3,0,2,3,0.0,100.0,100.0,1,2025-08-15 16:41:29,rai_roster_turnover_detailed.csv,2025-08-17 08:45:20,32
RAI,2012,2013,WR,6,7,3,3,4,50.0,50.0,57.14,1,2025-08-15 16:41:29,rai_roster_turnover_detailed.csv,2025-08-17 08:45:20,32
RAI,2013,2014,DB,9,13,6,3,7,66.67,33.33,53.85,4,2025-08-15 16:41:29,rai_roster_turnover_detailed.csv,2025-08-17 08:45:20,32
RAI,2013,2014,DL,7,6,1,6,5,14.29,85.71,83.33,-1,2025-08-15 16:41:29,rai_roster_turnover_detailed.csv,2025-08-17 08:45:20,32
RAI,2013,2014,LB,5,5,2,3,3,40.0,60.0,60.0,0,2025-08-15 16:41:29,rai_roster_turnover_detailed.csv,2025-08-17 08:45:20,32
RAI,2013,2014,OL,6,3,2,4,1,33.33,66.67,33.33,-3,2025-08-15 16:41:29,rai_roster_turnover_detailed.csv,2025-08-17 08:45:20,32
RAI,2013,2014,OTHER,14,15,2,12,13,14.29,85.71,86.67,1,2025-08-15 16:41:29,rai_roster_turnover_detailed.csv,2025-08-17 08:45:20,32
RAI,2013,2014,QB,3,3,1,2,2,33.33,66.67,66.67,0,2025-08-15 16:41:29,rai_roster_turnover_detailed.csv,2025-08-17 08:45:20,32
RAI,2013,2014,RB,6,7,4,2,3,66.67,33.33,42.86,1,2025-08-15 16:41:29,rai_roster_turnover_detailed.csv,2025-08-17 08:45:20,32
RAI,2013,2014,ST,3,3,3,0,0,100.0,0.0,0.0,0,2025-08-15 16:41:29,rai_roster_turnover_detailed.csv,2025-08-17 08:45:20,32
RAI,2013,2014,TE,3,3,1,2,2,33.33,66.67,66.67,0,2025-08-15 16:41:29,rai_roster_turnover_detailed.csv,2025-08-17 08:45:20,32
RAI,2013,2014,WR,7,8,4,3,4,57.14,42.86,50.0,1,2025-08-15 16:41:29,rai_roster_turnover_detailed.csv,2025-08-17 08:45:20,32
RAI,2014,2015,DB,13,12,6,7,6,46.15,53.85,50.0,-1,2025-08-15 16:41:29,rai_roster_turnover_detailed.csv,2025-08-17 08:45:20,32
RAI,2014,2015,DL,6,5,3,3,2,50.0,50.0,40.0,-1,2025-08-15 16:41:29,rai_roster_turnover_detailed.csv,2025-08-17 08:45:20,32
RAI,2014,2015,LB,5,6,0,5,6,0.0,100.0,100.0,1,2025-08-15 16:41:29,rai_roster_turnover_detailed.csv,2025-08-17 08:45:20,32
RAI,2014,2015,OL,3,5,1,2,4,33.33,66.67,80.0,2,2025-08-15 16:41:29,rai_roster_turnover_detailed.csv,2025-08-17 08:45:20,32
RAI,2014,2015,OTHER,15,14,7,8,7,46.67,53.33,50.0,-1,2025-08-15 16:41:29,rai_roster_turnover_detailed.csv,2025-08-17 08:45:20,32
RAI,2014,2015,QB,3,2,2,1,0,66.67,33.33,0.0,-1,2025-08-15 16:41:29,rai_roster_turnover_detailed.csv,2025-08-17 08:45:20,32
RAI,2014,2015,RB,7,6,4,3,2,57.14,42.86,33.33,-1,2025-08-15 16:41:29,rai_roster_turnover_detailed.csv,2025-08-17 08:45:20,32
RAI,2014,2015,ST,3,3,3,0,0,100.0,0.0,0.0,0,2025-08-15 16:41:29,rai_roster_turnover_detailed.csv,2025-08-17 08:45:20,32
RAI,2014,2015,TE,3,3,1,2,2,33.33,66.67,66.67,0,2025-08-15 16:41:29,rai_roster_turnover_detailed.csv,2025-08-17 08:45:20,32
RAI,2014,2015,WR,8,6,2,6,4,25.0,75.0,66.67,-2,2025-08-15 16:41:29,rai_roster_turnover_detailed.csv,2025-08-17 08:45:20,32
RAI,2015,2016,DB,12,9,4,8,5,33.33,66.67,55.56,-3,2025-08-15 16:41:29,rai_roster_turnover_detailed.csv,2025-08-17 08:45:20,32
RAI,2015,2016,DL,5,6,0,5,6,0.0,100.0,100.0,1,2025-08-15 16:41:29,rai_roster_turnover_detailed.csv,2025-08-17 08:45:20,32
RAI,2015,2016,LB,6,5,1,5,4,16.67,83.33,80.0,-1,2025-08-15 16:41:29,rai_roster_turnover_detailed.csv,2025-08-17 08:45:20,32
RAI,2015,2016,OL,5,5,3,2,2,60.0,40.0,40.0,0,2025-08-15 16:41:29,rai_roster_turnover_detailed.csv,2025-08-17 08:45:20,32
RAI,2015,2016,OTHER,14,14,8,6,6,57.14,42.86,42.86,0,2025-08-15 16:41:29,rai_roster_turnover_detailed.csv,2025-08-17 08:45:20,32
RAI,2015,2016,QB,2,3,2,0,1,100.0,0.0,33.33,1,2025-08-15 16:41:29,rai_roster_turnover_detailed.csv,2025-08-17 08:45:20,32
RAI,2015,2016,RB,6,5,3,3,2,50.0,50.0,40.0,-1,2025-08-15 16:41:29,rai_roster_turnover_detailed.csv,2025-08-17 08:45:20,32
RAI,2015,2016,ST,3,3,3,0,0,100.0,0.0,0.0,0,2025-08-15 16:41:29,rai_roster_turnover_detailed.csv,2025-08-17 08:45:20,32
RAI,2015,2016,TE,3,4,3,0,1,100.0,0.0,25.0,1,2025-08-15 16:41:29,rai_roster_turnover_detailed.csv,2025-08-17 08:45:20,32
RAI,2015,2016,WR,6,5,4,2,1,66.67,33.33,20.0,-1,2025-08-15 16:41:29,rai_roster_turnover_detailed.csv,2025-08-17 08:45:20,32
RAI,2016,2017,DB,9,9,4,5,5,44.44,55.56,55.56,0,2025-08-15 16:41:29,rai_roster_turnover_detailed.csv,2025-08-17 08:45:20,32
RAI,2016,2017,DL,6,6,3,3,3,50.0,50.0,50.0,0,2025-08-15 16:41:29,rai_roster_turnover_detailed.csv,2025-08-17 08:45:20,32
RAI,2016,2017,LB,5,5,1,4,4,20.0,80.0,80.0,0,2025-08-15 16:41:29,rai_roster_turnover_detailed.csv,2025-08-17 08:45:20,32
RAI,2016,2017,OL,5,6,3,2,3,60.0,40.0,50.0,1,2025-08-15 16:41:29,rai_roster_turnover_detailed.csv,2025-08-17 08:45:20,32
RAI,2016,2017,OTHER,14,15,7,7,8,50.0,50.0,53.33,1,2025-08-15 16:41:29,rai_roster_turnover_detailed.csv,2025-08-17 08:45:20,32
RAI,2016,2017,QB,3,2,1,2,1,33.33,66.67,50.0,-1,2025-08-15 16:41:29,rai_roster_turnover_detailed.csv,2025-08-17 08:45:20,32
RAI,2016,2017,RB,5,5,3,2,2,60.0,40.0,40.0,0,2025-08-15 16:41:29,rai_roster_turnover_detailed.csv,2025-08-17 08:45:20,32
RAI,2016,2017,ST,3,3,2,1,1,66.67,33.33,33.33,0,2025-08-15 16:41:29,rai_roster_turnover_detailed.csv,2025-08-17 08:45:20,32
RAI,2016,2017,TE,4,4,2,2,2,50.0,50.0,50.0,0,2025-08-15 16:41:29,rai_roster_turnover_detailed.csv,2025-08-17 08:45:20,32
RAI,2016,2017,WR,5,6,4,1,2,80.0,20.0,33.33,1,2025-08-15 16:41:29,rai_roster_turnover_detailed.csv,2025-08-17 08:45:20,32
RAI,2017,2018,DB,9,11,3,6,8,33.33,66.67,72.73,2,2025-08-15 16:41:29,rai_roster_turnover_detailed.csv,2025-08-17 08:45:20,32
RAI,2017,2018,DL,6,9,1,5,8,16.67,83.33,88.89,3,2025-08-15 16:41:29,rai_roster_turnover_detailed.csv,2025-08-17 08:45:20,32
RAI,2017,2018,LB,5,6,1,4,5,20.0,80.0,83.33,1,2025-08-15 16:41:29,rai_roster_turnover_detailed.csv,2025-08-17 08:45:20,32
RAI,2017,2018,OL,6,10,3,3,7,50.0,50.0,70.0,4,2025-08-15 16:41:29,rai_roster_turnover_detailed.csv,2025-08-17 08:45:20,32
RAI,2017,2018,OTHER,15,15,4,11,11,26.67,73.33,73.33,0,2025-08-15 16:41:29,rai_roster_turnover_detailed.csv,2025-08-17 08:45:20,32
RAI,2017,2018,QB,2,2,1,1,1,50.0,50.0,50.0,0,2025-08-15 16:41:29,rai_roster_turnover_detailed.csv,2025-08-17 08:45:20,32
RAI,2017,2018,RB,5,4,3,2,1,60.0,40.0,25.0,-1,2025-08-15 16:41:29,rai_roster_turnover_detailed.csv,2025-08-17 08:45:20,32
RAI,2017,2018,ST,3,6,0,3,6,0.0,100.0,100.0,3,2025-08-15 16:41:29,rai_roster_turnover_detailed.csv,2025-08-17 08:45:20,32
RAI,2017,2018,TE,4,3,2,2,1,50.0,50.0,33.33,-1,2025-08-15 16:41:29,rai_roster_turnover_detailed.csv,2025-08-17 08:45:20,32
RAI,2017,2018,WR,6,11,3,3,8,50.0,50.0,72.73,5,2025-08-15 16:41:29,rai_roster_turnover_detailed.csv,2025-08-17 08:45:20,32
RAI,2018,2019,DB,11,12,5,6,7,45.45,54.55,58.33,1,2025-08-15 16:41:29,rai_roster_turnover_detailed.csv,2025-08-17 08:45:20,32
RAI,2018,2019,DL,9,6,0,9,6,0.0,100.0,100.0,-3,2025-08-15 16:41:29,rai_roster_turnover_detailed.csv,2025-08-17 08:45:20,32
RAI,2018,2019,LB,6,8,2,4,6,33.33,66.67,75.0,2,2025-08-15 16:41:29,rai_roster_turnover_detailed.csv,2025-08-17 08:45:20,32
RAI,2018,2019,OL,10,7,2,8,5,20.0,80.0,71.43,-3,2025-08-15 16:41:29,rai_roster_turnover_detailed.csv,2025-08-17 08:45:20,32
RAI,2018,2019,OTHER,15,15,8,7,7,53.33,46.67,46.67,0,2025-08-15 16:41:29,rai_roster_turnover_detailed.csv,2025-08-17 08:45:20,32
RAI,2018,2019,QB,2,2,1,1,1,50.0,50.0,50.0,0,2025-08-15 16:41:29,rai_roster_turnover_detailed.csv,2025-08-17 08:45:20,32
RAI,2018,2019,RB,4,5,2,2,3,50.0,50.0,60.0,1,2025-08-15 16:41:29,rai_roster_turnover_detailed.csv,2025-08-17 08:45:20,32
RAI,2018,2019,ST,6,3,2,4,1,33.33,66.67,33.33,-3,2025-08-15 16:41:29,rai_roster_turnover_detailed.csv,2025-08-17 08:45:20,32
RAI,2018,2019,TE,3,4,1,2,3,33.33,66.67,75.0,1,2025-08-15 16:41:29,rai_roster_turnover_detailed.csv,2025-08-17 08:45:20,32
RAI,2018,2019,WR,11,9,2,9,7,18.18,81.82,77.78,-2,2025-08-15 16:41:29,rai_roster_turnover_detailed.csv,2025-08-17 08:45:20,32
RAI,2019,2020,DB,12,12,6,6,6,50.0,50.0,50.0,0,2025-08-15 16:41:29,rai_roster_turnover_detailed.csv,2025-08-17 08:45:20,32
RAI,2019,2020,DL,6,8,2,4,6,33.33,66.67,75.0,2,2025-08-15 16:41:29,rai_roster_turnover_detailed.csv,2025-08-17 08:45:20,32
RAI,2019,2020,LB,8,6,1,7,5,12.5,87.5,83.33,-2,2025-08-15 16:41:29,rai_roster_turnover_detailed.csv,2025-08-17 08:45:20,32
RAI,2019,2020,OL,7,8,4,3,4,57.14,42.86,50.0,1,2025-08-15 16:41:29,rai_roster_turnover_detailed.csv,2025-08-17 08:45:20,32
RAI,2019,2020,OTHER,15,15,9,6,6,60.0,40.0,40.0,0,2025-08-15 16:41:29,rai_roster_turnover_detailed.csv,2025-08-17 08:45:20,32
RAI,2019,2020,QB,2,3,1,1,2,50.0,50.0,66.67,1,2025-08-15 16:41:29,rai_roster_turnover_detailed.csv,2025-08-17 08:45:20,32
RAI,2019,2020,RB,5,5,3,2,2,60.0,40.0,40.0,0,2025-08-15 16:41:29,rai_roster_turnover_detailed.csv,2025-08-17 08:45:20,32
RAI,2019,2020,ST,3,3,3,0,0,100.0,0.0,0.0,0,2025-08-15 16:41:29,rai_roster_turnover_detailed.csv,2025-08-17 08:45:20,32
RAI,2019,2020,TE,4,4,3,1,1,75.0,25.0,25.0,0,2025-08-15 16:41:29,rai_roster_turnover_detailed.csv,2025-08-17 08:45:20,32
RAI,2019,2020,WR,9,6,3,6,3,33.33,66.67,50.0,-3,2025-08-15 16:41:29,rai_roster_turnover_detailed.csv,2025-08-17 08:45:20,32
RAI,2020,2021,DB,12,12,5,7,7,41.67,58.33,58.33,0,2025-08-15 16:41:29,rai_roster_turnover_detailed.csv,2025-08-17 08:45:20,32
RAI,2020,2021,DL,8,7,1,7,6,12.5,87.5,85.71,-1,2025-08-15 16:41:29,rai_roster_turnover_detailed.csv,2025-08-17 08:45:20,32
RAI,2020,2021,LB,6,10,3,3,7,50.0,50.0,70.0,4,2025-08-15 16:41:29,rai_roster_turnover_detailed.csv,2025-08-17 08:45:20,32
RAI,2020,2021,OL,8,7,1,7,6,12.5,87.5,85.71,-1,2025-08-15 16:41:29,rai_roster_turnover_detailed.csv,2025-08-17 08:45:20,32
RAI,2020,2021,OTHER,15,13,5,10,8,33.33,66.67,61.54,-2,2025-08-15 16:41:29,rai_roster_turnover_detailed.csv,2025-08-17 08:45:20,32
RAI,2020,2021,QB,3,3,3,0,0,100.0,0.0,0.0,0,2025-08-15 16:41:29,rai_roster_turnover_detailed.csv,2025-08-17 08:45:20,32
RAI,2020,2021,RB,5,6,3,2,3,60.0,40.0,50.0,1,2025-08-15 16:41:29,rai_roster_turnover_detailed.csv,2025-08-17 08:45:20,32
RAI,2020,2021,ST,3,4,3,0,1,100.0,0.0,25.0,1,2025-08-15 16:41:29,rai_roster_turnover_detailed.csv,2025-08-17 08:45:20,32
RAI,2020,2021,TE,4,6,3,1,3,75.0,25.0,50.0,2,2025-08-15 16:41:29,rai_roster_turnover_detailed.csv,2025-08-17 08:45:20,32
RAI,2020,2021,WR,6,9,4,2,5,66.67,33.33,55.56,3,2025-08-15 16:41:29,rai_roster_turnover_detailed.csv,2025-08-17 08:45:20,32
RAI,2021,2022,DB,12,13,4,8,9,33.33,66.67,69.23,1,2025-08-15 16:41:29,rai_roster_turnover_detailed.csv,2025-08-17 08:45:20,32
RAI,2021,2022,DL,7,9,2,5,7,28.57,71.43,77.78,2,2025-08-15 16:41:29,rai_roster_turnover_detailed.csv,2025-08-17 08:45:20,32
RAI,2021,2022,LB,10,8,2,8,6,20.0,80.0,75.0,-2,2025-08-15 16:41:29,rai_roster_turnover_detailed.csv,2025-08-17 08:45:20,32
RAI,2021,2022,OL,7,9,3,4,6,42.86,57.14,66.67,2,2025-08-15 16:41:29,rai_roster_turnover_detailed.csv,2025-08-17 08:45:20,32
RAI,2021,2022,OTHER,13,12,2,11,10,15.38,84.62,83.33,-1,2025-08-15 16:41:29,rai_roster_turnover_detailed.csv,2025-08-17 08:45:20,32
RAI,2021,2022,QB,3,2,1,2,1,33.33,66.67,50.0,-1,2025-08-15 16:41:29,rai_roster_turnover_detailed.csv,2025-08-17 08:45:20,32
RAI,2021,2022,RB,6,6,1,5,5,16.67,83.33,83.33,0,2025-08-15 16:41:29,rai_roster_turnover_detailed.csv,2025-08-17 08:45:20,32
RAI,2021,2022,ST,4,3,3,1,0,75.0,25.0,0.0,-1,2025-08-15 16:41:29,rai_roster_turnover_detailed.csv,2025-08-17 08:45:20,32
RAI,2021,2022,TE,6,3,2,4,1,33.33,66.67,33.33,-3,2025-08-15 16:41:29,rai_roster_turnover_detailed.csv,2025-08-17 08:45:20,32
RAI,2021,2022,WR,9,7,2,7,5,22.22,77.78,71.43,-2,2025-08-15 16:41:29,rai_roster_turnover_detailed.csv,2025-08-17 08:45:20,32
RAI,2022,2023,DB,13,14,5,8,9,38.46,61.54,64.29,1,2025-08-15 16:41:29,rai_roster_turnover_detailed.csv,2025-08-17 08:45:20,32
RAI,2022,2023,DL,9,10,2,7,8,22.22,77.78,80.0,1,2025-08-15 16:41:29,rai_roster_turnover_detailed.csv,2025-08-17 08:45:20,32
RAI,2022,2023,LB,8,7,1,7,6,12.5,87.5,85.71,-1,2025-08-15 16:41:29,rai_roster_turnover_detailed.csv,2025-08-17 08:45:20,32
RAI,2022,2023,OL,9,10,5,4,5,55.56,44.44,50.0,1,2025-08-15 16:41:29,rai_roster_turnover_detailed.csv,2025-08-17 08:45:20,32
RAI,2022,2023,OTHER,12,4,2,10,2,16.67,83.33,50.0,-8,2025-08-15 16:41:29,rai_roster_turnover_detailed.csv,2025-08-17 08:45:20,32
RAI,2022,2023,QB,2,3,0,2,3,0.0,100.0,100.0,1,2025-08-15 16:41:29,rai_roster_turnover_detailed.csv,2025-08-17 08:45:20,32
RAI,2022,2023,RB,6,5,5,1,0,83.33,16.67,0.0,-1,2025-08-15 16:41:29,rai_roster_turnover_detailed.csv,2025-08-17 08:45:20,32
RAI,2022,2023,ST,3,3,2,1,1,66.67,33.33,33.33,0,2025-08-15 16:41:29,rai_roster_turnover_detailed.csv,2025-08-17 08:45:20,32
RAI,2022,2023,TE,3,5,0,3,5,0.0,100.0,100.0,2,2025-08-15 16:41:29,rai_roster_turnover_detailed.csv,2025-08-17 08:45:20,32
RAI,2022,2023,WR,7,7,3,4,4,42.86,57.14,57.14,0,2025-08-15 16:41:29,rai_roster_turnover_detailed.csv,2025-08-17 08:45:20,32
RAI,2023,2024,DB,14,11,6,8,5,42.86,57.14,45.45,-3,2025-08-15 16:41:29,rai_roster_turnover_detailed.csv,2025-08-17 08:45:20,32
RAI,2023,2024,DL,10,9,4,6,5,40.0,60.0,55.56,-1,2025-08-15 16:41:29,rai_roster_turnover_detailed.csv,2025-08-17 08:45:20,32
RAI,2023,2024,LB,7,6,4,3,2,57.14,42.86,33.33,-1,2025-08-15 16:41:29,rai_roster_turnover_detailed.csv,2025-08-17 08:45:20,32
RAI,2023,2024,OL,10,5,3,7,2,30.0,70.0,40.0,-5,2025-08-15 16:41:29,rai_roster_turnover_detailed.csv,2025-08-17 08:45:20,32
RAI,2023,2024,OTHER,4,11,0,4,11,0.0,100.0,100.0,7,2025-08-15 16:41:29,rai_roster_turnover_detailed.csv,2025-08-17 08:45:20,32
RAI,2023,2024,QB,3,3,1,2,2,33.33,66.67,66.67,0,2025-08-15 16:41:29,rai_roster_turnover_detailed.csv,2025-08-17 08:45:20,32
RAI,2023,2024,RB,5,6,2,3,4,40.0,60.0,66.67,1,2025-08-15 16:41:29,rai_roster_turnover_detailed.csv,2025-08-17 08:45:20,32
RAI,2023,2024,ST,3,3,3,0,0,100.0,0.0,0.0,0,2025-08-15 16:41:29,rai_roster_turnover_detailed.csv,2025-08-17 08:45:20,32
RAI,2023,2024,TE,5,5,1,4,4,20.0,80.0,80.0,0,2025-08-15 16:41:29,rai_roster_turnover_detailed.csv,2025-08-17 08:45:20,32
RAI,2023,2024,WR,7,9,5,2,4,71.43,28.57,44.44,2,2025-08-15 16:41:29,rai_roster_turnover_detailed.csv,2025-08-17 08:45:20,32
RAM,2011,2012,DB,11,8,4,7,4,36.36,63.64,50.0,-3,2025-08-15 16:41:32,ram_roster_turnover_detailed.csv,2025-08-17 08:45:20,32
RAM,2011,2012,DL,5,4,0,5,4,0.0,100.0,100.0,-1,2025-08-15 16:41:32,ram_roster_turnover_detailed.csv,2025-08-17 08:45:20,32
RAM,2011,2012,LB,9,7,5,4,2,55.56,44.44,28.57,-2,2025-08-15 16:41:32,ram_roster_turnover_detailed.csv,2025-08-17 08:45:20,32
RAM,2011,2012,OL,6,8,0,6,8,0.0,100.0,100.0,2,2025-08-15 16:41:32,ram_roster_turnover_detailed.csv,2025-08-17 08:45:20,32
RAM,2011,2012,OTHER,14,13,3,11,10,21.43,78.57,76.92,-1,2025-08-15 16:41:32,ram_roster_turnover_detailed.csv,2025-08-17 08:45:20,32
RAM,2011,2012,QB,4,2,2,2,0,50.0,50.0,0.0,-2,2025-08-15 16:41:32,ram_roster_turnover_detailed.csv,2025-08-17 08:45:20,32
RAM,2011,2012,RB,6,4,1,5,3,16.67,83.33,75.0,-2,2025-08-15 16:41:32,ram_roster_turnover_detailed.csv,2025-08-17 08:45:20,32
RAM,2011,2012,ST,3,3,1,2,2,33.33,66.67,66.67,0,2025-08-15 16:41:32,ram_roster_turnover_detailed.csv,2025-08-17 08:45:20,32
RAM,2011,2012,TE,2,4,0,2,4,0.0,100.0,100.0,2,2025-08-15 16:41:32,ram_roster_turnover_detailed.csv,2025-08-17 08:45:20,32
RAM,2011,2012,WR,11,6,3,8,3,27.27,72.73,50.0,-5,2025-08-15 16:41:32,ram_roster_turnover_detailed.csv,2025-08-17 08:45:20,32
RAM,2012,2013,DB,8,9,4,4,5,50.0,50.0,55.56,1,2025-08-15 16:41:32,ram_roster_turnover_detailed.csv,2025-08-17 08:45:20,32
RAM,2012,2013,DL,4,4,3,1,1,75.0,25.0,25.0,0,2025-08-15 16:41:32,ram_roster_turnover_detailed.csv,2025-08-17 08:45:20,32
RAM,2012,2013,LB,7,4,2,5,2,28.57,71.43,50.0,-3,2025-08-15 16:41:32,ram_roster_turnover_detailed.csv,2025-08-17 08:45:20,32
RAM,2012,2013,OL,8,6,2,6,4,25.0,75.0,66.67,-2,2025-08-15 16:41:32,ram_roster_turnover_detailed.csv,2025-08-17 08:45:20,32
RAM,2012,2013,OTHER,13,14,9,4,5,69.23,30.77,35.71,1,2025-08-15 16:41:32,ram_roster_turnover_detailed.csv,2025-08-17 08:45:20,32
RAM,2012,2013,QB,2,2,2,0,0,100.0,0.0,0.0,0,2025-08-15 16:41:32,ram_roster_turnover_detailed.csv,2025-08-17 08:45:20,32
RAM,2012,2013,RB,4,6,2,2,4,50.0,50.0,66.67,2,2025-08-15 16:41:32,ram_roster_turnover_detailed.csv,2025-08-17 08:45:20,32
RAM,2012,2013,ST,3,3,3,0,0,100.0,0.0,0.0,0,2025-08-15 16:41:32,ram_roster_turnover_detailed.csv,2025-08-17 08:45:20,32
RAM,2012,2013,TE,4,3,1,3,2,25.0,75.0,66.67,-1,2025-08-15 16:41:32,ram_roster_turnover_detailed.csv,2025-08-17 08:45:20,32
RAM,2012,2013,WR,6,7,3,3,4,50.0,50.0,57.14,1,2025-08-15 16:41:32,ram_roster_turnover_detailed.csv,2025-08-17 08:45:20,32
RAM,2013,2014,DB,9,9,5,4,4,55.56,44.44,44.44,0,2025-08-15 16:41:32,ram_roster_turnover_detailed.csv,2025-08-17 08:45:20,32
RAM,2013,2014,DL,4,3,0,4,3,0.0,100.0,100.0,-1,2025-08-15 16:41:32,ram_roster_turnover_detailed.csv,2025-08-17 08:45:20,32
RAM,2013,2014,LB,4,7,3,1,4,75.0,25.0,57.14,3,2025-08-15 16:41:32,ram_roster_turnover_detailed.csv,2025-08-17 08:45:20,32
RAM,2013,2014,OL,6,4,3,3,1,50.0,50.0,25.0,-2,2025-08-15 16:41:32,ram_roster_turnover_detailed.csv,2025-08-17 08:45:20,32
RAM,2013,2014,OTHER,14,15,10,4,5,71.43,28.57,33.33,1,2025-08-15 16:41:32,ram_roster_turnover_detailed.csv,2025-08-17 08:45:20,32
RAM,2013,2014,QB,2,2,0,2,2,0.0,100.0,100.0,0,2025-08-15 16:41:32,ram_roster_turnover_detailed.csv,2025-08-17 08:45:20,32
RAM,2013,2014,RB,6,6,4,2,2,66.67,33.33,33.33,0,2025-08-15 16:41:32,ram_roster_turnover_detailed.csv,2025-08-17 08:45:20,32
RAM,2013,2014,ST,3,3,3,0,0,100.0,0.0,0.0,0,2025-08-15 16:41:32,ram_roster_turnover_detailed.csv,2025-08-17 08:45:20,32
RAM,2013,2014,TE,3,3,1,2,2,33.33,66.67,66.67,0,2025-08-15 16:41:32,ram_roster_turnover_detailed.csv,2025-08-17 08:45:20,32
RAM,2013,2014,WR,7,7,5,2,2,71.43,28.57,28.57,0,2025-08-15 16:41:32,ram_roster_turnover_detailed.csv,2025-08-17 08:45:20,32
RAM,2014,2015,DB,9,8,6,3,2,66.67,33.33,25.0,-1,2025-08-15 16:41:32,ram_roster_turnover_detailed.csv,2025-08-17 08:45:20,32
RAM,2014,2015,DL,3,4,1,2,3,33.33,66.67,75.0,1,2025-08-15 16:41:32,ram_roster_turnover_detailed.csv,2025-08-17 08:45:20,32
RAM,2014,2015,LB,7,5,2,5,3,28.57,71.43,60.0,-2,2025-08-15 16:41:32,ram_roster_turnover_detailed.csv,2025-08-17 08:45:20,32
RAM,2014,2015,OL,4,6,1,3,5,25.0,75.0,83.33,2,2025-08-15 16:41:32,ram_roster_turnover_detailed.csv,2025-08-17 08:45:20,32
RAM,2014,2015,OTHER,15,16,9,6,7,60.0,40.0,43.75,1,2025-08-15 16:41:32,ram_roster_turnover_detailed.csv,2025-08-17 08:45:20,32
RAM,2014,2015,QB,2,3,0,2,3,0.0,100.0,100.0,1,2025-08-15 16:41:32,ram_roster_turnover_detailed.csv,2025-08-17 08:45:20,32
RAM,2014,2015,RB,6,7,4,2,3,66.67,33.33,42.86,1,2025-08-15 16:41:32,ram_roster_turnover_detailed.csv,2025-08-17 08:45:20,32
RAM,2014,2015,ST,3,4,3,0,1,100.0,0.0,25.0,1,2025-08-15 16:41:32,ram_roster_turnover_detailed.csv,2025-08-17 08:45:20,32
RAM,2014,2015,TE,3,4,2,1,2,66.67,33.33,50.0,1,2025-08-15 16:41:32,ram_roster_turnover_detailed.csv,2025-08-17 08:45:20,32
RAM,2014,2015,WR,7,8,5,2,3,71.43,28.57,37.5,1,2025-08-15 16:41:32,ram_roster_turnover_detailed.csv,2025-08-17 08:45:20,32
RAM,2015,2016,DB,8,13,4,4,9,50.0,50.0,69.23,5,2025-08-15 16:41:32,ram_roster_turnover_detailed.csv,2025-08-17 08:45:20,32
RAM,2015,2016,DL,4,4,2,2,2,50.0,50.0,50.0,0,2025-08-15 16:41:32,ram_roster_turnover_detailed.csv,2025-08-17 08:45:20,32
RAM,2015,2016,LB,5,5,2,3,3,40.0,60.0,60.0,0,2025-08-15 16:41:32,ram_roster_turnover_detailed.csv,2025-08-17 08:45:20,32
RAM,2015,2016,OL,6,6,3,3,3,50.0,50.0,50.0,0,2025-08-15 16:41:32,ram_roster_turnover_detailed.csv,2025-08-17 08:45:20,32
RAM,2015,2016,OTHER,16,12,11,5,1,68.75,31.25,8.33,-4,2025-08-15 16:41:32,ram_roster_turnover_detailed.csv,2025-08-17 08:45:20,32
RAM,2015,2016,QB,3,3,2,1,1,66.67,33.33,33.33,0,2025-08-15 16:41:32,ram_roster_turnover_detailed.csv,2025-08-17 08:45:20,32
RAM,2015,2016,RB,7,5,4,3,1,57.14,42.86,20.0,-2,2025-08-15 16:41:32,ram_roster_turnover_detailed.csv,2025-08-17 08:45:20,32
RAM,2015,2016,ST,4,3,3,1,0,75.0,25.0,0.0,-1,2025-08-15 16:41:32,ram_roster_turnover_detailed.csv,2025-08-17 08:45:20,32
RAM,2015,2016,TE,4,4,2,2,2,50.0,50.0,50.0,0,2025-08-15 16:41:32,ram_roster_turnover_detailed.csv,2025-08-17 08:45:20,32
RAM,2015,2016,WR,8,7,4,4,3,50.0,50.0,42.86,-1,2025-08-15 16:41:32,ram_roster_turnover_detailed.csv,2025-08-17 08:45:20,32
RAM,2016,2017,DB,13,13,8,5,5,61.54,38.46,38.46,0,2025-08-15 16:41:32,ram_roster_turnover_detailed.csv,2025-08-17 08:45:20,32
RAM,2016,2017,DL,4,7,2,2,5,50.0,50.0,71.43,3,2025-08-15 16:41:32,ram_roster_turnover_detailed.csv,2025-08-17 08:45:20,32
RAM,2016,2017,LB,5,4,2,3,2,40.0,60.0,50.0,-1,2025-08-15 16:41:32,ram_roster_turnover_detailed.csv,2025-08-17 08:45:20,32
RAM,2016,2017,OL,6,5,0,6,5,0.0,100.0,100.0,-1,2025-08-15 16:41:32,ram_roster_turnover_detailed.csv,2025-08-17 08:45:20,32
RAM,2016,2017,OTHER,12,11,6,6,5,50.0,50.0,45.45,-1,2025-08-15 16:41:32,ram_roster_turnover_detailed.csv,2025-08-17 08:45:20,32
RAM,2016,2017,QB,3,2,2,1,0,66.67,33.33,0.0,-1,2025-08-15 16:41:32,ram_roster_turnover_detailed.csv,2025-08-17 08:45:20,32
RAM,2016,2017,RB,5,4,2,3,2,40.0,60.0,50.0,-1,2025-08-15 16:41:32,ram_roster_turnover_detailed.csv,2025-08-17 08:45:20,32
RAM,2016,2017,ST,3,4,3,0,1,100.0,0.0,25.0,1,2025-08-15 16:41:32,ram_roster_turnover_detailed.csv,2025-08-17 08:45:20,32
RAM,2016,2017,TE,4,4,1,3,3,25.0,75.0,75.0,0,2025-08-15 16:41:32,ram_roster_turnover_detailed.csv,2025-08-17 08:45:20,32
RAM,2016,2017,WR,7,7,3,4,4,42.86,57.14,57.14,0,2025-08-15 16:41:32,ram_roster_turnover_detailed.csv,2025-08-17 08:45:20,32
RAM,2017,2018,DB,13,9,7,6,2,53.85,46.15,22.22,-4,2025-08-15 16:41:32,ram_roster_turnover_detailed.csv,2025-08-17 08:45:20,32
RAM,2017,2018,DL,7,6,2,5,4,28.57,71.43,66.67,-1,2025-08-15 16:41:32,ram_roster_turnover_detailed.csv,2025-08-17 08:45:20,32
RAM,2017,2018,LB,4,3,1,3,2,25.0,75.0,66.67,-1,2025-08-15 16:41:32,ram_roster_turnover_detailed.csv,2025-08-17 08:45:20,32
RAM,2017,2018,OL,5,4,1,4,3,20.0,80.0,75.0,-1,2025-08-15 16:41:32,ram_roster_turnover_detailed.csv,2025-08-17 08:45:20,32
RAM,2017,2018,OTHER,11,15,5,6,10,45.45,54.55,66.67,4,2025-08-15 16:41:32,ram_roster_turnover_detailed.csv,2025-08-17 08:45:20,32
RAM,2017,2018,QB,2,2,2,0,0,100.0,0.0,0.0,0,2025-08-15 16:41:32,ram_roster_turnover_detailed.csv,2025-08-17 08:45:20,32
RAM,2017,2018,RB,4,5,3,1,2,75.0,25.0,40.0,1,2025-08-15 16:41:32,ram_roster_turnover_detailed.csv,2025-08-17 08:45:20,32
RAM,2017,2018,ST,4,5,4,0,1,100.0,0.0,20.0,1,2025-08-15 16:41:32,ram_roster_turnover_detailed.csv,2025-08-17 08:45:20,32
RAM,2017,2018,TE,4,3,3,1,0,75.0,25.0,0.0,-1,2025-08-15 16:41:32,ram_roster_turnover_detailed.csv,2025-08-17 08:45:20,32
RAM,2017,2018,WR,7,9,5,2,4,71.43,28.57,44.44,2,2025-08-15 16:41:32,ram_roster_turnover_detailed.csv,2025-08-17 08:45:20,32
RAM,2018,2019,DB,9,11,4,5,7,44.44,55.56,63.64,2,2025-08-15 16:41:32,ram_roster_turnover_detailed.csv,2025-08-17 08:45:20,32
RAM,2018,2019,DL,6,3,1,5,2,16.67,83.33,66.67,-3,2025-08-15 16:41:32,ram_roster_turnover_detailed.csv,2025-08-17 08:45:20,32
RAM,2018,2019,LB,3,6,1,2,5,33.33,66.67,83.33,3,2025-08-15 16:41:32,ram_roster_turnover_detailed.csv,2025-08-17 08:45:20,32
RAM,2018,2019,OL,4,4,1,3,3,25.0,75.0,75.0,0,2025-08-15 16:41:32,ram_roster_turnover_detailed.csv,2025-08-17 08:45:20,32
RAM,2018,2019,OTHER,15,17,11,4,6,73.33,26.67,35.29,2,2025-08-15 16:41:32,ram_roster_turnover_detailed.csv,2025-08-17 08:45:20,32
RAM,2018,2019,QB,2,2,1,1,1,50.0,50.0,50.0,0,2025-08-15 16:41:32,ram_roster_turnover_detailed.csv,2025-08-17 08:45:20,32
RAM,2018,2019,RB,5,4,3,2,1,60.0,40.0,25.0,-1,2025-08-15 16:41:32,ram_roster_turnover_detailed.csv,2025-08-17 08:45:20,32
RAM,2018,2019,ST,5,3,3,2,0,60.0,40.0,0.0,-2,2025-08-15 16:41:32,ram_roster_turnover_detailed.csv,2025-08-17 08:45:20,32
RAM,2018,2019,TE,3,4,3,0,1,100.0,0.0,25.0,1,2025-08-15 16:41:32,ram_roster_turnover_detailed.csv,2025-08-17 08:45:20,32
RAM,2018,2019,WR,9,7,6,3,1,66.67,33.33,14.29,-2,2025-08-15 16:41:32,ram_roster_turnover_detailed.csv,2025-08-17 08:45:20,32
RAM,2019,2020,DB,11,12,8,3,4,72.73,27.27,33.33,1,2025-08-15 16:41:32,ram_roster_turnover_detailed.csv,2025-08-17 08:45:20,32
RAM,2019,2020,DL,3,7,2,1,5,66.67,33.33,71.43,4,2025-08-15 16:41:32,ram_roster_turnover_detailed.csv,2025-08-17 08:45:20,32
RAM,2019,2020,LB,6,6,2,4,4,33.33,66.67,66.67,0,2025-08-15 16:41:32,ram_roster_turnover_detailed.csv,2025-08-17 08:45:20,32
RAM,2019,2020,OL,4,4,1,3,3,25.0,75.0,75.0,0,2025-08-15 16:41:32,ram_roster_turnover_detailed.csv,2025-08-17 08:45:20,32
RAM,2019,2020,OTHER,17,12,8,9,4,47.06,52.94,33.33,-5,2025-08-15 16:41:32,ram_roster_turnover_detailed.csv,2025-08-17 08:45:20,32
RAM,2019,2020,QB,2,2,1,1,1,50.0,50.0,50.0,0,2025-08-15 16:41:32,ram_roster_turnover_detailed.csv,2025-08-17 08:45:20,32
RAM,2019,2020,RB,4,5,2,2,3,50.0,50.0,60.0,1,2025-08-15 16:41:32,ram_roster_turnover_detailed.csv,2025-08-17 08:45:20,32
RAM,2019,2020,ST,3,5,2,1,3,66.67,33.33,60.0,2,2025-08-15 16:41:32,ram_roster_turnover_detailed.csv,2025-08-17 08:45:20,32
RAM,2019,2020,TE,4,4,3,1,1,75.0,25.0,25.0,0,2025-08-15 16:41:32,ram_roster_turnover_detailed.csv,2025-08-17 08:45:20,32
RAM,2019,2020,WR,7,5,4,3,1,57.14,42.86,20.0,-2,2025-08-15 16:41:32,ram_roster_turnover_detailed.csv,2025-08-17 08:45:20,32
RAM,2020,2021,DB,12,15,9,3,6,75.0,25.0,40.0,3,2025-08-15 16:41:32,ram_roster_turnover_detailed.csv,2025-08-17 08:45:20,32
RAM,2020,2021,DL,7,5,1,6,4,14.29,85.71,80.0,-2,2025-08-15 16:41:32,ram_roster_turnover_detailed.csv,2025-08-17 08:45:20,32
RAM,2020,2021,LB,6,10,3,3,7,50.0,50.0,70.0,4,2025-08-15 16:41:32,ram_roster_turnover_detailed.csv,2025-08-17 08:45:20,32
RAM,2020,2021,OL,4,5,2,2,3,50.0,50.0,60.0,1,2025-08-15 16:41:32,ram_roster_turnover_detailed.csv,2025-08-17 08:45:20,32
RAM,2020,2021,OTHER,12,14,7,5,7,58.33,41.67,50.0,2,2025-08-15 16:41:32,ram_roster_turnover_detailed.csv,2025-08-17 08:45:20,32
RAM,2020,2021,QB,2,2,1,1,1,50.0,50.0,50.0,0,2025-08-15 16:41:32,ram_roster_turnover_detailed.csv,2025-08-17 08:45:20,32
RAM,2020,2021,RB,5,6,2,3,4,40.0,60.0,66.67,1,2025-08-15 16:41:32,ram_roster_turnover_detailed.csv,2025-08-17 08:45:20,32
RAM,2020,2021,ST,5,3,2,3,1,40.0,60.0,33.33,-2,2025-08-15 16:41:32,ram_roster_turnover_detailed.csv,2025-08-17 08:45:20,32
RAM,2020,2021,TE,4,4,3,1,1,75.0,25.0,25.0,0,2025-08-15 16:41:32,ram_roster_turnover_detailed.csv,2025-08-17 08:45:20,32
RAM,2020,2021,WR,5,11,3,2,8,60.0,40.0,72.73,6,2025-08-15 16:41:32,ram_roster_turnover_detailed.csv,2025-08-17 08:45:20,32
RAM,2021,2022,DB,15,12,6,9,6,40.0,60.0,50.0,-3,2025-08-15 16:41:32,ram_roster_turnover_detailed.csv,2025-08-17 08:45:20,32
RAM,2021,2022,DL,5,10,4,1,6,80.0,20.0,60.0,5,2025-08-15 16:41:32,ram_roster_turnover_detailed.csv,2025-08-17 08:45:20,32
RAM,2021,2022,LB,10,7,3,7,4,30.0,70.0,57.14,-3,2025-08-15 16:41:32,ram_roster_turnover_detailed.csv,2025-08-17 08:45:20,32
RAM,2021,2022,OL,5,9,3,2,6,60.0,40.0,66.67,4,2025-08-15 16:41:32,ram_roster_turnover_detailed.csv,2025-08-17 08:45:20,32
RAM,2021,2022,OTHER,14,15,5,9,10,35.71,64.29,66.67,1,2025-08-15 16:41:32,ram_roster_turnover_detailed.csv,2025-08-17 08:45:20,32
RAM,2021,2022,QB,2,4,2,0,2,100.0,0.0,50.0,2,2025-08-15 16:41:32,ram_roster_turnover_detailed.csv,2025-08-17 08:45:20,32
RAM,2021,2022,RB,6,6,3,3,3,50.0,50.0,50.0,0,2025-08-15 16:41:32,ram_roster_turnover_detailed.csv,2025-08-17 08:45:20,32
RAM,2021,2022,ST,3,3,2,1,1,66.67,33.33,33.33,0,2025-08-15 16:41:32,ram_roster_turnover_detailed.csv,2025-08-17 08:45:20,32
RAM,2021,2022,TE,4,5,3,1,2,75.0,25.0,40.0,1,2025-08-15 16:41:32,ram_roster_turnover_detailed.csv,2025-08-17 08:45:20,32
RAM,2021,2022,WR,11,9,6,5,3,54.55,45.45,33.33,-2,2025-08-15 16:41:32,ram_roster_turnover_detailed.csv,2025-08-17 08:45:20,32
RAM,2022,2023,DB,12,11,5,7,6,41.67,58.33,54.55,-1,2025-08-15 16:41:32,ram_roster_turnover_detailed.csv,2025-08-17 08:45:20,32
RAM,2022,2023,DL,10,9,6,4,3,60.0,40.0,33.33,-1,2025-08-15 16:41:32,ram_roster_turnover_detailed.csv,2025-08-17 08:45:20,32
RAM,2022,2023,LB,7,11,2,5,9,28.57,71.43,81.82,4,2025-08-15 16:41:32,ram_roster_turnover_detailed.csv,2025-08-17 08:45:20,32
RAM,2022,2023,OL,9,10,4,5,6,44.44,55.56,60.0,1,2025-08-15 16:41:32,ram_roster_turnover_detailed.csv,2025-08-17 08:45:20,32
RAM,2022,2023,OTHER,15,0,0,15,0,0.0,100.0,0.0,-15,2025-08-15 16:41:32,ram_roster_turnover_detailed.csv,2025-08-17 08:45:20,32
RAM,2022,2023,QB,4,3,1,3,2,25.0,75.0,66.67,-1,2025-08-15 16:41:32,ram_roster_turnover_detailed.csv,2025-08-17 08:45:20,32
RAM,2022,2023,RB,6,7,4,2,3,66.67,33.33,42.86,1,2025-08-15 16:41:32,ram_roster_turnover_detailed.csv,2025-08-17 08:45:20,32
RAM,2022,2023,ST,3,5,0,3,5,0.0,100.0,100.0,2,2025-08-15 16:41:32,ram_roster_turnover_detailed.csv,2025-08-17 08:45:20,32
RAM,2022,2023,TE,5,4,2,3,2,40.0,60.0,50.0,-1,2025-08-15 16:41:32,ram_roster_turnover_detailed.csv,2025-08-17 08:45:20,32
RAM,2022,2023,WR,9,8,5,4,3,55.56,44.44,37.5,-1,2025-08-15 16:41:32,ram_roster_turnover_detailed.csv,2025-08-17 08:45:20,32
RAM,2023,2024,DB,11,12,4,7,8,36.36,63.64,66.67,1,2025-08-15 16:41:32,ram_roster_turnover_detailed.csv,2025-08-17 08:45:20,32
RAM,2023,2024,DL,9,5,3,6,2,33.33,66.67,40.0,-4,2025-08-15 16:41:32,ram_roster_turnover_detailed.csv,2025-08-17 08:45:20,32
RAM,2023,2024,LB,11,7,5,6,2,45.45,54.55,28.57,-4,2025-08-15 16:41:32,ram_roster_turnover_detailed.csv,2025-08-17 08:45:20,32
RAM,2023,2024,OL,10,9,2,8,7,20.0,80.0,77.78,-1,2025-08-15 16:41:32,ram_roster_turnover_detailed.csv,2025-08-17 08:45:20,32
RAM,2023,2024,OTHER,0,12,0,0,12,0.0,0.0,100.0,12,2025-08-15 16:41:32,ram_roster_turnover_detailed.csv,2025-08-17 08:45:20,32
RAM,2023,2024,QB,3,2,1,2,1,33.33,66.67,50.0,-1,2025-08-15 16:41:32,ram_roster_turnover_detailed.csv,2025-08-17 08:45:20,32
RAM,2023,2024,RB,7,4,2,5,2,28.57,71.43,50.0,-3,2025-08-15 16:41:32,ram_roster_turnover_detailed.csv,2025-08-17 08:45:20,32
RAM,2023,2024,ST,5,4,2,3,2,40.0,60.0,50.0,-1,2025-08-15 16:41:32,ram_roster_turnover_detailed.csv,2025-08-17 08:45:20,32
RAM,2023,2024,TE,4,5,3,1,2,75.0,25.0,40.0,1,2025-08-15 16:41:32,ram_roster_turnover_detailed.csv,2025-08-17 08:45:20,32
RAM,2023,2024,WR,8,7,5,3,2,62.5,37.5,28.57,-1,2025-08-15 16:41:32,ram_roster_turnover_detailed.csv,2025-08-17 08:45:20,32
RAV,2011,2012,DB,11,11,4,7,7,36.36,63.64,63.64,0,2025-08-15 16:41:33,rav_roster_turnover_detailed.csv,2025-08-17 08:45:20,32
RAV,2011,2012,DL,7,4,1,6,3,14.29,85.71,75.0,-3,2025-08-15 16:41:33,rav_roster_turnover_detailed.csv,2025-08-17 08:45:20,32
RAV,2011,2012,LB,7,5,3,4,2,42.86,57.14,40.0,-2,2025-08-15 16:41:33,rav_roster_turnover_detailed.csv,2025-08-17 08:45:20,32
RAV,2011,2012,OL,3,3,1,2,2,33.33,66.67,66.67,0,2025-08-15 16:41:33,rav_roster_turnover_detailed.csv,2025-08-17 08:45:20,32
RAV,2011,2012,OTHER,13,18,8,5,10,61.54,38.46,55.56,5,2025-08-15 16:41:33,rav_roster_turnover_detailed.csv,2025-08-17 08:45:20,32
RAV,2011,2012,QB,2,2,2,0,0,100.0,0.0,0.0,0,2025-08-15 16:41:33,rav_roster_turnover_detailed.csv,2025-08-17 08:45:20,32
RAV,2011,2012,RB,4,4,3,1,1,75.0,25.0,25.0,0,2025-08-15 16:41:33,rav_roster_turnover_detailed.csv,2025-08-17 08:45:20,32
RAV,2011,2012,ST,4,3,2,2,1,50.0,50.0,33.33,-1,2025-08-15 16:41:33,rav_roster_turnover_detailed.csv,2025-08-17 08:45:20,32
RAV,2011,2012,TE,3,3,2,1,1,66.67,33.33,33.33,0,2025-08-15 16:41:33,rav_roster_turnover_detailed.csv,2025-08-17 08:45:20,32
RAV,2011,2012,WR,6,7,5,1,2,83.33,16.67,28.57,1,2025-08-15 16:41:33,rav_roster_turnover_detailed.csv,2025-08-17 08:45:20,32
RAV,2012,2013,DB,11,10,5,6,5,45.45,54.55,50.0,-1,2025-08-15 16:41:33,rav_roster_turnover_detailed.csv,2025-08-17 08:45:20,32
RAV,2012,2013,DL,4,6,2,2,4,50.0,50.0,66.67,2,2025-08-15 16:41:33,rav_roster_turnover_detailed.csv,2025-08-17 08:45:20,32
RAV,2012,2013,LB,5,5,0,5,5,0.0,100.0,100.0,0,2025-08-15 16:41:33,rav_roster_turnover_detailed.csv,2025-08-17 08:45:20,32
RAV,2012,2013,OL,3,3,1,2,2,33.33,66.67,66.67,0,2025-08-15 16:41:33,rav_roster_turnover_detailed.csv,2025-08-17 08:45:20,32
RAV,2012,2013,OTHER,18,15,8,10,7,44.44,55.56,46.67,-3,2025-08-15 16:41:33,rav_roster_turnover_detailed.csv,2025-08-17 08:45:20,32
RAV,2012,2013,QB,2,2,2,0,0,100.0,0.0,0.0,0,2025-08-15 16:41:33,rav_roster_turnover_detailed.csv,2025-08-17 08:45:20,32
RAV,2012,2013,RB,4,6,3,1,3,75.0,25.0,50.0,2,2025-08-15 16:41:33,rav_roster_turnover_detailed.csv,2025-08-17 08:45:20,32
RAV,2012,2013,ST,3,3,3,0,0,100.0,0.0,0.0,0,2025-08-15 16:41:33,rav_roster_turnover_detailed.csv,2025-08-17 08:45:20,32
RAV,2012,2013,TE,3,4,3,0,1,100.0,0.0,25.0,1,2025-08-15 16:41:33,rav_roster_turnover_detailed.csv,2025-08-17 08:45:20,32
RAV,2012,2013,WR,7,6,4,3,2,57.14,42.86,33.33,-1,2025-08-15 16:41:33,rav_roster_turnover_detailed.csv,2025-08-17 08:45:20,32
RAV,2013,2014,DB,10,13,5,5,8,50.0,50.0,61.54,3,2025-08-15 16:41:33,rav_roster_turnover_detailed.csv,2025-08-17 08:45:20,32
RAV,2013,2014,DL,6,8,4,2,4,66.67,33.33,50.0,2,2025-08-15 16:41:33,rav_roster_turnover_detailed.csv,2025-08-17 08:45:20,32
RAV,2013,2014,LB,5,4,3,2,1,60.0,40.0,25.0,-1,2025-08-15 16:41:33,rav_roster_turnover_detailed.csv,2025-08-17 08:45:20,32
RAV,2013,2014,OL,3,5,2,1,3,66.67,33.33,60.0,2,2025-08-15 16:41:33,rav_roster_turnover_detailed.csv,2025-08-17 08:45:20,32
RAV,2013,2014,OTHER,15,14,9,6,5,60.0,40.0,35.71,-1,2025-08-15 16:41:33,rav_roster_turnover_detailed.csv,2025-08-17 08:45:20,32
RAV,2013,2014,QB,2,2,2,0,0,100.0,0.0,0.0,0,2025-08-15 16:41:33,rav_roster_turnover_detailed.csv,2025-08-17 08:45:20,32
RAV,2013,2014,RB,6,6,2,4,4,33.33,66.67,66.67,0,2025-08-15 16:41:33,rav_roster_turnover_detailed.csv,2025-08-17 08:45:20,32
RAV,2013,2014,ST,3,5,3,0,2,100.0,0.0,40.0,2,2025-08-15 16:41:33,rav_roster_turnover_detailed.csv,2025-08-17 08:45:20,32
RAV,2013,2014,TE,4,4,1,3,3,25.0,75.0,75.0,0,2025-08-15 16:41:33,rav_roster_turnover_detailed.csv,2025-08-17 08:45:20,32
RAV,2013,2014,WR,6,6,3,3,3,50.0,50.0,50.0,0,2025-08-15 16:41:33,rav_roster_turnover_detailed.csv,2025-08-17 08:45:20,32
RAV,2014,2015,DB,13,12,5,8,7,38.46,61.54,58.33,-1,2025-08-15 16:41:33,rav_roster_turnover_detailed.csv,2025-08-17 08:45:20,32
RAV,2014,2015,DL,8,5,1,7,4,12.5,87.5,80.0,-3,2025-08-15 16:41:33,rav_roster_turnover_detailed.csv,2025-08-17 08:45:20,32
RAV,2014,2015,LB,4,6,3,1,3,75.0,25.0,50.0,2,2025-08-15 16:41:33,rav_roster_turnover_detailed.csv,2025-08-17 08:45:20,32
RAV,2014,2015,OL,5,4,2,3,2,40.0,60.0,50.0,-1,2025-08-15 16:41:33,rav_roster_turnover_detailed.csv,2025-08-17 08:45:20,32
RAV,2014,2015,OTHER,14,16,11,3,5,78.57,21.43,31.25,2,2025-08-15 16:41:33,rav_roster_turnover_detailed.csv,2025-08-17 08:45:20,32
RAV,2014,2015,QB,2,4,1,1,3,50.0,50.0,75.0,2,2025-08-15 16:41:33,rav_roster_turnover_detailed.csv,2025-08-17 08:45:20,32
RAV,2014,2015,RB,6,7,3,3,4,50.0,50.0,57.14,1,2025-08-15 16:41:33,rav_roster_turnover_detailed.csv,2025-08-17 08:45:20,32
RAV,2014,2015,ST,5,3,3,2,0,60.0,40.0,0.0,-2,2025-08-15 16:41:33,rav_roster_turnover_detailed.csv,2025-08-17 08:45:20,32
RAV,2014,2015,TE,4,4,1,3,3,25.0,75.0,75.0,0,2025-08-15 16:41:33,rav_roster_turnover_detailed.csv,2025-08-17 08:45:20,32
RAV,2014,2015,WR,6,11,4,2,7,66.67,33.33,63.64,5,2025-08-15 16:41:33,rav_roster_turnover_detailed.csv,2025-08-17 08:45:20,32
RAV,2015,2016,DB,12,12,3,9,9,25.0,75.0,75.0,0,2025-08-15 16:41:33,rav_roster_turnover_detailed.csv,2025-08-17 08:45:20,32
RAV,2015,2016,DL,5,5,3,2,2,60.0,40.0,40.0,0,2025-08-15 16:41:33,rav_roster_turnover_detailed.csv,2025-08-17 08:45:20,32
RAV,2015,2016,LB,6,5,1,5,4,16.67,83.33,80.0,-1,2025-08-15 16:41:33,rav_roster_turnover_detailed.csv,2025-08-17 08:45:20,32
RAV,2015,2016,OL,4,4,2,2,2,50.0,50.0,50.0,0,2025-08-15 16:41:33,rav_roster_turnover_detailed.csv,2025-08-17 08:45:20,32
RAV,2015,2016,OTHER,16,14,7,9,7,43.75,56.25,50.0,-2,2025-08-15 16:41:33,rav_roster_turnover_detailed.csv,2025-08-17 08:45:20,32
RAV,2015,2016,QB,4,2,2,2,0,50.0,50.0,0.0,-2,2025-08-15 16:41:33,rav_roster_turnover_detailed.csv,2025-08-17 08:45:20,32
RAV,2015,2016,RB,7,6,5,2,1,71.43,28.57,16.67,-1,2025-08-15 16:41:33,rav_roster_turnover_detailed.csv,2025-08-17 08:45:20,32
RAV,2015,2016,ST,3,3,3,0,0,100.0,0.0,0.0,0,2025-08-15 16:41:33,rav_roster_turnover_detailed.csv,2025-08-17 08:45:20,32
RAV,2015,2016,TE,4,4,3,1,1,75.0,25.0,25.0,0,2025-08-15 16:41:33,rav_roster_turnover_detailed.csv,2025-08-17 08:45:20,32
RAV,2015,2016,WR,11,9,5,6,4,45.45,54.55,44.44,-2,2025-08-15 16:41:33,rav_roster_turnover_detailed.csv,2025-08-17 08:45:20,32
RAV,2016,2017,DB,12,10,4,8,6,33.33,66.67,60.0,-2,2025-08-15 16:41:33,rav_roster_turnover_detailed.csv,2025-08-17 08:45:20,32
RAV,2016,2017,DL,5,8,3,2,5,60.0,40.0,62.5,3,2025-08-15 16:41:33,rav_roster_turnover_detailed.csv,2025-08-17 08:45:20,32
RAV,2016,2017,LB,5,5,1,4,4,20.0,80.0,80.0,0,2025-08-15 16:41:33,rav_roster_turnover_detailed.csv,2025-08-17 08:45:20,32
RAV,2016,2017,OL,4,6,1,3,5,25.0,75.0,83.33,2,2025-08-15 16:41:33,rav_roster_turnover_detailed.csv,2025-08-17 08:45:20,32
RAV,2016,2017,OTHER,14,12,4,10,8,28.57,71.43,66.67,-2,2025-08-15 16:41:33,rav_roster_turnover_detailed.csv,2025-08-17 08:45:20,32
RAV,2016,2017,QB,2,2,2,0,0,100.0,0.0,0.0,0,2025-08-15 16:41:33,rav_roster_turnover_detailed.csv,2025-08-17 08:45:20,32
RAV,2016,2017,RB,6,5,2,4,3,33.33,66.67,60.0,-1,2025-08-15 16:41:33,rav_roster_turnover_detailed.csv,2025-08-17 08:45:20,32
RAV,2016,2017,ST,3,3,3,0,0,100.0,0.0,0.0,0,2025-08-15 16:41:33,rav_roster_turnover_detailed.csv,2025-08-17 08:45:20,32
RAV,2016,2017,TE,4,4,2,2,2,50.0,50.0,50.0,0,2025-08-15 16:41:33,rav_roster_turnover_detailed.csv,2025-08-17 08:45:20,32
RAV,2016,2017,WR,9,9,4,5,5,44.44,55.56,55.56,0,2025-08-15 16:41:33,rav_roster_turnover_detailed.csv,2025-08-17 08:45:20,32
RAV,2017,2018,DB,10,10,5,5,5,50.0,50.0,50.0,0,2025-08-15 16:41:33,rav_roster_turnover_detailed.csv,2025-08-17 08:45:20,32
RAV,2017,2018,DL,8,6,5,3,1,62.5,37.5,16.67,-2,2025-08-15 16:41:33,rav_roster_turnover_detailed.csv,2025-08-17 08:45:20,32
RAV,2017,2018,LB,5,4,1,4,3,20.0,80.0,75.0,-1,2025-08-15 16:41:33,rav_roster_turnover_detailed.csv,2025-08-17 08:45:20,32
RAV,2017,2018,OL,6,4,1,5,3,16.67,83.33,75.0,-2,2025-08-15 16:41:33,rav_roster_turnover_detailed.csv,2025-08-17 08:45:20,32
RAV,2017,2018,OTHER,12,15,9,3,6,75.0,25.0,40.0,3,2025-08-15 16:41:33,rav_roster_turnover_detailed.csv,2025-08-17 08:45:20,32
RAV,2017,2018,QB,2,3,1,1,2,50.0,50.0,66.67,1,2025-08-15 16:41:33,rav_roster_turnover_detailed.csv,2025-08-17 08:45:20,32
RAV,2017,2018,RB,5,5,2,3,3,40.0,60.0,60.0,0,2025-08-15 16:41:33,rav_roster_turnover_detailed.csv,2025-08-17 08:45:20,32
RAV,2017,2018,ST,3,3,3,0,0,100.0,0.0,0.0,0,2025-08-15 16:41:33,rav_roster_turnover_detailed.csv,2025-08-17 08:45:20,32
RAV,2017,2018,TE,4,4,2,2,2,50.0,50.0,50.0,0,2025-08-15 16:41:33,rav_roster_turnover_detailed.csv,2025-08-17 08:45:20,32
RAV,2017,2018,WR,9,7,1,8,6,11.11,88.89,85.71,-2,2025-08-15 16:41:33,rav_roster_turnover_detailed.csv,2025-08-17 08:45:20,32
RAV,2018,2019,DB,10,15,6,4,9,60.0,40.0,60.0,5,2025-08-15 16:41:33,rav_roster_turnover_detailed.csv,2025-08-17 08:45:20,32
RAV,2018,2019,DL,6,7,3,3,4,50.0,50.0,57.14,1,2025-08-15 16:41:33,rav_roster_turnover_detailed.csv,2025-08-17 08:45:20,32
RAV,2018,2019,LB,4,3,3,1,0,75.0,25.0,0.0,-1,2025-08-15 16:41:33,rav_roster_turnover_detailed.csv,2025-08-17 08:45:20,32
RAV,2018,2019,OL,4,6,2,2,4,50.0,50.0,66.67,2,2025-08-15 16:41:33,rav_roster_turnover_detailed.csv,2025-08-17 08:45:20,32
RAV,2018,2019,OTHER,15,14,8,7,6,53.33,46.67,42.86,-1,2025-08-15 16:41:33,rav_roster_turnover_detailed.csv,2025-08-17 08:45:20,32
RAV,2018,2019,QB,3,3,2,1,1,66.67,33.33,33.33,0,2025-08-15 16:41:33,rav_roster_turnover_detailed.csv,2025-08-17 08:45:20,32
RAV,2018,2019,RB,5,5,1,4,4,20.0,80.0,80.0,0,2025-08-15 16:41:33,rav_roster_turnover_detailed.csv,2025-08-17 08:45:20,32
RAV,2018,2019,ST,3,3,3,0,0,100.0,0.0,0.0,0,2025-08-15 16:41:33,rav_roster_turnover_detailed.csv,2025-08-17 08:45:20,32
RAV,2018,2019,TE,4,3,3,1,0,75.0,25.0,0.0,-1,2025-08-15 16:41:33,rav_roster_turnover_detailed.csv,2025-08-17 08:45:20,32
RAV,2018,2019,WR,7,6,2,5,4,28.57,71.43,66.67,-1,2025-08-15 16:41:33,rav_roster_turnover_detailed.csv,2025-08-17 08:45:20,32
RAV,2019,2020,DB,15,15,6,9,9,40.0,60.0,60.0,0,2025-08-15 16:41:33,rav_roster_turnover_detailed.csv,2025-08-17 08:45:20,32
RAV,2019,2020,DL,7,9,2,5,7,28.57,71.43,77.78,2,2025-08-15 16:41:33,rav_roster_turnover_detailed.csv,2025-08-17 08:45:20,32
RAV,2019,2020,LB,3,5,2,1,3,66.67,33.33,60.0,2,2025-08-15 16:41:33,rav_roster_turnover_detailed.csv,2025-08-17 08:45:20,32
RAV,2019,2020,OL,6,5,2,4,3,33.33,66.67,60.0,-1,2025-08-15 16:41:33,rav_roster_turnover_detailed.csv,2025-08-17 08:45:20,32
RAV,2019,2020,OTHER,14,15,7,7,8,50.0,50.0,53.33,1,2025-08-15 16:41:33,rav_roster_turnover_detailed.csv,2025-08-17 08:45:20,32
RAV,2019,2020,QB,3,4,3,0,1,100.0,0.0,25.0,1,2025-08-15 16:41:33,rav_roster_turnover_detailed.csv,2025-08-17 08:45:20,32
RAV,2019,2020,RB,5,5,4,1,1,80.0,20.0,20.0,0,2025-08-15 16:41:33,rav_roster_turnover_detailed.csv,2025-08-17 08:45:20,32
RAV,2019,2020,ST,3,5,3,0,2,100.0,0.0,40.0,2,2025-08-15 16:41:33,rav_roster_turnover_detailed.csv,2025-08-17 08:45:20,32
RAV,2019,2020,TE,3,5,2,1,3,66.67,33.33,60.0,2,2025-08-15 16:41:33,rav_roster_turnover_detailed.csv,2025-08-17 08:45:20,32
RAV,2019,2020,WR,6,7,4,2,3,66.67,33.33,42.86,1,2025-08-15 16:41:33,rav_roster_turnover_detailed.csv,2025-08-17 08:45:20,32
RAV,2020,2021,DB,15,15,7,8,8,46.67,53.33,53.33,0,2025-08-15 16:41:33,rav_roster_turnover_detailed.csv,2025-08-17 08:45:20,32
RAV,2020,2021,DL,9,9,4,5,5,44.44,55.56,55.56,0,2025-08-15 16:41:33,rav_roster_turnover_detailed.csv,2025-08-17 08:45:20,32
RAV,2020,2021,LB,5,3,2,3,1,40.0,60.0,33.33,-2,2025-08-15 16:41:33,rav_roster_turnover_detailed.csv,2025-08-17 08:45:20,32
RAV,2020,2021,OL,5,9,1,4,8,20.0,80.0,88.89,4,2025-08-15 16:41:33,rav_roster_turnover_detailed.csv,2025-08-17 08:45:20,32
RAV,2020,2021,OTHER,15,14,6,9,8,40.0,60.0,57.14,-1,2025-08-15 16:41:33,rav_roster_turnover_detailed.csv,2025-08-17 08:45:20,32
RAV,2020,2021,QB,4,3,2,2,1,50.0,50.0,33.33,-1,2025-08-15 16:41:33,rav_roster_turnover_detailed.csv,2025-08-17 08:45:20,32
RAV,2020,2021,RB,5,7,1,4,6,20.0,80.0,85.71,2,2025-08-15 16:41:33,rav_roster_turnover_detailed.csv,2025-08-17 08:45:20,32
RAV,2020,2021,ST,5,3,3,2,0,60.0,40.0,0.0,-2,2025-08-15 16:41:33,rav_roster_turnover_detailed.csv,2025-08-17 08:45:20,32
RAV,2020,2021,TE,5,5,3,2,2,60.0,40.0,40.0,0,2025-08-15 16:41:33,rav_roster_turnover_detailed.csv,2025-08-17 08:45:20,32
RAV,2020,2021,WR,7,7,4,3,3,57.14,42.86,42.86,0,2025-08-15 16:41:33,rav_roster_turnover_detailed.csv,2025-08-17 08:45:20,32
RAV,2021,2022,DB,15,11,6,9,5,40.0,60.0,45.45,-4,2025-08-15 16:41:33,rav_roster_turnover_detailed.csv,2025-08-17 08:45:20,32
RAV,2021,2022,DL,9,8,2,7,6,22.22,77.78,75.0,-1,2025-08-15 16:41:33,rav_roster_turnover_detailed.csv,2025-08-17 08:45:20,32
RAV,2021,2022,LB,3,14,1,2,13,33.33,66.67,92.86,11,2025-08-15 16:41:33,rav_roster_turnover_detailed.csv,2025-08-17 08:45:20,32
RAV,2021,2022,OL,9,5,2,7,3,22.22,77.78,60.0,-4,2025-08-15 16:41:33,rav_roster_turnover_detailed.csv,2025-08-17 08:45:20,32
RAV,2021,2022,OTHER,14,11,6,8,5,42.86,57.14,45.45,-3,2025-08-15 16:41:33,rav_roster_turnover_detailed.csv,2025-08-17 08:45:20,32
RAV,2021,2022,QB,3,3,2,1,1,66.67,33.33,33.33,0,2025-08-15 16:41:33,rav_roster_turnover_detailed.csv,2025-08-17 08:45:20,32
RAV,2021,2022,RB,7,6,1,6,5,14.29,85.71,83.33,-1,2025-08-15 16:41:33,rav_roster_turnover_detailed.csv,2025-08-17 08:45:20,32
RAV,2021,2022,ST,3,3,2,1,1,66.67,33.33,33.33,0,2025-08-15 16:41:33,rav_roster_turnover_detailed.csv,2025-08-17 08:45:20,32
RAV,2021,2022,TE,5,5,3,2,2,60.0,40.0,40.0,0,2025-08-15 16:41:33,rav_roster_turnover_detailed.csv,2025-08-17 08:45:20,32
RAV,2021,2022,WR,7,10,5,2,5,71.43,28.57,50.0,3,2025-08-15 16:41:33,rav_roster_turnover_detailed.csv,2025-08-17 08:45:20,32
RAV,2022,2023,DB,11,14,9,2,5,81.82,18.18,35.71,3,2025-08-15 16:41:33,rav_roster_turnover_detailed.csv,2025-08-17 08:45:20,32
RAV,2022,2023,DL,8,5,5,3,0,62.5,37.5,0.0,-3,2025-08-15 16:41:33,rav_roster_turnover_detailed.csv,2025-08-17 08:45:20,32
RAV,2022,2023,LB,14,12,4,10,8,28.57,71.43,66.67,-2,2025-08-15 16:41:33,rav_roster_turnover_detailed.csv,2025-08-17 08:45:20,32
RAV,2022,2023,OL,5,9,3,2,6,60.0,40.0,66.67,4,2025-08-15 16:41:33,rav_roster_turnover_detailed.csv,2025-08-17 08:45:20,32
RAV,2022,2023,OTHER,11,1,0,11,1,0.0,100.0,100.0,-10,2025-08-15 16:41:33,rav_roster_turnover_detailed.csv,2025-08-17 08:45:20,32
RAV,2022,2023,QB,3,3,2,1,1,66.67,33.33,33.33,0,2025-08-15 16:41:33,rav_roster_turnover_detailed.csv,2025-08-17 08:45:20,32
RAV,2022,2023,RB,6,10,5,1,5,83.33,16.67,50.0,4,2025-08-15 16:41:33,rav_roster_turnover_detailed.csv,2025-08-17 08:45:20,32
RAV,2022,2023,ST,3,3,2,1,1,66.67,33.33,33.33,0,2025-08-15 16:41:33,rav_roster_turnover_detailed.csv,2025-08-17 08:45:20,32
RAV,2022,2023,TE,5,3,3,2,0,60.0,40.0,0.0,-2,2025-08-15 16:41:33,rav_roster_turnover_detailed.csv,2025-08-17 08:45:20,32
RAV,2022,2023,WR,10,8,3,7,5,30.0,70.0,62.5,-2,2025-08-15 16:41:33,rav_roster_turnover_detailed.csv,2025-08-17 08:45:20,32
RAV,2023,2024,DB,14,14,5,9,9,35.71,64.29,64.29,0,2025-08-15 16:41:33,rav_roster_turnover_detailed.csv,2025-08-17 08:45:20,32
RAV,2023,2024,DL,5,7,5,0,2,100.0,0.0,28.57,2,2025-08-15 16:41:33,rav_roster_turnover_detailed.csv,2025-08-17 08:45:20,32
RAV,2023,2024,LB,12,9,4,8,5,33.33,66.67,55.56,-3,2025-08-15 16:41:33,rav_roster_turnover_detailed.csv,2025-08-17 08:45:20,32
RAV,2023,2024,OL,9,5,2,7,3,22.22,77.78,60.0,-4,2025-08-15 16:41:33,rav_roster_turnover_detailed.csv,2025-08-17 08:45:20,32
RAV,2023,2024,OTHER,1,10,0,1,10,0.0,100.0,100.0,9,2025-08-15 16:41:33,rav_roster_turnover_detailed.csv,2025-08-17 08:45:20,32
RAV,2023,2024,QB,3,2,1,2,1,33.33,66.67,50.0,-1,2025-08-15 16:41:33,rav_roster_turnover_detailed.csv,2025-08-17 08:45:20,32
RAV,2023,2024,RB,10,7,3,7,4,30.0,70.0,57.14,-3,2025-08-15 16:41:33,rav_roster_turnover_detailed.csv,2025-08-17 08:45:20,32
RAV,2023,2024,ST,3,3,2,1,1,66.67,33.33,33.33,0,2025-08-15 16:41:33,rav_roster_turnover_detailed.csv,2025-08-17 08:45:20,32
RAV,2023,2024,TE,3,3,3,0,0,100.0,0.0,0.0,0,2025-08-15 16:41:33,rav_roster_turnover_detailed.csv,2025-08-17 08:45:20,32
RAV,2023,2024,WR,8,9,4,4,5,50.0,50.0,55.56,1,2025-08-15 16:41:33,rav_roster_turnover_detailed.csv,2025-08-17 08:45:20,32
SDG,2011,2012,DB,9,10,4,5,6,44.44,55.56,60.0,1,2025-08-15 16:41:32,sdg_roster_turnover_detailed.csv,2025-08-17 08:45:20,32
SDG,2011,2012,DL,8,6,3,5,3,37.5,62.5,50.0,-2,2025-08-15 16:41:32,sdg_roster_turnover_detailed.csv,2025-08-17 08:45:20,32
SDG,2011,2012,LB,5,7,2,3,5,40.0,60.0,71.43,2,2025-08-15 16:41:32,sdg_roster_turnover_detailed.csv,2025-08-17 08:45:20,32
SDG,2011,2012,OL,7,8,3,4,5,42.86,57.14,62.5,1,2025-08-15 16:41:32,sdg_roster_turnover_detailed.csv,2025-08-17 08:45:20,32
SDG,2011,2012,OTHER,15,12,10,5,2,66.67,33.33,16.67,-3,2025-08-15 16:41:32,sdg_roster_turnover_detailed.csv,2025-08-17 08:45:20,32
SDG,2011,2012,QB,2,1,1,1,0,50.0,50.0,0.0,-1,2025-08-15 16:41:32,sdg_roster_turnover_detailed.csv,2025-08-17 08:45:20,32
SDG,2011,2012,RB,4,5,2,2,3,50.0,50.0,60.0,1,2025-08-15 16:41:32,sdg_roster_turnover_detailed.csv,2025-08-17 08:45:20,32
SDG,2011,2012,ST,4,5,4,0,1,100.0,0.0,20.0,1,2025-08-15 16:41:32,sdg_roster_turnover_detailed.csv,2025-08-17 08:45:20,32
SDG,2011,2012,TE,3,4,2,1,2,66.67,33.33,50.0,1,2025-08-15 16:41:32,sdg_roster_turnover_detailed.csv,2025-08-17 08:45:20,32
SDG,2011,2012,WR,6,7,2,4,5,33.33,66.67,71.43,1,2025-08-15 16:41:32,sdg_roster_turnover_detailed.csv,2025-08-17 08:45:20,32
SDG,2012,2013,DB,10,6,3,7,3,30.0,70.0,50.0,-4,2025-08-15 16:41:32,sdg_roster_turnover_detailed.csv,2025-08-17 08:45:20,32
SDG,2012,2013,DL,6,6,1,5,5,16.67,83.33,83.33,0,2025-08-15 16:41:32,sdg_roster_turnover_detailed.csv,2025-08-17 08:45:20,32
SDG,2012,2013,LB,7,7,3,4,4,42.86,57.14,57.14,0,2025-08-15 16:41:32,sdg_roster_turnover_detailed.csv,2025-08-17 08:45:20,32
SDG,2012,2013,OL,8,7,2,6,5,25.0,75.0,71.43,-1,2025-08-15 16:41:32,sdg_roster_turnover_detailed.csv,2025-08-17 08:45:20,32
SDG,2012,2013,OTHER,12,15,4,8,11,33.33,66.67,73.33,3,2025-08-15 16:41:32,sdg_roster_turnover_detailed.csv,2025-08-17 08:45:20,32
SDG,2012,2013,QB,1,2,1,0,1,100.0,0.0,50.0,1,2025-08-15 16:41:32,sdg_roster_turnover_detailed.csv,2025-08-17 08:45:20,32
SDG,2012,2013,RB,5,6,3,2,3,60.0,40.0,50.0,1,2025-08-15 16:41:32,sdg_roster_turnover_detailed.csv,2025-08-17 08:45:20,32
SDG,2012,2013,ST,5,3,3,2,0,60.0,40.0,0.0,-2,2025-08-15 16:41:32,sdg_roster_turnover_detailed.csv,2025-08-17 08:45:20,32
SDG,2012,2013,TE,4,3,1,3,2,25.0,75.0,66.67,-1,2025-08-15 16:41:32,sdg_roster_turnover_detailed.csv,2025-08-17 08:45:20,32
SDG,2012,2013,WR,7,7,3,4,4,42.86,57.14,57.14,0,2025-08-15 16:41:32,sdg_roster_turnover_detailed.csv,2025-08-17 08:45:20,32
SDG,2013,2014,DB,6,9,4,2,5,66.67,33.33,55.56,3,2025-08-15 16:41:32,sdg_roster_turnover_detailed.csv,2025-08-17 08:45:20,32
SDG,2013,2014,DL,6,5,2,4,3,33.33,66.67,60.0,-1,2025-08-15 16:41:32,sdg_roster_turnover_detailed.csv,2025-08-17 08:45:20,32
SDG,2013,2014,LB,7,5,1,6,4,14.29,85.71,80.0,-2,2025-08-15 16:41:32,sdg_roster_turnover_detailed.csv,2025-08-17 08:45:20,32
SDG,2013,2014,OL,7,8,3,4,5,42.86,57.14,62.5,1,2025-08-15 16:41:32,sdg_roster_turnover_detailed.csv,2025-08-17 08:45:20,32
SDG,2013,2014,OTHER,15,15,10,5,5,66.67,33.33,33.33,0,2025-08-15 16:41:32,sdg_roster_turnover_detailed.csv,2025-08-17 08:45:20,32
SDG,2013,2014,QB,2,2,1,1,1,50.0,50.0,50.0,0,2025-08-15 16:41:32,sdg_roster_turnover_detailed.csv,2025-08-17 08:45:20,32
SDG,2013,2014,RB,6,6,3,3,3,50.0,50.0,50.0,0,2025-08-15 16:41:32,sdg_roster_turnover_detailed.csv,2025-08-17 08:45:20,32
SDG,2013,2014,ST,3,4,3,0,1,100.0,0.0,25.0,1,2025-08-15 16:41:32,sdg_roster_turnover_detailed.csv,2025-08-17 08:45:20,32
SDG,2013,2014,TE,3,4,2,1,2,66.67,33.33,50.0,1,2025-08-15 16:41:32,sdg_roster_turnover_detailed.csv,2025-08-17 08:45:20,32
SDG,2013,2014,WR,7,6,4,3,2,57.14,42.86,33.33,-1,2025-08-15 16:41:32,sdg_roster_turnover_detailed.csv,2025-08-17 08:45:20,32
SDG,2014,2015,DB,9,12,5,4,7,55.56,44.44,58.33,3,2025-08-15 16:41:32,sdg_roster_turnover_detailed.csv,2025-08-17 08:45:20,32
SDG,2014,2015,DL,5,6,3,2,3,60.0,40.0,50.0,1,2025-08-15 16:41:32,sdg_roster_turnover_detailed.csv,2025-08-17 08:45:20,32
SDG,2014,2015,LB,5,5,1,4,4,20.0,80.0,80.0,0,2025-08-15 16:41:32,sdg_roster_turnover_detailed.csv,2025-08-17 08:45:20,32
SDG,2014,2015,OL,8,6,2,6,4,25.0,75.0,66.67,-2,2025-08-15 16:41:32,sdg_roster_turnover_detailed.csv,2025-08-17 08:45:20,32
SDG,2014,2015,OTHER,15,15,8,7,7,53.33,46.67,46.67,0,2025-08-15 16:41:32,sdg_roster_turnover_detailed.csv,2025-08-17 08:45:20,32
SDG,2014,2015,QB,2,2,2,0,0,100.0,0.0,0.0,0,2025-08-15 16:41:32,sdg_roster_turnover_detailed.csv,2025-08-17 08:45:20,32
SDG,2014,2015,RB,6,5,3,3,2,50.0,50.0,40.0,-1,2025-08-15 16:41:32,sdg_roster_turnover_detailed.csv,2025-08-17 08:45:20,32
SDG,2014,2015,ST,4,3,2,2,1,50.0,50.0,33.33,-1,2025-08-15 16:41:32,sdg_roster_turnover_detailed.csv,2025-08-17 08:45:20,32
SDG,2014,2015,TE,4,5,4,0,1,100.0,0.0,20.0,1,2025-08-15 16:41:32,sdg_roster_turnover_detailed.csv,2025-08-17 08:45:20,32
SDG,2014,2015,WR,6,8,3,3,5,50.0,50.0,62.5,2,2025-08-15 16:41:32,sdg_roster_turnover_detailed.csv,2025-08-17 08:45:20,32
SDG,2015,2016,DB,12,10,4,8,6,33.33,66.67,60.0,-2,2025-08-15 16:41:32,sdg_roster_turnover_detailed.csv,2025-08-17 08:45:20,32
SDG,2015,2016,DL,6,6,3,3,3,50.0,50.0,50.0,0,2025-08-15 16:41:32,sdg_roster_turnover_detailed.csv,2025-08-17 08:45:20,32
SDG,2015,2016,LB,5,8,1,4,7,20.0,80.0,87.5,3,2025-08-15 16:41:32,sdg_roster_turnover_detailed.csv,2025-08-17 08:45:20,32
SDG,2015,2016,OL,6,4,1,5,3,16.67,83.33,75.0,-2,2025-08-15 16:41:32,sdg_roster_turnover_detailed.csv,2025-08-17 08:45:20,32
SDG,2015,2016,OTHER,15,16,9,6,7,60.0,40.0,43.75,1,2025-08-15 16:41:32,sdg_roster_turnover_detailed.csv,2025-08-17 08:45:20,32
SDG,2015,2016,QB,2,2,2,0,0,100.0,0.0,0.0,0,2025-08-15 16:41:32,sdg_roster_turnover_detailed.csv,2025-08-17 08:45:20,32
SDG,2015,2016,RB,5,6,2,3,4,40.0,60.0,66.67,1,2025-08-15 16:41:32,sdg_roster_turnover_detailed.csv,2025-08-17 08:45:20,32
SDG,2015,2016,ST,3,3,2,1,1,66.67,33.33,33.33,0,2025-08-15 16:41:32,sdg_roster_turnover_detailed.csv,2025-08-17 08:45:20,32
SDG,2015,2016,TE,5,4,1,4,3,20.0,80.0,75.0,-1,2025-08-15 16:41:32,sdg_roster_turnover_detailed.csv,2025-08-17 08:45:20,32
SDG,2015,2016,WR,8,9,3,5,6,37.5,62.5,66.67,1,2025-08-15 16:41:32,sdg_roster_turnover_detailed.csv,2025-08-17 08:45:20,32
SDG,2016,2017,DB,10,9,4,6,5,40.0,60.0,55.56,-1,2025-08-15 16:41:32,sdg_roster_turnover_detailed.csv,2025-08-17 08:45:20,32
SDG,2016,2017,DL,6,4,3,3,1,50.0,50.0,25.0,-2,2025-08-15 16:41:32,sdg_roster_turnover_detailed.csv,2025-08-17 08:45:20,32
SDG,2016,2017,LB,8,8,2,6,6,25.0,75.0,75.0,0,2025-08-15 16:41:32,sdg_roster_turnover_detailed.csv,2025-08-17 08:45:20,32
SDG,2016,2017,OL,4,5,1,3,4,25.0,75.0,80.0,1,2025-08-15 16:41:32,sdg_roster_turnover_detailed.csv,2025-08-17 08:45:20,32
SDG,2016,2017,OTHER,16,15,9,7,6,56.25,43.75,40.0,-1,2025-08-15 16:41:32,sdg_roster_turnover_detailed.csv,2025-08-17 08:45:20,32
SDG,2016,2017,QB,2,2,2,0,0,100.0,0.0,0.0,0,2025-08-15 16:41:32,sdg_roster_turnover_detailed.csv,2025-08-17 08:45:20,32
SDG,2016,2017,RB,6,5,3,3,2,50.0,50.0,40.0,-1,2025-08-15 16:41:32,sdg_roster_turnover_detailed.csv,2025-08-17 08:45:20,32
SDG,2016,2017,ST,3,6,2,1,4,66.67,33.33,66.67,3,2025-08-15 16:41:32,sdg_roster_turnover_detailed.csv,2025-08-17 08:45:20,32
SDG,2016,2017,TE,4,5,3,1,2,75.0,25.0,40.0,1,2025-08-15 16:41:32,sdg_roster_turnover_detailed.csv,2025-08-17 08:45:20,32
SDG,2016,2017,WR,9,6,5,4,1,55.56,44.44,16.67,-3,2025-08-15 16:41:32,sdg_roster_turnover_detailed.csv,2025-08-17 08:45:20,32
SDG,2017,2018,DB,9,9,5,4,4,55.56,44.44,44.44,0,2025-08-15 16:41:32,sdg_roster_turnover_detailed.csv,2025-08-17 08:45:20,32
SDG,2017,2018,DL,4,4,1,3,3,25.0,75.0,75.0,0,2025-08-15 16:41:32,sdg_roster_turnover_detailed.csv,2025-08-17 08:45:20,32
SDG,2017,2018,LB,8,8,2,6,6,25.0,75.0,75.0,0,2025-08-15 16:41:32,sdg_roster_turnover_detailed.csv,2025-08-17 08:45:20,32
SDG,2017,2018,OL,5,6,0,5,6,0.0,100.0,100.0,1,2025-08-15 16:41:32,sdg_roster_turnover_detailed.csv,2025-08-17 08:45:20,32
SDG,2017,2018,OTHER,15,14,10,5,4,66.67,33.33,28.57,-1,2025-08-15 16:41:32,sdg_roster_turnover_detailed.csv,2025-08-17 08:45:20,32
SDG,2017,2018,QB,2,2,1,1,1,50.0,50.0,50.0,0,2025-08-15 16:41:32,sdg_roster_turnover_detailed.csv,2025-08-17 08:45:20,32
SDG,2017,2018,RB,5,5,3,2,2,60.0,40.0,40.0,0,2025-08-15 16:41:32,sdg_roster_turnover_detailed.csv,2025-08-17 08:45:20,32
SDG,2017,2018,ST,6,6,3,3,3,50.0,50.0,50.0,0,2025-08-15 16:41:32,sdg_roster_turnover_detailed.csv,2025-08-17 08:45:20,32
SDG,2017,2018,TE,5,4,3,2,1,60.0,40.0,25.0,-1,2025-08-15 16:41:32,sdg_roster_turnover_detailed.csv,2025-08-17 08:45:20,32
SDG,2017,2018,WR,6,6,5,1,1,83.33,16.67,16.67,0,2025-08-15 16:41:32,sdg_roster_turnover_detailed.csv,2025-08-17 08:45:20,32
SDG,2018,2019,DB,9,10,5,4,5,55.56,44.44,50.0,1,2025-08-15 16:41:32,sdg_roster_turnover_detailed.csv,2025-08-17 08:45:20,32
SDG,2018,2019,DL,4,6,2,2,4,50.0,50.0,66.67,2,2025-08-15 16:41:32,sdg_roster_turnover_detailed.csv,2025-08-17 08:45:20,32
SDG,2018,2019,LB,8,7,3,5,4,37.5,62.5,57.14,-1,2025-08-15 16:41:32,sdg_roster_turnover_detailed.csv,2025-08-17 08:45:20,32
SDG,2018,2019,OL,6,5,3,3,2,50.0,50.0,40.0,-1,2025-08-15 16:41:32,sdg_roster_turnover_detailed.csv,2025-08-17 08:45:20,32
SDG,2018,2019,OTHER,14,13,9,5,4,64.29,35.71,30.77,-1,2025-08-15 16:41:32,sdg_roster_turnover_detailed.csv,2025-08-17 08:45:20,32
SDG,2018,2019,QB,2,2,1,1,1,50.0,50.0,50.0,0,2025-08-15 16:41:32,sdg_roster_turnover_detailed.csv,2025-08-17 08:45:20,32
SDG,2018,2019,RB,5,5,4,1,1,80.0,20.0,20.0,0,2025-08-15 16:41:32,sdg_roster_turnover_detailed.csv,2025-08-17 08:45:20,32
SDG,2018,2019,ST,6,4,1,5,3,16.67,83.33,75.0,-2,2025-08-15 16:41:32,sdg_roster_turnover_detailed.csv,2025-08-17 08:45:20,32
SDG,2018,2019,TE,4,5,3,1,2,75.0,25.0,40.0,1,2025-08-15 16:41:32,sdg_roster_turnover_detailed.csv,2025-08-17 08:45:20,32
SDG,2018,2019,WR,6,8,4,2,4,66.67,33.33,50.0,2,2025-08-15 16:41:32,sdg_roster_turnover_detailed.csv,2025-08-17 08:45:20,32
SDG,2019,2020,DB,10,13,5,5,8,50.0,50.0,61.54,3,2025-08-15 16:41:32,sdg_roster_turnover_detailed.csv,2025-08-17 08:45:20,32
SDG,2019,2020,DL,6,6,3,3,3,50.0,50.0,50.0,0,2025-08-15 16:41:32,sdg_roster_turnover_detailed.csv,2025-08-17 08:45:20,32
SDG,2019,2020,LB,7,8,3,4,5,42.86,57.14,62.5,1,2025-08-15 16:41:32,sdg_roster_turnover_detailed.csv,2025-08-17 08:45:20,32
SDG,2019,2020,OL,5,6,2,3,4,40.0,60.0,66.67,1,2025-08-15 16:41:32,sdg_roster_turnover_detailed.csv,2025-08-17 08:45:20,32
SDG,2019,2020,OTHER,13,14,7,6,7,53.85,46.15,50.0,1,2025-08-15 16:41:32,sdg_roster_turnover_detailed.csv,2025-08-17 08:45:20,32
SDG,2019,2020,QB,2,3,1,1,2,50.0,50.0,66.67,1,2025-08-15 16:41:32,sdg_roster_turnover_detailed.csv,2025-08-17 08:45:20,32
SDG,2019,2020,RB,5,7,3,2,4,60.0,40.0,57.14,2,2025-08-15 16:41:32,sdg_roster_turnover_detailed.csv,2025-08-17 08:45:20,32
SDG,2019,2020,ST,4,3,3,1,0,75.0,25.0,0.0,-1,2025-08-15 16:41:32,sdg_roster_turnover_detailed.csv,2025-08-17 08:45:20,32
SDG,2019,2020,TE,5,5,3,2,2,60.0,40.0,40.0,0,2025-08-15 16:41:32,sdg_roster_turnover_detailed.csv,2025-08-17 08:45:20,32
SDG,2019,2020,WR,8,6,4,4,2,50.0,50.0,33.33,-2,2025-08-15 16:41:32,sdg_roster_turnover_detailed.csv,2025-08-17 08:45:20,32
SDG,2020,2021,DB,13,13,4,9,9,30.77,69.23,69.23,0,2025-08-15 16:41:32,sdg_roster_turnover_detailed.csv,2025-08-17 08:45:20,32
SDG,2020,2021,DL,6,7,2,4,5,33.33,66.67,71.43,1,2025-08-15 16:41:32,sdg_roster_turnover_detailed.csv,2025-08-17 08:45:20,32
SDG,2020,2021,LB,8,6,2,6,4,25.0,75.0,66.67,-2,2025-08-15 16:41:32,sdg_roster_turnover_detailed.csv,2025-08-17 08:45:20,32
SDG,2020,2021,OL,6,6,1,5,5,16.67,83.33,83.33,0,2025-08-15 16:41:32,sdg_roster_turnover_detailed.csv,2025-08-17 08:45:20,32
SDG,2020,2021,OTHER,14,15,5,9,10,35.71,64.29,66.67,1,2025-08-15 16:41:32,sdg_roster_turnover_detailed.csv,2025-08-17 08:45:20,32
SDG,2020,2021,QB,3,2,1,2,1,33.33,66.67,50.0,-1,2025-08-15 16:41:32,sdg_roster_turnover_detailed.csv,2025-08-17 08:45:20,32
SDG,2020,2021,RB,7,6,5,2,1,71.43,28.57,16.67,-1,2025-08-15 16:41:32,sdg_roster_turnover_detailed.csv,2025-08-17 08:45:20,32
SDG,2020,2021,ST,3,4,1,2,3,33.33,66.67,75.0,1,2025-08-15 16:41:32,sdg_roster_turnover_detailed.csv,2025-08-17 08:45:20,32
SDG,2020,2021,TE,5,5,2,3,3,40.0,60.0,60.0,0,2025-08-15 16:41:32,sdg_roster_turnover_detailed.csv,2025-08-17 08:45:20,32
SDG,2020,2021,WR,6,8,4,2,4,66.67,33.33,50.0,2,2025-08-15 16:41:32,sdg_roster_turnover_detailed.csv,2025-08-17 08:45:20,32
SDG,2021,2022,DB,13,9,4,9,5,30.77,69.23,55.56,-4,2025-08-15 16:41:32,sdg_roster_turnover_detailed.csv,2025-08-17 08:45:20,32
SDG,2021,2022,DL,7,7,3,4,4,42.86,57.14,57.14,0,2025-08-15 16:41:32,sdg_roster_turnover_detailed.csv,2025-08-17 08:45:20,32
SDG,2021,2022,LB,6,7,3,3,4,50.0,50.0,57.14,1,2025-08-15 16:41:32,sdg_roster_turnover_detailed.csv,2025-08-17 08:45:20,32
SDG,2021,2022,OL,6,8,2,4,6,33.33,66.67,75.0,2,2025-08-15 16:41:32,sdg_roster_turnover_detailed.csv,2025-08-17 08:45:20,32
SDG,2021,2022,OTHER,15,14,5,10,9,33.33,66.67,64.29,-1,2025-08-15 16:41:32,sdg_roster_turnover_detailed.csv,2025-08-17 08:45:20,32
SDG,2021,2022,QB,2,2,2,0,0,100.0,0.0,0.0,0,2025-08-15 16:41:32,sdg_roster_turnover_detailed.csv,2025-08-17 08:45:20,32
SDG,2021,2022,RB,6,6,3,3,3,50.0,50.0,50.0,0,2025-08-15 16:41:32,sdg_roster_turnover_detailed.csv,2025-08-17 08:45:20,32
SDG,2021,2022,ST,4,5,1,3,4,25.0,75.0,80.0,1,2025-08-15 16:41:32,sdg_roster_turnover_detailed.csv,2025-08-17 08:45:20,32
SDG,2021,2022,TE,5,5,2,3,3,40.0,60.0,60.0,0,2025-08-15 16:41:32,sdg_roster_turnover_detailed.csv,2025-08-17 08:45:20,32
SDG,2021,2022,WR,8,7,6,2,1,75.0,25.0,14.29,-1,2025-08-15 16:41:32,sdg_roster_turnover_detailed.csv,2025-08-17 08:45:20,32
SDG,2022,2023,DB,9,13,6,3,7,66.67,33.33,53.85,4,2025-08-15 16:41:32,sdg_roster_turnover_detailed.csv,2025-08-17 08:45:20,32
SDG,2022,2023,DL,7,6,1,6,5,14.29,85.71,83.33,-1,2025-08-15 16:41:32,sdg_roster_turnover_detailed.csv,2025-08-17 08:45:20,32
SDG,2022,2023,LB,7,14,4,3,10,57.14,42.86,71.43,7,2025-08-15 16:41:32,sdg_roster_turnover_detailed.csv,2025-08-17 08:45:20,32
SDG,2022,2023,OL,8,11,5,3,6,62.5,37.5,54.55,3,2025-08-15 16:41:32,sdg_roster_turnover_detailed.csv,2025-08-17 08:45:20,32
SDG,2022,2023,OTHER,14,2,1,13,1,7.14,92.86,50.0,-12,2025-08-15 16:41:32,sdg_roster_turnover_detailed.csv,2025-08-17 08:45:20,32
SDG,2022,2023,QB,2,2,1,1,1,50.0,50.0,50.0,0,2025-08-15 16:41:32,sdg_roster_turnover_detailed.csv,2025-08-17 08:45:20,32
SDG,2022,2023,RB,6,4,3,3,1,50.0,50.0,25.0,-2,2025-08-15 16:41:32,sdg_roster_turnover_detailed.csv,2025-08-17 08:45:20,32
SDG,2022,2023,ST,5,3,3,2,0,60.0,40.0,0.0,-2,2025-08-15 16:41:32,sdg_roster_turnover_detailed.csv,2025-08-17 08:45:20,32
SDG,2022,2023,TE,5,7,4,1,3,80.0,20.0,42.86,2,2025-08-15 16:41:32,sdg_roster_turnover_detailed.csv,2025-08-17 08:45:20,32
SDG,2022,2023,WR,7,10,4,3,6,57.14,42.86,60.0,3,2025-08-15 16:41:32,sdg_roster_turnover_detailed.csv,2025-08-17 08:45:20,32
SDG,2023,2024,DB,13,14,6,7,8,46.15,53.85,57.14,1,2025-08-15 16:41:32,sdg_roster_turnover_detailed.csv,2025-08-17 08:45:20,32
SDG,2023,2024,DL,6,4,2,4,2,33.33,66.67,50.0,-2,2025-08-15 16:41:32,sdg_roster_turnover_detailed.csv,2025-08-17 08:45:20,32
SDG,2023,2024,LB,14,8,3,11,5,21.43,78.57,62.5,-6,2025-08-15 16:41:32,sdg_roster_turnover_detailed.csv,2025-08-17 08:45:20,32
SDG,2023,2024,OL,11,6,4,7,2,36.36,63.64,33.33,-5,2025-08-15 16:41:32,sdg_roster_turnover_detailed.csv,2025-08-17 08:45:20,32
SDG,2023,2024,OTHER,2,11,0,2,11,0.0,100.0,100.0,9,2025-08-15 16:41:32,sdg_roster_turnover_detailed.csv,2025-08-17 08:45:20,32
SDG,2023,2024,QB,2,2,1,1,1,50.0,50.0,50.0,0,2025-08-15 16:41:32,sdg_roster_turnover_detailed.csv,2025-08-17 08:45:20,32
SDG,2023,2024,RB,4,6,0,4,6,0.0,100.0,100.0,2,2025-08-15 16:41:32,sdg_roster_turnover_detailed.csv,2025-08-17 08:45:20,32
SDG,2023,2024,ST,3,3,3,0,0,100.0,0.0,0.0,0,2025-08-15 16:41:32,sdg_roster_turnover_detailed.csv,2025-08-17 08:45:20,32
SDG,2023,2024,TE,7,5,1,6,4,14.29,85.71,80.0,-2,2025-08-15 16:41:32,sdg_roster_turnover_detailed.csv,2025-08-17 08:45:20,32
SDG,2023,2024,WR,10,11,4,6,7,40.0,60.0,63.64,1,2025-08-15 16:41:32,sdg_roster_turnover_detailed.csv,2025-08-17 08:45:20,32
SEA,2011,2012,DB,12,10,8,4,2,66.67,33.33,20.0,-2,2025-08-15 16:41:31,sea_roster_turnover_detailed.csv,2025-08-17 08:45:20,32
SEA,2011,2012,DL,5,7,1,4,6,20.0,80.0,85.71,2,2025-08-15 16:41:31,sea_roster_turnover_detailed.csv,2025-08-17 08:45:20,32
SEA,2011,2012,LB,10,5,4,6,1,40.0,60.0,20.0,-5,2025-08-15 16:41:31,sea_roster_turnover_detailed.csv,2025-08-17 08:45:20,32
SEA,2011,2012,OL,6,3,1,5,2,16.67,83.33,66.67,-3,2025-08-15 16:41:31,sea_roster_turnover_detailed.csv,2025-08-17 08:45:20,32
SEA,2011,2012,OTHER,15,13,13,2,0,86.67,13.33,0.0,-2,2025-08-15 16:41:31,sea_roster_turnover_detailed.csv,2025-08-17 08:45:20,32
SEA,2011,2012,QB,2,2,0,2,2,0.0,100.0,100.0,0,2025-08-15 16:41:31,sea_roster_turnover_detailed.csv,2025-08-17 08:45:20,32
SEA,2011,2012,RB,6,5,3,3,2,50.0,50.0,40.0,-1,2025-08-15 16:41:31,sea_roster_turnover_detailed.csv,2025-08-17 08:45:20,32
SEA,2011,2012,ST,2,3,2,0,1,100.0,0.0,33.33,1,2025-08-15 16:41:31,sea_roster_turnover_detailed.csv,2025-08-17 08:45:20,32
SEA,2011,2012,TE,4,3,2,2,1,50.0,50.0,33.33,-1,2025-08-15 16:41:31,sea_roster_turnover_detailed.csv,2025-08-17 08:45:20,32
SEA,2011,2012,WR,8,9,5,3,4,62.5,37.5,44.44,1,2025-08-15 16:41:31,sea_roster_turnover_detailed.csv,2025-08-17 08:45:20,32
SEA,2012,2013,DB,10,8,6,4,2,60.0,40.0,25.0,-2,2025-08-15 16:41:31,sea_roster_turnover_detailed.csv,2025-08-17 08:45:20,32
SEA,2012,2013,DL,7,7,1,6,6,14.29,85.71,85.71,0,2025-08-15 16:41:31,sea_roster_turnover_detailed.csv,2025-08-17 08:45:20,32
SEA,2012,2013,LB,5,6,4,1,2,80.0,20.0,33.33,1,2025-08-15 16:41:31,sea_roster_turnover_detailed.csv,2025-08-17 08:45:20,32
SEA,2012,2013,OL,3,4,2,1,2,66.67,33.33,50.0,1,2025-08-15 16:41:31,sea_roster_turnover_detailed.csv,2025-08-17 08:45:20,32
SEA,2012,2013,OTHER,13,16,10,3,6,76.92,23.08,37.5,3,2025-08-15 16:41:31,sea_roster_turnover_detailed.csv,2025-08-17 08:45:20,32
SEA,2012,2013,QB,2,2,1,1,1,50.0,50.0,50.0,0,2025-08-15 16:41:31,sea_roster_turnover_detailed.csv,2025-08-17 08:45:20,32
SEA,2012,2013,RB,5,7,4,1,3,80.0,20.0,42.86,2,2025-08-15 16:41:31,sea_roster_turnover_detailed.csv,2025-08-17 08:45:20,32
SEA,2012,2013,ST,3,2,2,1,0,66.67,33.33,0.0,-1,2025-08-15 16:41:31,sea_roster_turnover_detailed.csv,2025-08-17 08:45:20,32
SEA,2012,2013,TE,3,3,1,2,2,33.33,66.67,66.67,0,2025-08-15 16:41:31,sea_roster_turnover_detailed.csv,2025-08-17 08:45:20,32
SEA,2012,2013,WR,9,8,4,5,4,44.44,55.56,50.0,-1,2025-08-15 16:41:31,sea_roster_turnover_detailed.csv,2025-08-17 08:45:20,32
SEA,2013,2014,DB,8,9,5,3,4,62.5,37.5,44.44,1,2025-08-15 16:41:31,sea_roster_turnover_detailed.csv,2025-08-17 08:45:20,32
SEA,2013,2014,DL,7,7,1,6,6,14.29,85.71,85.71,0,2025-08-15 16:41:31,sea_roster_turnover_detailed.csv,2025-08-17 08:45:20,32
SEA,2013,2014,LB,6,7,4,2,3,66.67,33.33,42.86,1,2025-08-15 16:41:31,sea_roster_turnover_detailed.csv,2025-08-17 08:45:20,32
SEA,2013,2014,OL,4,6,2,2,4,50.0,50.0,66.67,2,2025-08-15 16:41:31,sea_roster_turnover_detailed.csv,2025-08-17 08:45:20,32
SEA,2013,2014,OTHER,16,16,10,6,6,62.5,37.5,37.5,0,2025-08-15 16:41:31,sea_roster_turnover_detailed.csv,2025-08-17 08:45:20,32
SEA,2013,2014,QB,2,2,2,0,0,100.0,0.0,0.0,0,2025-08-15 16:41:31,sea_roster_turnover_detailed.csv,2025-08-17 08:45:20,32
SEA,2013,2014,RB,7,6,5,2,1,71.43,28.57,16.67,-1,2025-08-15 16:41:31,sea_roster_turnover_detailed.csv,2025-08-17 08:45:20,32
SEA,2013,2014,ST,2,2,2,0,0,100.0,0.0,0.0,0,2025-08-15 16:41:31,sea_roster_turnover_detailed.csv,2025-08-17 08:45:20,32
SEA,2013,2014,TE,3,7,2,1,5,66.67,33.33,71.43,4,2025-08-15 16:41:31,sea_roster_turnover_detailed.csv,2025-08-17 08:45:20,32
SEA,2013,2014,WR,8,10,5,3,5,62.5,37.5,50.0,2,2025-08-15 16:41:31,sea_roster_turnover_detailed.csv,2025-08-17 08:45:20,32
SEA,2014,2015,DB,9,12,5,4,7,55.56,44.44,58.33,3,2025-08-15 16:41:31,sea_roster_turnover_detailed.csv,2025-08-17 08:45:20,32
SEA,2014,2015,DL,7,7,4,3,3,57.14,42.86,42.86,0,2025-08-15 16:41:31,sea_roster_turnover_detailed.csv,2025-08-17 08:45:20,32
SEA,2014,2015,LB,7,6,5,2,1,71.43,28.57,16.67,-1,2025-08-15 16:41:31,sea_roster_turnover_detailed.csv,2025-08-17 08:45:20,32
SEA,2014,2015,OL,6,5,2,4,3,33.33,66.67,60.0,-1,2025-08-15 16:41:31,sea_roster_turnover_detailed.csv,2025-08-17 08:45:20,32
SEA,2014,2015,OTHER,16,13,9,7,4,56.25,43.75,30.77,-3,2025-08-15 16:41:31,sea_roster_turnover_detailed.csv,2025-08-17 08:45:20,32
SEA,2014,2015,QB,2,3,2,0,1,100.0,0.0,33.33,1,2025-08-15 16:41:31,sea_roster_turnover_detailed.csv,2025-08-17 08:45:20,32
SEA,2014,2015,RB,6,9,4,2,5,66.67,33.33,55.56,3,2025-08-15 16:41:31,sea_roster_turnover_detailed.csv,2025-08-17 08:45:20,32
SEA,2014,2015,ST,2,2,2,0,0,100.0,0.0,0.0,0,2025-08-15 16:41:31,sea_roster_turnover_detailed.csv,2025-08-17 08:45:20,32
SEA,2014,2015,TE,7,5,2,5,3,28.57,71.43,60.0,-2,2025-08-15 16:41:31,sea_roster_turnover_detailed.csv,2025-08-17 08:45:20,32
SEA,2014,2015,WR,10,8,5,5,3,50.0,50.0,37.5,-2,2025-08-15 16:41:31,sea_roster_turnover_detailed.csv,2025-08-17 08:45:20,32
SEA,2015,2016,DB,12,10,5,7,5,41.67,58.33,50.0,-2,2025-08-15 16:41:31,sea_roster_turnover_detailed.csv,2025-08-17 08:45:20,32
SEA,2015,2016,DL,7,8,1,6,7,14.29,85.71,87.5,1,2025-08-15 16:41:31,sea_roster_turnover_detailed.csv,2025-08-17 08:45:20,32
SEA,2015,2016,LB,6,5,4,2,1,66.67,33.33,20.0,-1,2025-08-15 16:41:31,sea_roster_turnover_detailed.csv,2025-08-17 08:45:20,32
SEA,2015,2016,OL,5,4,0,5,4,0.0,100.0,100.0,-1,2025-08-15 16:41:31,sea_roster_turnover_detailed.csv,2025-08-17 08:45:20,32
SEA,2015,2016,OTHER,13,14,7,6,7,53.85,46.15,50.0,1,2025-08-15 16:41:31,sea_roster_turnover_detailed.csv,2025-08-17 08:45:20,32
SEA,2015,2016,QB,3,2,1,2,1,33.33,66.67,50.0,-1,2025-08-15 16:41:31,sea_roster_turnover_detailed.csv,2025-08-17 08:45:20,32
SEA,2015,2016,RB,9,10,3,6,7,33.33,66.67,70.0,1,2025-08-15 16:41:31,sea_roster_turnover_detailed.csv,2025-08-17 08:45:20,32
SEA,2015,2016,ST,2,4,2,0,2,100.0,0.0,50.0,2,2025-08-15 16:41:31,sea_roster_turnover_detailed.csv,2025-08-17 08:45:20,32
SEA,2015,2016,TE,5,5,2,3,3,40.0,60.0,60.0,0,2025-08-15 16:41:31,sea_roster_turnover_detailed.csv,2025-08-17 08:45:20,32
SEA,2015,2016,WR,8,7,5,3,2,62.5,37.5,28.57,-1,2025-08-15 16:41:31,sea_roster_turnover_detailed.csv,2025-08-17 08:45:20,32
SEA,2016,2017,DB,10,10,4,6,6,40.0,60.0,60.0,0,2025-08-15 16:41:31,sea_roster_turnover_detailed.csv,2025-08-17 08:45:20,32
SEA,2016,2017,DL,8,9,2,6,7,25.0,75.0,77.78,1,2025-08-15 16:41:31,sea_roster_turnover_detailed.csv,2025-08-17 08:45:20,32
SEA,2016,2017,LB,5,8,1,4,7,20.0,80.0,87.5,3,2025-08-15 16:41:31,sea_roster_turnover_detailed.csv,2025-08-17 08:45:20,32
SEA,2016,2017,OL,4,4,1,3,3,25.0,75.0,75.0,0,2025-08-15 16:41:31,sea_roster_turnover_detailed.csv,2025-08-17 08:45:20,32
SEA,2016,2017,OTHER,14,15,6,8,9,42.86,57.14,60.0,1,2025-08-15 16:41:31,sea_roster_turnover_detailed.csv,2025-08-17 08:45:20,32
SEA,2016,2017,QB,2,2,1,1,1,50.0,50.0,50.0,0,2025-08-15 16:41:31,sea_roster_turnover_detailed.csv,2025-08-17 08:45:20,32
SEA,2016,2017,RB,10,7,3,7,4,30.0,70.0,57.14,-3,2025-08-15 16:41:31,sea_roster_turnover_detailed.csv,2025-08-17 08:45:20,32
SEA,2016,2017,ST,4,3,2,2,1,50.0,50.0,33.33,-1,2025-08-15 16:41:31,sea_roster_turnover_detailed.csv,2025-08-17 08:45:20,32
SEA,2016,2017,TE,5,5,4,1,1,80.0,20.0,20.0,0,2025-08-15 16:41:31,sea_roster_turnover_detailed.csv,2025-08-17 08:45:20,32
SEA,2016,2017,WR,7,5,3,4,2,42.86,57.14,40.0,-2,2025-08-15 16:41:31,sea_roster_turnover_detailed.csv,2025-08-17 08:45:20,32
SEA,2017,2018,DB,10,9,6,4,3,60.0,40.0,33.33,-1,2025-08-15 16:41:31,sea_roster_turnover_detailed.csv,2025-08-17 08:45:20,32
SEA,2017,2018,DL,9,7,3,6,4,33.33,66.67,57.14,-2,2025-08-15 16:41:31,sea_roster_turnover_detailed.csv,2025-08-17 08:45:20,32
SEA,2017,2018,LB,8,5,1,7,4,12.5,87.5,80.0,-3,2025-08-15 16:41:31,sea_roster_turnover_detailed.csv,2025-08-17 08:45:20,32
SEA,2017,2018,OL,4,6,1,3,5,25.0,75.0,83.33,2,2025-08-15 16:41:31,sea_roster_turnover_detailed.csv,2025-08-17 08:45:20,32
SEA,2017,2018,OTHER,15,13,6,9,7,40.0,60.0,53.85,-2,2025-08-15 16:41:31,sea_roster_turnover_detailed.csv,2025-08-17 08:45:20,32
SEA,2017,2018,QB,2,1,1,1,0,50.0,50.0,0.0,-1,2025-08-15 16:41:31,sea_roster_turnover_detailed.csv,2025-08-17 08:45:20,32
SEA,2017,2018,RB,7,7,5,2,2,71.43,28.57,28.57,0,2025-08-15 16:41:31,sea_roster_turnover_detailed.csv,2025-08-17 08:45:20,32
SEA,2017,2018,ST,3,3,1,2,2,33.33,66.67,66.67,0,2025-08-15 16:41:31,sea_roster_turnover_detailed.csv,2025-08-17 08:45:20,32
SEA,2017,2018,TE,5,5,2,3,3,40.0,60.0,60.0,0,2025-08-15 16:41:31,sea_roster_turnover_detailed.csv,2025-08-17 08:45:20,32
SEA,2017,2018,WR,5,6,3,2,3,60.0,40.0,50.0,1,2025-08-15 16:41:31,sea_roster_turnover_detailed.csv,2025-08-17 08:45:20,32
SEA,2018,2019,DB,9,10,5,4,5,55.56,44.44,50.0,1,2025-08-15 16:41:31,sea_roster_turnover_detailed.csv,2025-08-17 08:45:20,32
SEA,2018,2019,DL,7,4,1,6,3,14.29,85.71,75.0,-3,2025-08-15 16:41:31,sea_roster_turnover_detailed.csv,2025-08-17 08:45:20,32
SEA,2018,2019,LB,5,6,2,3,4,40.0,60.0,66.67,1,2025-08-15 16:41:31,sea_roster_turnover_detailed.csv,2025-08-17 08:45:20,32
SEA,2018,2019,OL,6,7,4,2,3,66.67,33.33,42.86,1,2025-08-15 16:41:31,sea_roster_turnover_detailed.csv,2025-08-17 08:45:20,32
SEA,2018,2019,OTHER,13,14,8,5,6,61.54,38.46,42.86,1,2025-08-15 16:41:31,sea_roster_turnover_detailed.csv,2025-08-17 08:45:20,32
SEA,2018,2019,QB,1,1,1,0,0,100.0,0.0,0.0,0,2025-08-15 16:41:31,sea_roster_turnover_detailed.csv,2025-08-17 08:45:20,32
SEA,2018,2019,RB,7,6,3,4,3,42.86,57.14,50.0,-1,2025-08-15 16:41:31,sea_roster_turnover_detailed.csv,2025-08-17 08:45:20,32
SEA,2018,2019,ST,3,3,2,1,1,66.67,33.33,33.33,0,2025-08-15 16:41:31,sea_roster_turnover_detailed.csv,2025-08-17 08:45:20,32
SEA,2018,2019,TE,5,5,3,2,2,60.0,40.0,40.0,0,2025-08-15 16:41:31,sea_roster_turnover_detailed.csv,2025-08-17 08:45:20,32
SEA,2018,2019,WR,6,7,4,2,3,66.67,33.33,42.86,1,2025-08-15 16:41:31,sea_roster_turnover_detailed.csv,2025-08-17 08:45:20,32
SEA,2019,2020,DB,10,10,6,4,4,60.0,40.0,40.0,0,2025-08-15 16:41:31,sea_roster_turnover_detailed.csv,2025-08-17 08:45:20,32
SEA,2019,2020,DL,4,11,2,2,9,50.0,50.0,81.82,7,2025-08-15 16:41:31,sea_roster_turnover_detailed.csv,2025-08-17 08:45:20,32
SEA,2019,2020,LB,6,7,4,2,3,66.67,33.33,42.86,1,2025-08-15 16:41:31,sea_roster_turnover_detailed.csv,2025-08-17 08:45:20,32
SEA,2019,2020,OL,7,8,3,4,5,42.86,57.14,62.5,1,2025-08-15 16:41:31,sea_roster_turnover_detailed.csv,2025-08-17 08:45:20,32
SEA,2019,2020,OTHER,14,13,5,9,8,35.71,64.29,61.54,-1,2025-08-15 16:41:31,sea_roster_turnover_detailed.csv,2025-08-17 08:45:20,32
SEA,2019,2020,QB,1,2,1,0,1,100.0,0.0,50.0,1,2025-08-15 16:41:31,sea_roster_turnover_detailed.csv,2025-08-17 08:45:20,32
SEA,2019,2020,RB,6,7,3,3,4,50.0,50.0,57.14,1,2025-08-15 16:41:31,sea_roster_turnover_detailed.csv,2025-08-17 08:45:20,32
SEA,2019,2020,ST,3,3,3,0,0,100.0,0.0,0.0,0,2025-08-15 16:41:31,sea_roster_turnover_detailed.csv,2025-08-17 08:45:20,32
SEA,2019,2020,TE,5,6,3,2,3,60.0,40.0,50.0,1,2025-08-15 16:41:31,sea_roster_turnover_detailed.csv,2025-08-17 08:45:20,32
SEA,2019,2020,WR,7,6,3,4,3,42.86,57.14,50.0,-1,2025-08-15 16:41:31,sea_roster_turnover_detailed.csv,2025-08-17 08:45:20,32
SEA,2020,2021,DB,10,14,5,5,9,50.0,50.0,64.29,4,2025-08-15 16:41:31,sea_roster_turnover_detailed.csv,2025-08-17 08:45:20,32
SEA,2020,2021,DL,11,6,3,8,3,27.27,72.73,50.0,-5,2025-08-15 16:41:31,sea_roster_turnover_detailed.csv,2025-08-17 08:45:20,32
SEA,2020,2021,LB,7,4,2,5,2,28.57,71.43,50.0,-3,2025-08-15 16:41:31,sea_roster_turnover_detailed.csv,2025-08-17 08:45:20,32
SEA,2020,2021,OL,8,7,5,3,2,62.5,37.5,28.57,-1,2025-08-15 16:41:31,sea_roster_turnover_detailed.csv,2025-08-17 08:45:20,32
SEA,2020,2021,OTHER,13,15,6,7,9,46.15,53.85,60.0,2,2025-08-15 16:41:31,sea_roster_turnover_detailed.csv,2025-08-17 08:45:20,32
SEA,2020,2021,QB,2,2,2,0,0,100.0,0.0,0.0,0,2025-08-15 16:41:31,sea_roster_turnover_detailed.csv,2025-08-17 08:45:20,32
SEA,2020,2021,RB,7,7,5,2,2,71.43,28.57,28.57,0,2025-08-15 16:41:31,sea_roster_turnover_detailed.csv,2025-08-17 08:45:20,32
SEA,2020,2021,ST,3,3,3,0,0,100.0,0.0,0.0,0,2025-08-15 16:41:31,sea_roster_turnover_detailed.csv,2025-08-17 08:45:20,32
SEA,2020,2021,TE,6,4,2,4,2,33.33,66.67,50.0,-2,2025-08-15 16:41:31,sea_roster_turnover_detailed.csv,2025-08-17 08:45:20,32
SEA,2020,2021,WR,6,8,4,2,4,66.67,33.33,50.0,2,2025-08-15 16:41:31,sea_roster_turnover_detailed.csv,2025-08-17 08:45:20,32
SEA,2021,2022,DB,14,15,5,9,10,35.71,64.29,66.67,1,2025-08-15 16:41:31,sea_roster_turnover_detailed.csv,2025-08-17 08:45:20,32
SEA,2021,2022,DL,6,6,2,4,4,33.33,66.67,66.67,0,2025-08-15 16:41:31,sea_roster_turnover_detailed.csv,2025-08-17 08:45:20,32
SEA,2021,2022,LB,4,9,2,2,7,50.0,50.0,77.78,5,2025-08-15 16:41:31,sea_roster_turnover_detailed.csv,2025-08-17 08:45:20,32
SEA,2021,2022,OL,7,5,3,4,2,42.86,57.14,40.0,-2,2025-08-15 16:41:31,sea_roster_turnover_detailed.csv,2025-08-17 08:45:20,32
SEA,2021,2022,OTHER,15,11,3,12,8,20.0,80.0,72.73,-4,2025-08-15 16:41:31,sea_roster_turnover_detailed.csv,2025-08-17 08:45:20,32
SEA,2021,2022,QB,2,1,1,1,0,50.0,50.0,0.0,-1,2025-08-15 16:41:31,sea_roster_turnover_detailed.csv,2025-08-17 08:45:20,32
SEA,2021,2022,RB,7,7,3,4,4,42.86,57.14,57.14,0,2025-08-15 16:41:31,sea_roster_turnover_detailed.csv,2025-08-17 08:45:20,32
SEA,2021,2022,ST,3,3,2,1,1,66.67,33.33,33.33,0,2025-08-15 16:41:31,sea_roster_turnover_detailed.csv,2025-08-17 08:45:20,32
SEA,2021,2022,TE,4,4,3,1,1,75.0,25.0,25.0,0,2025-08-15 16:41:31,sea_roster_turnover_detailed.csv,2025-08-17 08:45:20,32
SEA,2021,2022,WR,8,8,4,4,4,50.0,50.0,50.0,0,2025-08-15 16:41:31,sea_roster_turnover_detailed.csv,2025-08-17 08:45:20,32
SEA,2022,2023,DB,15,15,7,8,8,46.67,53.33,53.33,0,2025-08-15 16:41:31,sea_roster_turnover_detailed.csv,2025-08-17 08:45:20,32
SEA,2022,2023,DL,6,8,1,5,7,16.67,83.33,87.5,2,2025-08-15 16:41:31,sea_roster_turnover_detailed.csv,2025-08-17 08:45:20,32
SEA,2022,2023,LB,9,12,4,5,8,44.44,55.56,66.67,3,2025-08-15 16:41:31,sea_roster_turnover_detailed.csv,2025-08-17 08:45:20,32
SEA,2022,2023,OL,5,13,3,2,10,60.0,40.0,76.92,8,2025-08-15 16:41:31,sea_roster_turnover_detailed.csv,2025-08-17 08:45:20,32
SEA,2022,2023,OTHER,11,1,1,10,0,9.09,90.91,0.0,-10,2025-08-15 16:41:31,sea_roster_turnover_detailed.csv,2025-08-17 08:45:20,32
SEA,2022,2023,QB,1,2,1,0,1,100.0,0.0,50.0,1,2025-08-15 16:41:31,sea_roster_turnover_detailed.csv,2025-08-17 08:45:20,32
SEA,2022,2023,RB,7,5,2,5,3,28.57,71.43,60.0,-2,2025-08-15 16:41:31,sea_roster_turnover_detailed.csv,2025-08-17 08:45:20,32
SEA,2022,2023,ST,3,3,2,1,1,66.67,33.33,33.33,0,2025-08-15 16:41:31,sea_roster_turnover_detailed.csv,2025-08-17 08:45:20,32
SEA,2022,2023,TE,4,4,3,1,1,75.0,25.0,25.0,0,2025-08-15 16:41:31,sea_roster_turnover_detailed.csv,2025-08-17 08:45:20,32
SEA,2022,2023,WR,8,8,4,4,4,50.0,50.0,50.0,0,2025-08-15 16:41:31,sea_roster_turnover_detailed.csv,2025-08-17 08:45:20,32
SEA,2023,2024,DB,15,14,6,9,8,40.0,60.0,57.14,-1,2025-08-15 16:41:31,sea_roster_turnover_detailed.csv,2025-08-17 08:45:20,32
SEA,2023,2024,DL,8,7,3,5,4,37.5,62.5,57.14,-1,2025-08-15 16:41:31,sea_roster_turnover_detailed.csv,2025-08-17 08:45:20,32
SEA,2023,2024,LB,12,10,3,9,7,25.0,75.0,70.0,-2,2025-08-15 16:41:31,sea_roster_turnover_detailed.csv,2025-08-17 08:45:20,32
SEA,2023,2024,OL,13,9,3,10,6,23.08,76.92,66.67,-4,2025-08-15 16:41:31,sea_roster_turnover_detailed.csv,2025-08-17 08:45:20,32
SEA,2023,2024,OTHER,1,12,0,1,12,0.0,100.0,100.0,11,2025-08-15 16:41:31,sea_roster_turnover_detailed.csv,2025-08-17 08:45:20,32
SEA,2023,2024,QB,2,2,1,1,1,50.0,50.0,50.0,0,2025-08-15 16:41:31,sea_roster_turnover_detailed.csv,2025-08-17 08:45:20,32
SEA,2023,2024,RB,5,4,3,2,1,60.0,40.0,25.0,-1,2025-08-15 16:41:31,sea_roster_turnover_detailed.csv,2025-08-17 08:45:20,32
SEA,2023,2024,ST,3,3,3,0,0,100.0,0.0,0.0,0,2025-08-15 16:41:31,sea_roster_turnover_detailed.csv,2025-08-17 08:45:20,32
SEA,2023,2024,TE,4,5,2,2,3,50.0,50.0,60.0,1,2025-08-15 16:41:31,sea_roster_turnover_detailed.csv,2025-08-17 08:45:20,32
SEA,2023,2024,WR,8,8,5,3,3,62.5,37.5,37.5,0,2025-08-15 16:41:31,sea_roster_turnover_detailed.csv,2025-08-17 08:45:20,32
SFO,2011,2012,DB,9,8,5,4,3,55.56,44.44,37.5,-1,2025-08-15 16:41:33,sfo_roster_turnover_detailed.csv,2025-08-17 08:45:20,32
SFO,2011,2012,DL,5,7,5,0,2,100.0,0.0,28.57,2,2025-08-15 16:41:33,sfo_roster_turnover_detailed.csv,2025-08-17 08:45:20,32
SFO,2011,2012,LB,4,5,2,2,3,50.0,50.0,60.0,1,2025-08-15 16:41:33,sfo_roster_turnover_detailed.csv,2025-08-17 08:45:20,32
SFO,2011,2012,OL,4,3,2,2,1,50.0,50.0,33.33,-1,2025-08-15 16:41:33,sfo_roster_turnover_detailed.csv,2025-08-17 08:45:20,32
SFO,2011,2012,OTHER,12,12,10,2,2,83.33,16.67,16.67,0,2025-08-15 16:41:33,sfo_roster_turnover_detailed.csv,2025-08-17 08:45:20,32
SFO,2011,2012,QB,2,2,2,0,0,100.0,0.0,0.0,0,2025-08-15 16:41:33,sfo_roster_turnover_detailed.csv,2025-08-17 08:45:20,32
SFO,2011,2012,RB,6,6,4,2,2,66.67,33.33,33.33,0,2025-08-15 16:41:33,sfo_roster_turnover_detailed.csv,2025-08-17 08:45:20,32
SFO,2011,2012,ST,3,3,3,0,0,100.0,0.0,0.0,0,2025-08-15 16:41:33,sfo_roster_turnover_detailed.csv,2025-08-17 08:45:20,32
SFO,2011,2012,TE,2,3,1,1,2,50.0,50.0,66.67,1,2025-08-15 16:41:33,sfo_roster_turnover_detailed.csv,2025-08-17 08:45:20,32
SFO,2011,2012,WR,7,7,3,4,4,42.86,57.14,57.14,0,2025-08-15 16:41:33,sfo_roster_turnover_detailed.csv,2025-08-17 08:45:20,32
SFO,2012,2013,DB,8,9,3,5,6,37.5,62.5,66.67,1,2025-08-15 16:41:33,sfo_roster_turnover_detailed.csv,2025-08-17 08:45:20,32
SFO,2012,2013,DL,7,6,3,4,3,42.86,57.14,50.0,-1,2025-08-15 16:41:33,sfo_roster_turnover_detailed.csv,2025-08-17 08:45:20,32
SFO,2012,2013,LB,5,3,1,4,2,20.0,80.0,66.67,-2,2025-08-15 16:41:33,sfo_roster_turnover_detailed.csv,2025-08-17 08:45:20,32
SFO,2012,2013,OL,3,4,2,1,2,66.67,33.33,50.0,1,2025-08-15 16:41:33,sfo_roster_turnover_detailed.csv,2025-08-17 08:45:20,32
SFO,2012,2013,OTHER,12,14,12,0,2,100.0,0.0,14.29,2,2025-08-15 16:41:33,sfo_roster_turnover_detailed.csv,2025-08-17 08:45:20,32
SFO,2012,2013,QB,2,2,1,1,1,50.0,50.0,50.0,0,2025-08-15 16:41:33,sfo_roster_turnover_detailed.csv,2025-08-17 08:45:20,32
SFO,2012,2013,RB,6,6,5,1,1,83.33,16.67,16.67,0,2025-08-15 16:41:33,sfo_roster_turnover_detailed.csv,2025-08-17 08:45:20,32
SFO,2012,2013,ST,3,3,1,2,2,33.33,66.67,66.67,0,2025-08-15 16:41:33,sfo_roster_turnover_detailed.csv,2025-08-17 08:45:20,32
SFO,2012,2013,TE,3,4,2,1,2,66.67,33.33,50.0,1,2025-08-15 16:41:33,sfo_roster_turnover_detailed.csv,2025-08-17 08:45:20,32
SFO,2012,2013,WR,7,8,3,4,5,42.86,57.14,62.5,1,2025-08-15 16:41:33,sfo_roster_turnover_detailed.csv,2025-08-17 08:45:20,32
SFO,2013,2014,DB,9,11,3,6,8,33.33,66.67,72.73,2,2025-08-15 16:41:33,sfo_roster_turnover_detailed.csv,2025-08-17 08:45:20,32
SFO,2013,2014,DL,6,8,5,1,3,83.33,16.67,37.5,2,2025-08-15 16:41:33,sfo_roster_turnover_detailed.csv,2025-08-17 08:45:20,32
SFO,2013,2014,LB,3,3,1,2,2,33.33,66.67,66.67,0,2025-08-15 16:41:33,sfo_roster_turnover_detailed.csv,2025-08-17 08:45:20,32
SFO,2013,2014,OL,4,5,2,2,3,50.0,50.0,60.0,1,2025-08-15 16:41:33,sfo_roster_turnover_detailed.csv,2025-08-17 08:45:20,32
SFO,2013,2014,OTHER,14,15,10,4,5,71.43,28.57,33.33,1,2025-08-15 16:41:33,sfo_roster_turnover_detailed.csv,2025-08-17 08:45:20,32
SFO,2013,2014,QB,2,2,1,1,1,50.0,50.0,50.0,0,2025-08-15 16:41:33,sfo_roster_turnover_detailed.csv,2025-08-17 08:45:20,32
SFO,2013,2014,RB,6,6,3,3,3,50.0,50.0,50.0,0,2025-08-15 16:41:33,sfo_roster_turnover_detailed.csv,2025-08-17 08:45:20,32
SFO,2013,2014,ST,3,3,2,1,1,66.67,33.33,33.33,0,2025-08-15 16:41:33,sfo_roster_turnover_detailed.csv,2025-08-17 08:45:20,32
SFO,2013,2014,TE,4,5,4,0,1,100.0,0.0,20.0,1,2025-08-15 16:41:33,sfo_roster_turnover_detailed.csv,2025-08-17 08:45:20,32
SFO,2013,2014,WR,8,8,4,4,4,50.0,50.0,50.0,0,2025-08-15 16:41:33,sfo_roster_turnover_detailed.csv,2025-08-17 08:45:20,32
SFO,2014,2015,DB,11,10,6,5,4,54.55,45.45,40.0,-1,2025-08-15 16:41:33,sfo_roster_turnover_detailed.csv,2025-08-17 08:45:20,32
SFO,2014,2015,DL,8,7,5,3,2,62.5,37.5,28.57,-1,2025-08-15 16:41:33,sfo_roster_turnover_detailed.csv,2025-08-17 08:45:20,32
SFO,2014,2015,LB,3,3,0,3,3,0.0,100.0,100.0,0,2025-08-15 16:41:33,sfo_roster_turnover_detailed.csv,2025-08-17 08:45:20,32
SFO,2014,2015,OL,5,4,2,3,2,40.0,60.0,50.0,-1,2025-08-15 16:41:33,sfo_roster_turnover_detailed.csv,2025-08-17 08:45:20,32
SFO,2014,2015,OTHER,15,13,4,11,9,26.67,73.33,69.23,-2,2025-08-15 16:41:33,sfo_roster_turnover_detailed.csv,2025-08-17 08:45:20,32
SFO,2014,2015,QB,2,2,2,0,0,100.0,0.0,0.0,0,2025-08-15 16:41:33,sfo_roster_turnover_detailed.csv,2025-08-17 08:45:20,32
SFO,2014,2015,RB,6,10,2,4,8,33.33,66.67,80.0,4,2025-08-15 16:41:33,sfo_roster_turnover_detailed.csv,2025-08-17 08:45:20,32
SFO,2014,2015,ST,3,3,2,1,1,66.67,33.33,33.33,0,2025-08-15 16:41:33,sfo_roster_turnover_detailed.csv,2025-08-17 08:45:20,32
SFO,2014,2015,TE,5,5,3,2,2,60.0,40.0,40.0,0,2025-08-15 16:41:33,sfo_roster_turnover_detailed.csv,2025-08-17 08:45:20,32
SFO,2014,2015,WR,8,6,3,5,3,37.5,62.5,50.0,-2,2025-08-15 16:41:33,sfo_roster_turnover_detailed.csv,2025-08-17 08:45:20,32
SFO,2015,2016,DB,10,12,8,2,4,80.0,20.0,33.33,2,2025-08-15 16:41:33,sfo_roster_turnover_detailed.csv,2025-08-17 08:45:20,32
SFO,2015,2016,DL,7,8,4,3,4,57.14,42.86,50.0,1,2025-08-15 16:41:33,sfo_roster_turnover_detailed.csv,2025-08-17 08:45:20,32
SFO,2015,2016,LB,3,4,1,2,3,33.33,66.67,75.0,1,2025-08-15 16:41:33,sfo_roster_turnover_detailed.csv,2025-08-17 08:45:20,32
SFO,2015,2016,OL,4,6,2,2,4,50.0,50.0,66.67,2,2025-08-15 16:41:33,sfo_roster_turnover_detailed.csv,2025-08-17 08:45:20,32
SFO,2015,2016,OTHER,13,16,6,7,10,46.15,53.85,62.5,3,2025-08-15 16:41:33,sfo_roster_turnover_detailed.csv,2025-08-17 08:45:20,32
SFO,2015,2016,QB,2,2,2,0,0,100.0,0.0,0.0,0,2025-08-15 16:41:33,sfo_roster_turnover_detailed.csv,2025-08-17 08:45:20,32
SFO,2015,2016,RB,10,5,4,6,1,40.0,60.0,20.0,-5,2025-08-15 16:41:33,sfo_roster_turnover_detailed.csv,2025-08-17 08:45:20,32
SFO,2015,2016,ST,3,3,3,0,0,100.0,0.0,0.0,0,2025-08-15 16:41:33,sfo_roster_turnover_detailed.csv,2025-08-17 08:45:20,32
SFO,2015,2016,TE,5,4,2,3,2,40.0,60.0,50.0,-1,2025-08-15 16:41:33,sfo_roster_turnover_detailed.csv,2025-08-17 08:45:20,32
SFO,2015,2016,WR,6,9,2,4,7,33.33,66.67,77.78,3,2025-08-15 16:41:33,sfo_roster_turnover_detailed.csv,2025-08-17 08:45:20,32
SFO,2016,2017,DB,12,13,3,9,10,25.0,75.0,76.92,1,2025-08-15 16:41:33,sfo_roster_turnover_detailed.csv,2025-08-17 08:45:20,32
SFO,2016,2017,DL,8,10,3,5,7,37.5,62.5,70.0,2,2025-08-15 16:41:33,sfo_roster_turnover_detailed.csv,2025-08-17 08:45:20,32
SFO,2016,2017,LB,4,6,1,3,5,25.0,75.0,83.33,2,2025-08-15 16:41:33,sfo_roster_turnover_detailed.csv,2025-08-17 08:45:20,32
SFO,2016,2017,OL,6,5,1,5,4,16.67,83.33,80.0,-1,2025-08-15 16:41:33,sfo_roster_turnover_detailed.csv,2025-08-17 08:45:20,32
SFO,2016,2017,OTHER,16,16,6,10,10,37.5,62.5,62.5,0,2025-08-15 16:41:33,sfo_roster_turnover_detailed.csv,2025-08-17 08:45:20,32
SFO,2016,2017,QB,2,3,0,2,3,0.0,100.0,100.0,1,2025-08-15 16:41:33,sfo_roster_turnover_detailed.csv,2025-08-17 08:45:20,32
SFO,2016,2017,RB,5,5,2,3,3,40.0,60.0,60.0,0,2025-08-15 16:41:33,sfo_roster_turnover_detailed.csv,2025-08-17 08:45:20,32
SFO,2016,2017,ST,3,3,2,1,1,66.67,33.33,33.33,0,2025-08-15 16:41:33,sfo_roster_turnover_detailed.csv,2025-08-17 08:45:20,32
SFO,2016,2017,TE,4,4,1,3,3,25.0,75.0,75.0,0,2025-08-15 16:41:33,sfo_roster_turnover_detailed.csv,2025-08-17 08:45:20,32
SFO,2016,2017,WR,9,7,0,9,7,0.0,100.0,100.0,-2,2025-08-15 16:41:33,sfo_roster_turnover_detailed.csv,2025-08-17 08:45:20,32
SFO,2017,2018,DB,13,12,7,6,5,53.85,46.15,41.67,-1,2025-08-15 16:41:33,sfo_roster_turnover_detailed.csv,2025-08-17 08:45:20,32
SFO,2017,2018,DL,10,6,4,6,2,40.0,60.0,33.33,-4,2025-08-15 16:41:33,sfo_roster_turnover_detailed.csv,2025-08-17 08:45:20,32
SFO,2017,2018,LB,6,7,3,3,4,50.0,50.0,57.14,1,2025-08-15 16:41:33,sfo_roster_turnover_detailed.csv,2025-08-17 08:45:20,32
SFO,2017,2018,OL,5,4,2,3,2,40.0,60.0,50.0,-1,2025-08-15 16:41:33,sfo_roster_turnover_detailed.csv,2025-08-17 08:45:20,32
SFO,2017,2018,OTHER,16,13,7,9,6,43.75,56.25,46.15,-3,2025-08-15 16:41:33,sfo_roster_turnover_detailed.csv,2025-08-17 08:45:20,32
SFO,2017,2018,QB,3,3,2,1,1,66.67,33.33,33.33,0,2025-08-15 16:41:33,sfo_roster_turnover_detailed.csv,2025-08-17 08:45:20,32
SFO,2017,2018,RB,5,6,3,2,3,60.0,40.0,50.0,1,2025-08-15 16:41:33,sfo_roster_turnover_detailed.csv,2025-08-17 08:45:20,32
SFO,2017,2018,ST,3,4,3,0,1,100.0,0.0,25.0,1,2025-08-15 16:41:33,sfo_roster_turnover_detailed.csv,2025-08-17 08:45:20,32
SFO,2017,2018,TE,4,4,2,2,2,50.0,50.0,50.0,0,2025-08-15 16:41:33,sfo_roster_turnover_detailed.csv,2025-08-17 08:45:20,32
SFO,2017,2018,WR,7,9,5,2,4,71.43,28.57,44.44,2,2025-08-15 16:41:33,sfo_roster_turnover_detailed.csv,2025-08-17 08:45:20,32
SFO,2018,2019,DB,12,9,7,5,2,58.33,41.67,22.22,-3,2025-08-15 16:41:33,sfo_roster_turnover_detailed.csv,2025-08-17 08:45:20,32
SFO,2018,2019,DL,6,11,3,3,8,50.0,50.0,72.73,5,2025-08-15 16:41:33,sfo_roster_turnover_detailed.csv,2025-08-17 08:45:20,32
SFO,2018,2019,LB,7,5,2,5,3,28.57,71.43,60.0,-2,2025-08-15 16:41:33,sfo_roster_turnover_detailed.csv,2025-08-17 08:45:20,32
SFO,2018,2019,OL,4,2,1,3,1,25.0,75.0,50.0,-2,2025-08-15 16:41:33,sfo_roster_turnover_detailed.csv,2025-08-17 08:45:20,32
SFO,2018,2019,OTHER,13,15,8,5,7,61.54,38.46,46.67,2,2025-08-15 16:41:33,sfo_roster_turnover_detailed.csv,2025-08-17 08:45:20,32
SFO,2018,2019,QB,3,2,2,1,0,66.67,33.33,0.0,-1,2025-08-15 16:41:33,sfo_roster_turnover_detailed.csv,2025-08-17 08:45:20,32
SFO,2018,2019,RB,6,5,4,2,1,66.67,33.33,20.0,-1,2025-08-15 16:41:33,sfo_roster_turnover_detailed.csv,2025-08-17 08:45:20,32
SFO,2018,2019,ST,4,7,3,1,4,75.0,25.0,57.14,3,2025-08-15 16:41:33,sfo_roster_turnover_detailed.csv,2025-08-17 08:45:20,32
SFO,2018,2019,TE,4,4,3,1,1,75.0,25.0,25.0,0,2025-08-15 16:41:33,sfo_roster_turnover_detailed.csv,2025-08-17 08:45:20,32
SFO,2018,2019,WR,9,7,4,5,3,44.44,55.56,42.86,-2,2025-08-15 16:41:33,sfo_roster_turnover_detailed.csv,2025-08-17 08:45:20,32
SFO,2019,2020,DB,9,16,6,3,10,66.67,33.33,62.5,7,2025-08-15 16:41:33,sfo_roster_turnover_detailed.csv,2025-08-17 08:45:20,32
SFO,2019,2020,DL,11,10,3,8,7,27.27,72.73,70.0,-1,2025-08-15 16:41:33,sfo_roster_turnover_detailed.csv,2025-08-17 08:45:20,32
SFO,2019,2020,LB,5,5,3,2,2,60.0,40.0,40.0,0,2025-08-15 16:41:33,sfo_roster_turnover_detailed.csv,2025-08-17 08:45:20,32
SFO,2019,2020,OL,2,7,0,2,7,0.0,100.0,100.0,5,2025-08-15 16:41:33,sfo_roster_turnover_detailed.csv,2025-08-17 08:45:20,32
SFO,2019,2020,OTHER,15,14,9,6,5,60.0,40.0,35.71,-1,2025-08-15 16:41:33,sfo_roster_turnover_detailed.csv,2025-08-17 08:45:20,32
SFO,2019,2020,QB,2,3,2,0,1,100.0,0.0,33.33,1,2025-08-15 16:41:33,sfo_roster_turnover_detailed.csv,2025-08-17 08:45:20,32
SFO,2019,2020,RB,5,7,4,1,3,80.0,20.0,42.86,2,2025-08-15 16:41:33,sfo_roster_turnover_detailed.csv,2025-08-17 08:45:20,32
SFO,2019,2020,ST,7,6,4,3,2,57.14,42.86,33.33,-1,2025-08-15 16:41:33,sfo_roster_turnover_detailed.csv,2025-08-17 08:45:20,32
SFO,2019,2020,TE,4,5,2,2,3,50.0,50.0,60.0,1,2025-08-15 16:41:33,sfo_roster_turnover_detailed.csv,2025-08-17 08:45:20,32
SFO,2019,2020,WR,7,11,5,2,6,71.43,28.57,54.55,4,2025-08-15 16:41:33,sfo_roster_turnover_detailed.csv,2025-08-17 08:45:20,32
SFO,2020,2021,DB,16,17,6,10,11,37.5,62.5,64.71,1,2025-08-15 16:41:33,sfo_roster_turnover_detailed.csv,2025-08-17 08:45:20,32
SFO,2020,2021,DL,10,7,2,8,5,20.0,80.0,71.43,-3,2025-08-15 16:41:33,sfo_roster_turnover_detailed.csv,2025-08-17 08:45:20,32
SFO,2020,2021,LB,5,8,4,1,4,80.0,20.0,50.0,3,2025-08-15 16:41:33,sfo_roster_turnover_detailed.csv,2025-08-17 08:45:20,32
SFO,2020,2021,OL,7,5,1,6,4,14.29,85.71,80.0,-2,2025-08-15 16:41:33,sfo_roster_turnover_detailed.csv,2025-08-17 08:45:20,32
SFO,2020,2021,OTHER,14,14,8,6,6,57.14,42.86,42.86,0,2025-08-15 16:41:33,sfo_roster_turnover_detailed.csv,2025-08-17 08:45:20,32
SFO,2020,2021,QB,3,2,1,2,1,33.33,66.67,50.0,-1,2025-08-15 16:41:33,sfo_roster_turnover_detailed.csv,2025-08-17 08:45:20,32
SFO,2020,2021,RB,7,10,4,3,6,57.14,42.86,60.0,3,2025-08-15 16:41:33,sfo_roster_turnover_detailed.csv,2025-08-17 08:45:20,32
SFO,2020,2021,ST,6,4,3,3,1,50.0,50.0,25.0,-2,2025-08-15 16:41:33,sfo_roster_turnover_detailed.csv,2025-08-17 08:45:20,32
SFO,2020,2021,TE,5,4,3,2,1,60.0,40.0,25.0,-1,2025-08-15 16:41:33,sfo_roster_turnover_detailed.csv,2025-08-17 08:45:20,32
SFO,2020,2021,WR,11,8,5,6,3,45.45,54.55,37.5,-3,2025-08-15 16:41:33,sfo_roster_turnover_detailed.csv,2025-08-17 08:45:20,32
SFO,2021,2022,DB,17,9,3,14,6,17.65,82.35,66.67,-8,2025-08-15 16:41:33,sfo_roster_turnover_detailed.csv,2025-08-17 08:45:20,32
SFO,2021,2022,DL,7,8,1,6,7,14.29,85.71,87.5,1,2025-08-15 16:41:33,sfo_roster_turnover_detailed.csv,2025-08-17 08:45:20,32
SFO,2021,2022,LB,8,4,2,6,2,25.0,75.0,50.0,-4,2025-08-15 16:41:33,sfo_roster_turnover_detailed.csv,2025-08-17 08:45:20,32
SFO,2021,2022,OL,5,6,3,2,3,60.0,40.0,50.0,1,2025-08-15 16:41:33,sfo_roster_turnover_detailed.csv,2025-08-17 08:45:20,32
SFO,2021,2022,OTHER,14,15,7,7,8,50.0,50.0,53.33,1,2025-08-15 16:41:33,sfo_roster_turnover_detailed.csv,2025-08-17 08:45:20,32
SFO,2021,2022,QB,2,4,2,0,2,100.0,0.0,50.0,2,2025-08-15 16:41:33,sfo_roster_turnover_detailed.csv,2025-08-17 08:45:20,32
SFO,2021,2022,RB,10,8,3,7,5,30.0,70.0,62.5,-2,2025-08-15 16:41:33,sfo_roster_turnover_detailed.csv,2025-08-17 08:45:20,32
SFO,2021,2022,ST,4,3,3,1,0,75.0,25.0,0.0,-1,2025-08-15 16:41:33,sfo_roster_turnover_detailed.csv,2025-08-17 08:45:20,32
SFO,2021,2022,TE,4,4,3,1,1,75.0,25.0,25.0,0,2025-08-15 16:41:33,sfo_roster_turnover_detailed.csv,2025-08-17 08:45:20,32
SFO,2021,2022,WR,8,8,3,5,5,37.5,62.5,62.5,0,2025-08-15 16:41:33,sfo_roster_turnover_detailed.csv,2025-08-17 08:45:20,32
SFO,2022,2023,DB,9,17,5,4,12,55.56,44.44,70.59,8,2025-08-15 16:41:33,sfo_roster_turnover_detailed.csv,2025-08-17 08:45:20,32
SFO,2022,2023,DL,8,13,3,5,10,37.5,62.5,76.92,5,2025-08-15 16:41:33,sfo_roster_turnover_detailed.csv,2025-08-17 08:45:20,32
SFO,2022,2023,LB,4,8,4,0,4,100.0,0.0,50.0,4,2025-08-15 16:41:33,sfo_roster_turnover_detailed.csv,2025-08-17 08:45:20,32
SFO,2022,2023,OL,6,13,4,2,9,66.67,33.33,69.23,7,2025-08-15 16:41:33,sfo_roster_turnover_detailed.csv,2025-08-17 08:45:20,32
SFO,2022,2023,OTHER,15,1,1,14,0,6.67,93.33,0.0,-14,2025-08-15 16:41:33,sfo_roster_turnover_detailed.csv,2025-08-17 08:45:20,32
SFO,2022,2023,QB,4,2,1,3,1,25.0,75.0,50.0,-2,2025-08-15 16:41:33,sfo_roster_turnover_detailed.csv,2025-08-17 08:45:20,32
SFO,2022,2023,RB,8,6,5,3,1,62.5,37.5,16.67,-2,2025-08-15 16:41:33,sfo_roster_turnover_detailed.csv,2025-08-17 08:45:20,32
SFO,2022,2023,ST,3,3,2,1,1,66.67,33.33,33.33,0,2025-08-15 16:41:33,sfo_roster_turnover_detailed.csv,2025-08-17 08:45:20,32
SFO,2022,2023,TE,4,4,3,1,1,75.0,25.0,25.0,0,2025-08-15 16:41:33,sfo_roster_turnover_detailed.csv,2025-08-17 08:45:20,32
SFO,2022,2023,WR,8,8,6,2,2,75.0,25.0,25.0,0,2025-08-15 16:41:33,sfo_roster_turnover_detailed.csv,2025-08-17 08:45:20,32
SFO,2023,2024,DB,17,12,5,12,7,29.41,70.59,58.33,-5,2025-08-15 16:41:33,sfo_roster_turnover_detailed.csv,2025-08-17 08:45:20,32
SFO,2023,2024,DL,13,10,5,8,5,38.46,61.54,50.0,-3,2025-08-15 16:41:33,sfo_roster_turnover_detailed.csv,2025-08-17 08:45:20,32
SFO,2023,2024,LB,8,7,5,3,2,62.5,37.5,28.57,-1,2025-08-15 16:41:33,sfo_roster_turnover_detailed.csv,2025-08-17 08:45:20,32
SFO,2023,2024,OL,13,9,5,8,4,38.46,61.54,44.44,-4,2025-08-15 16:41:33,sfo_roster_turnover_detailed.csv,2025-08-17 08:45:20,32
SFO,2023,2024,OTHER,1,12,0,1,12,0.0,100.0,100.0,11,2025-08-15 16:41:33,sfo_roster_turnover_detailed.csv,2025-08-17 08:45:20,32
SFO,2023,2024,QB,2,3,1,1,2,50.0,50.0,66.67,1,2025-08-15 16:41:33,sfo_roster_turnover_detailed.csv,2025-08-17 08:45:20,32
SFO,2023,2024,RB,6,6,3,3,3,50.0,50.0,50.0,0,2025-08-15 16:41:33,sfo_roster_turnover_detailed.csv,2025-08-17 08:45:20,32
SFO,2023,2024,ST,3,6,3,0,3,100.0,0.0,50.0,3,2025-08-15 16:41:33,sfo_roster_turnover_detailed.csv,2025-08-17 08:45:20,32
SFO,2023,2024,TE,4,4,2,2,2,50.0,50.0,50.0,0,2025-08-15 16:41:33,sfo_roster_turnover_detailed.csv,2025-08-17 08:45:20,32
SFO,2023,2024,WR,8,8,5,3,3,62.5,37.5,37.5,0,2025-08-15 16:41:33,sfo_roster_turnover_detailed.csv,2025-08-17 08:45:20,32
TAM,2011,2012,DB,10,11,4,6,7,40.0,60.0,63.64,1,2025-08-15 16:41:31,tam_roster_turnover_detailed.csv,2025-08-17 08:45:20,32
TAM,2011,2012,DL,8,7,1,7,6,12.5,87.5,85.71,-1,2025-08-15 16:41:31,tam_roster_turnover_detailed.csv,2025-08-17 08:45:20,32
TAM,2011,2012,LB,5,5,3,2,2,60.0,40.0,40.0,0,2025-08-15 16:41:31,tam_roster_turnover_detailed.csv,2025-08-17 08:45:20,32
TAM,2011,2012,OL,5,5,2,3,3,40.0,60.0,60.0,0,2025-08-15 16:41:31,tam_roster_turnover_detailed.csv,2025-08-17 08:45:20,32
TAM,2011,2012,OTHER,14,15,5,9,10,35.71,64.29,66.67,1,2025-08-15 16:41:31,tam_roster_turnover_detailed.csv,2025-08-17 08:45:20,32
TAM,2011,2012,QB,3,2,1,2,1,33.33,66.67,50.0,-1,2025-08-15 16:41:31,tam_roster_turnover_detailed.csv,2025-08-17 08:45:20,32
TAM,2011,2012,RB,7,4,1,6,3,14.29,85.71,75.0,-3,2025-08-15 16:41:31,tam_roster_turnover_detailed.csv,2025-08-17 08:45:20,32
TAM,2011,2012,ST,4,3,3,1,0,75.0,25.0,0.0,-1,2025-08-15 16:41:31,tam_roster_turnover_detailed.csv,2025-08-17 08:45:20,32
TAM,2011,2012,TE,2,5,0,2,5,0.0,100.0,100.0,3,2025-08-15 16:41:31,tam_roster_turnover_detailed.csv,2025-08-17 08:45:20,32
TAM,2011,2012,WR,8,10,4,4,6,50.0,50.0,60.0,2,2025-08-15 16:41:31,tam_roster_turnover_detailed.csv,2025-08-17 08:45:20,32
TAM,2012,2013,DB,11,10,4,7,6,36.36,63.64,60.0,-1,2025-08-15 16:41:31,tam_roster_turnover_detailed.csv,2025-08-17 08:45:20,32
TAM,2012,2013,DL,7,6,2,5,4,28.57,71.43,66.67,-1,2025-08-15 16:41:31,tam_roster_turnover_detailed.csv,2025-08-17 08:45:20,32
TAM,2012,2013,LB,5,6,2,3,4,40.0,60.0,66.67,1,2025-08-15 16:41:31,tam_roster_turnover_detailed.csv,2025-08-17 08:45:20,32
TAM,2012,2013,OL,5,4,1,4,3,20.0,80.0,75.0,-1,2025-08-15 16:41:31,tam_roster_turnover_detailed.csv,2025-08-17 08:45:20,32
TAM,2012,2013,OTHER,15,11,6,9,5,40.0,60.0,45.45,-4,2025-08-15 16:41:31,tam_roster_turnover_detailed.csv,2025-08-17 08:45:20,32
TAM,2012,2013,QB,2,3,2,0,1,100.0,0.0,33.33,1,2025-08-15 16:41:31,tam_roster_turnover_detailed.csv,2025-08-17 08:45:20,32
TAM,2012,2013,RB,4,8,1,3,7,25.0,75.0,87.5,4,2025-08-15 16:41:31,tam_roster_turnover_detailed.csv,2025-08-17 08:45:20,32
TAM,2012,2013,ST,3,3,2,1,1,66.67,33.33,33.33,0,2025-08-15 16:41:31,tam_roster_turnover_detailed.csv,2025-08-17 08:45:20,32
TAM,2012,2013,TE,5,5,2,3,3,40.0,60.0,60.0,0,2025-08-15 16:41:31,tam_roster_turnover_detailed.csv,2025-08-17 08:45:20,32
TAM,2012,2013,WR,10,8,4,6,4,40.0,60.0,50.0,-2,2025-08-15 16:41:31,tam_roster_turnover_detailed.csv,2025-08-17 08:45:20,32
TAM,2013,2014,DB,10,11,5,5,6,50.0,50.0,54.55,1,2025-08-15 16:41:31,tam_roster_turnover_detailed.csv,2025-08-17 08:45:20,32
TAM,2013,2014,DL,6,10,2,4,8,33.33,66.67,80.0,4,2025-08-15 16:41:31,tam_roster_turnover_detailed.csv,2025-08-17 08:45:20,32
TAM,2013,2014,LB,6,5,2,4,3,33.33,66.67,60.0,-1,2025-08-15 16:41:31,tam_roster_turnover_detailed.csv,2025-08-17 08:45:20,32
TAM,2013,2014,OL,4,4,0,4,4,0.0,100.0,100.0,0,2025-08-15 16:41:31,tam_roster_turnover_detailed.csv,2025-08-17 08:45:20,32
TAM,2013,2014,OTHER,11,15,5,6,10,45.45,54.55,66.67,4,2025-08-15 16:41:31,tam_roster_turnover_detailed.csv,2025-08-17 08:45:20,32
TAM,2013,2014,QB,3,2,1,2,1,33.33,66.67,50.0,-1,2025-08-15 16:41:31,tam_roster_turnover_detailed.csv,2025-08-17 08:45:20,32
TAM,2013,2014,RB,8,7,3,5,4,37.5,62.5,57.14,-1,2025-08-15 16:41:31,tam_roster_turnover_detailed.csv,2025-08-17 08:45:20,32
TAM,2013,2014,ST,3,3,1,2,2,33.33,66.67,66.67,0,2025-08-15 16:41:31,tam_roster_turnover_detailed.csv,2025-08-17 08:45:20,32
TAM,2013,2014,TE,5,4,0,5,4,0.0,100.0,100.0,-1,2025-08-15 16:41:31,tam_roster_turnover_detailed.csv,2025-08-17 08:45:20,32
TAM,2013,2014,WR,8,9,3,5,6,37.5,62.5,66.67,1,2025-08-15 16:41:31,tam_roster_turnover_detailed.csv,2025-08-17 08:45:20,32
TAM,2014,2015,DB,11,8,3,8,5,27.27,72.73,62.5,-3,2025-08-15 16:41:31,tam_roster_turnover_detailed.csv,2025-08-17 08:45:20,32
TAM,2014,2015,DL,10,6,4,6,2,40.0,60.0,33.33,-4,2025-08-15 16:41:31,tam_roster_turnover_detailed.csv,2025-08-17 08:45:20,32
TAM,2014,2015,LB,5,10,1,4,9,20.0,80.0,90.0,5,2025-08-15 16:41:31,tam_roster_turnover_detailed.csv,2025-08-17 08:45:20,32
TAM,2014,2015,OL,4,5,1,3,4,25.0,75.0,80.0,1,2025-08-15 16:41:31,tam_roster_turnover_detailed.csv,2025-08-17 08:45:20,32
TAM,2014,2015,OTHER,15,18,9,6,9,60.0,40.0,50.0,3,2025-08-15 16:41:31,tam_roster_turnover_detailed.csv,2025-08-17 08:45:20,32
TAM,2014,2015,QB,2,1,0,2,1,0.0,100.0,100.0,-1,2025-08-15 16:41:31,tam_roster_turnover_detailed.csv,2025-08-17 08:45:20,32
TAM,2014,2015,RB,7,3,3,4,0,42.86,57.14,0.0,-4,2025-08-15 16:41:31,tam_roster_turnover_detailed.csv,2025-08-17 08:45:20,32
TAM,2014,2015,ST,3,4,1,2,3,33.33,66.67,75.0,1,2025-08-15 16:41:31,tam_roster_turnover_detailed.csv,2025-08-17 08:45:20,32
TAM,2014,2015,TE,4,5,3,1,2,75.0,25.0,40.0,1,2025-08-15 16:41:31,tam_roster_turnover_detailed.csv,2025-08-17 08:45:20,32
TAM,2014,2015,WR,9,7,4,5,3,44.44,55.56,42.86,-2,2025-08-15 16:41:31,tam_roster_turnover_detailed.csv,2025-08-17 08:45:20,32
TAM,2015,2016,DB,8,10,5,3,5,62.5,37.5,50.0,2,2025-08-15 16:41:31,tam_roster_turnover_detailed.csv,2025-08-17 08:45:20,32
TAM,2015,2016,DL,6,6,0,6,6,0.0,100.0,100.0,0,2025-08-15 16:41:31,tam_roster_turnover_detailed.csv,2025-08-17 08:45:20,32
TAM,2015,2016,LB,10,7,3,7,4,30.0,70.0,57.14,-3,2025-08-15 16:41:31,tam_roster_turnover_detailed.csv,2025-08-17 08:45:20,32
TAM,2015,2016,OL,5,6,1,4,5,20.0,80.0,83.33,1,2025-08-15 16:41:31,tam_roster_turnover_detailed.csv,2025-08-17 08:45:20,32
TAM,2015,2016,OTHER,18,12,6,12,6,33.33,66.67,50.0,-6,2025-08-15 16:41:31,tam_roster_turnover_detailed.csv,2025-08-17 08:45:20,32
TAM,2015,2016,QB,1,2,1,0,1,100.0,0.0,50.0,1,2025-08-15 16:41:31,tam_roster_turnover_detailed.csv,2025-08-17 08:45:20,32
TAM,2015,2016,RB,3,8,2,1,6,66.67,33.33,75.0,5,2025-08-15 16:41:31,tam_roster_turnover_detailed.csv,2025-08-17 08:45:20,32
TAM,2015,2016,ST,4,3,1,3,2,25.0,75.0,66.67,-1,2025-08-15 16:41:31,tam_roster_turnover_detailed.csv,2025-08-17 08:45:20,32
TAM,2015,2016,TE,5,5,4,1,1,80.0,20.0,20.0,0,2025-08-15 16:41:31,tam_roster_turnover_detailed.csv,2025-08-17 08:45:20,32
TAM,2015,2016,WR,7,8,5,2,3,71.43,28.57,37.5,1,2025-08-15 16:41:31,tam_roster_turnover_detailed.csv,2025-08-17 08:45:20,32
TAM,2016,2017,DB,10,10,4,6,6,40.0,60.0,60.0,0,2025-08-15 16:41:31,tam_roster_turnover_detailed.csv,2025-08-17 08:45:20,32
TAM,2016,2017,DL,6,7,3,3,4,50.0,50.0,57.14,1,2025-08-15 16:41:31,tam_roster_turnover_detailed.csv,2025-08-17 08:45:20,32
TAM,2016,2017,LB,7,8,4,3,4,57.14,42.86,50.0,1,2025-08-15 16:41:31,tam_roster_turnover_detailed.csv,2025-08-17 08:45:20,32
TAM,2016,2017,OL,6,5,3,3,2,50.0,50.0,40.0,-1,2025-08-15 16:41:31,tam_roster_turnover_detailed.csv,2025-08-17 08:45:20,32
TAM,2016,2017,OTHER,12,14,9,3,5,75.0,25.0,35.71,2,2025-08-15 16:41:31,tam_roster_turnover_detailed.csv,2025-08-17 08:45:20,32
TAM,2016,2017,QB,2,2,1,1,1,50.0,50.0,50.0,0,2025-08-15 16:41:31,tam_roster_turnover_detailed.csv,2025-08-17 08:45:20,32
TAM,2016,2017,RB,8,4,4,4,0,50.0,50.0,0.0,-4,2025-08-15 16:41:31,tam_roster_turnover_detailed.csv,2025-08-17 08:45:20,32
TAM,2016,2017,ST,3,4,1,2,3,33.33,66.67,75.0,1,2025-08-15 16:41:31,tam_roster_turnover_detailed.csv,2025-08-17 08:45:20,32
TAM,2016,2017,TE,5,5,3,2,2,60.0,40.0,40.0,0,2025-08-15 16:41:31,tam_roster_turnover_detailed.csv,2025-08-17 08:45:20,32
TAM,2016,2017,WR,8,7,3,5,4,37.5,62.5,57.14,-1,2025-08-15 16:41:31,tam_roster_turnover_detailed.csv,2025-08-17 08:45:20,32
TAM,2017,2018,DB,10,13,5,5,8,50.0,50.0,61.54,3,2025-08-15 16:41:31,tam_roster_turnover_detailed.csv,2025-08-17 08:45:20,32
TAM,2017,2018,DL,7,6,1,6,5,14.29,85.71,83.33,-1,2025-08-15 16:41:31,tam_roster_turnover_detailed.csv,2025-08-17 08:45:20,32
TAM,2017,2018,LB,8,7,4,4,3,50.0,50.0,42.86,-1,2025-08-15 16:41:31,tam_roster_turnover_detailed.csv,2025-08-17 08:45:20,32
TAM,2017,2018,OL,5,5,3,2,2,60.0,40.0,40.0,0,2025-08-15 16:41:31,tam_roster_turnover_detailed.csv,2025-08-17 08:45:20,32
TAM,2017,2018,OTHER,14,15,7,7,8,50.0,50.0,53.33,1,2025-08-15 16:41:31,tam_roster_turnover_detailed.csv,2025-08-17 08:45:20,32
TAM,2017,2018,QB,2,2,2,0,0,100.0,0.0,0.0,0,2025-08-15 16:41:31,tam_roster_turnover_detailed.csv,2025-08-17 08:45:20,32
TAM,2017,2018,RB,4,6,2,2,4,50.0,50.0,66.67,2,2025-08-15 16:41:31,tam_roster_turnover_detailed.csv,2025-08-17 08:45:20,32
TAM,2017,2018,ST,4,4,2,2,2,50.0,50.0,50.0,0,2025-08-15 16:41:31,tam_roster_turnover_detailed.csv,2025-08-17 08:45:20,32
TAM,2017,2018,TE,5,4,4,1,0,80.0,20.0,0.0,-1,2025-08-15 16:41:31,tam_roster_turnover_detailed.csv,2025-08-17 08:45:20,32
TAM,2017,2018,WR,7,7,6,1,1,85.71,14.29,14.29,0,2025-08-15 16:41:31,tam_roster_turnover_detailed.csv,2025-08-17 08:45:20,32
TAM,2018,2019,DB,13,9,3,10,6,23.08,76.92,66.67,-4,2025-08-15 16:41:31,tam_roster_turnover_detailed.csv,2025-08-17 08:45:20,32
TAM,2018,2019,DL,6,7,2,4,5,33.33,66.67,71.43,1,2025-08-15 16:41:31,tam_roster_turnover_detailed.csv,2025-08-17 08:45:20,32
TAM,2018,2019,LB,7,6,2,5,4,28.57,71.43,66.67,-1,2025-08-15 16:41:31,tam_roster_turnover_detailed.csv,2025-08-17 08:45:20,32
TAM,2018,2019,OL,5,6,1,4,5,20.0,80.0,83.33,1,2025-08-15 16:41:31,tam_roster_turnover_detailed.csv,2025-08-17 08:45:20,32
TAM,2018,2019,OTHER,15,14,7,8,7,46.67,53.33,50.0,-1,2025-08-15 16:41:31,tam_roster_turnover_detailed.csv,2025-08-17 08:45:20,32
TAM,2018,2019,QB,2,2,1,1,1,50.0,50.0,50.0,0,2025-08-15 16:41:31,tam_roster_turnover_detailed.csv,2025-08-17 08:45:20,32
TAM,2018,2019,RB,6,4,3,3,1,50.0,50.0,25.0,-2,2025-08-15 16:41:31,tam_roster_turnover_detailed.csv,2025-08-17 08:45:20,32
TAM,2018,2019,ST,4,3,0,4,3,0.0,100.0,100.0,-1,2025-08-15 16:41:31,tam_roster_turnover_detailed.csv,2025-08-17 08:45:20,32
TAM,2018,2019,TE,4,5,3,1,2,75.0,25.0,40.0,1,2025-08-15 16:41:31,tam_roster_turnover_detailed.csv,2025-08-17 08:45:20,32
TAM,2018,2019,WR,7,10,4,3,6,57.14,42.86,60.0,3,2025-08-15 16:41:31,tam_roster_turnover_detailed.csv,2025-08-17 08:45:20,32
TAM,2019,2020,DB,9,12,6,3,6,66.67,33.33,50.0,3,2025-08-15 16:41:31,tam_roster_turnover_detailed.csv,2025-08-17 08:45:20,32
TAM,2019,2020,DL,7,8,4,3,4,57.14,42.86,50.0,1,2025-08-15 16:41:31,tam_roster_turnover_detailed.csv,2025-08-17 08:45:20,32
TAM,2019,2020,LB,6,5,2,4,3,33.33,66.67,60.0,-1,2025-08-15 16:41:31,tam_roster_turnover_detailed.csv,2025-08-17 08:45:20,32
TAM,2019,2020,OL,6,6,3,3,3,50.0,50.0,50.0,0,2025-08-15 16:41:31,tam_roster_turnover_detailed.csv,2025-08-17 08:45:20,32
TAM,2019,2020,OTHER,14,12,11,3,1,78.57,21.43,8.33,-2,2025-08-15 16:41:31,tam_roster_turnover_detailed.csv,2025-08-17 08:45:20,32
TAM,2019,2020,QB,2,2,0,2,2,0.0,100.0,100.0,0,2025-08-15 16:41:31,tam_roster_turnover_detailed.csv,2025-08-17 08:45:20,32
TAM,2019,2020,RB,4,5,1,3,4,25.0,75.0,80.0,1,2025-08-15 16:41:31,tam_roster_turnover_detailed.csv,2025-08-17 08:45:20,32
TAM,2019,2020,ST,3,3,2,1,1,66.67,33.33,33.33,0,2025-08-15 16:41:31,tam_roster_turnover_detailed.csv,2025-08-17 08:45:20,32
TAM,2019,2020,TE,5,5,4,1,1,80.0,20.0,20.0,0,2025-08-15 16:41:31,tam_roster_turnover_detailed.csv,2025-08-17 08:45:20,32
TAM,2019,2020,WR,10,8,6,4,2,60.0,40.0,25.0,-2,2025-08-15 16:41:31,tam_roster_turnover_detailed.csv,2025-08-17 08:45:20,32
TAM,2020,2021,DB,12,10,5,7,5,41.67,58.33,50.0,-2,2025-08-15 16:41:31,tam_roster_turnover_detailed.csv,2025-08-17 08:45:20,32
TAM,2020,2021,DL,8,6,6,2,0,75.0,25.0,0.0,-2,2025-08-15 16:41:31,tam_roster_turnover_detailed.csv,2025-08-17 08:45:20,32
TAM,2020,2021,LB,5,4,1,4,3,20.0,80.0,75.0,-1,2025-08-15 16:41:31,tam_roster_turnover_detailed.csv,2025-08-17 08:45:20,32
TAM,2020,2021,OL,6,5,3,3,2,50.0,50.0,40.0,-1,2025-08-15 16:41:31,tam_roster_turnover_detailed.csv,2025-08-17 08:45:20,32
TAM,2020,2021,OTHER,12,14,12,0,2,100.0,0.0,14.29,2,2025-08-15 16:41:31,tam_roster_turnover_detailed.csv,2025-08-17 08:45:20,32
TAM,2020,2021,QB,2,2,2,0,0,100.0,0.0,0.0,0,2025-08-15 16:41:31,tam_roster_turnover_detailed.csv,2025-08-17 08:45:20,32
TAM,2020,2021,RB,5,6,4,1,2,80.0,20.0,33.33,1,2025-08-15 16:41:31,tam_roster_turnover_detailed.csv,2025-08-17 08:45:20,32
TAM,2020,2021,ST,3,5,3,0,2,100.0,0.0,40.0,2,2025-08-15 16:41:31,tam_roster_turnover_detailed.csv,2025-08-17 08:45:20,32
TAM,2020,2021,TE,5,6,3,2,3,60.0,40.0,50.0,1,2025-08-15 16:41:31,tam_roster_turnover_detailed.csv,2025-08-17 08:45:20,32
TAM,2020,2021,WR,8,11,8,0,3,100.0,0.0,27.27,3,2025-08-15 16:41:31,tam_roster_turnover_detailed.csv,2025-08-17 08:45:20,32
TAM,2021,2022,DB,10,11,3,7,8,30.0,70.0,72.73,1,2025-08-15 16:41:31,tam_roster_turnover_detailed.csv,2025-08-17 08:45:20,32
TAM,2021,2022,DL,6,7,2,4,5,33.33,66.67,71.43,1,2025-08-15 16:41:31,tam_roster_turnover_detailed.csv,2025-08-17 08:45:20,32
TAM,2021,2022,LB,4,6,2,2,4,50.0,50.0,66.67,2,2025-08-15 16:41:31,tam_roster_turnover_detailed.csv,2025-08-17 08:45:20,32
TAM,2021,2022,OL,5,6,2,3,4,40.0,60.0,66.67,1,2025-08-15 16:41:31,tam_roster_turnover_detailed.csv,2025-08-17 08:45:20,32
TAM,2021,2022,OTHER,14,15,8,6,7,57.14,42.86,46.67,1,2025-08-15 16:41:31,tam_roster_turnover_detailed.csv,2025-08-17 08:45:20,32
TAM,2021,2022,QB,2,3,2,0,1,100.0,0.0,33.33,1,2025-08-15 16:41:31,tam_roster_turnover_detailed.csv,2025-08-17 08:45:20,32
TAM,2021,2022,RB,6,4,3,3,1,50.0,50.0,25.0,-2,2025-08-15 16:41:31,tam_roster_turnover_detailed.csv,2025-08-17 08:45:20,32
TAM,2021,2022,ST,5,3,2,3,1,40.0,60.0,33.33,-2,2025-08-15 16:41:31,tam_roster_turnover_detailed.csv,2025-08-17 08:45:20,32
TAM,2021,2022,TE,6,4,1,5,3,16.67,83.33,75.0,-2,2025-08-15 16:41:31,tam_roster_turnover_detailed.csv,2025-08-17 08:45:20,32
TAM,2021,2022,WR,11,10,5,6,5,45.45,54.55,50.0,-1,2025-08-15 16:41:31,tam_roster_turnover_detailed.csv,2025-08-17 08:45:20,32
TAM,2022,2023,DB,11,11,3,8,8,27.27,72.73,72.73,0,2025-08-15 16:41:31,tam_roster_turnover_detailed.csv,2025-08-17 08:45:20,32
TAM,2022,2023,DL,7,8,4,3,4,57.14,42.86,50.0,1,2025-08-15 16:41:31,tam_roster_turnover_detailed.csv,2025-08-17 08:45:20,32
TAM,2022,2023,LB,6,10,3,3,7,50.0,50.0,70.0,4,2025-08-15 16:41:31,tam_roster_turnover_detailed.csv,2025-08-17 08:45:20,32
TAM,2022,2023,OL,6,9,3,3,6,50.0,50.0,66.67,3,2025-08-15 16:41:31,tam_roster_turnover_detailed.csv,2025-08-17 08:45:20,32
TAM,2022,2023,OTHER,15,2,2,13,0,13.33,86.67,0.0,-13,2025-08-15 16:41:31,tam_roster_turnover_detailed.csv,2025-08-17 08:45:20,32
TAM,2022,2023,QB,3,2,1,2,1,33.33,66.67,50.0,-1,2025-08-15 16:41:31,tam_roster_turnover_detailed.csv,2025-08-17 08:45:20,32
TAM,2022,2023,RB,4,4,2,2,2,50.0,50.0,50.0,0,2025-08-15 16:41:31,tam_roster_turnover_detailed.csv,2025-08-17 08:45:20,32
TAM,2022,2023,ST,3,3,2,1,1,66.67,33.33,33.33,0,2025-08-15 16:41:31,tam_roster_turnover_detailed.csv,2025-08-17 08:45:20,32
TAM,2022,2023,TE,4,4,2,2,2,50.0,50.0,50.0,0,2025-08-15 16:41:31,tam_roster_turnover_detailed.csv,2025-08-17 08:45:20,32
TAM,2022,2023,WR,10,7,3,7,4,30.0,70.0,57.14,-3,2025-08-15 16:41:31,tam_roster_turnover_detailed.csv,2025-08-17 08:45:20,32
TAM,2023,2024,DB,11,14,6,5,8,54.55,45.45,57.14,3,2025-08-15 16:41:31,tam_roster_turnover_detailed.csv,2025-08-17 08:45:20,32
TAM,2023,2024,DL,8,7,4,4,3,50.0,50.0,42.86,-1,2025-08-15 16:41:31,tam_roster_turnover_detailed.csv,2025-08-17 08:45:20,32
TAM,2023,2024,LB,10,11,5,5,6,50.0,50.0,54.55,1,2025-08-15 16:41:31,tam_roster_turnover_detailed.csv,2025-08-17 08:45:20,32
TAM,2023,2024,OL,9,5,2,7,3,22.22,77.78,60.0,-4,2025-08-15 16:41:31,tam_roster_turnover_detailed.csv,2025-08-17 08:45:20,32
TAM,2023,2024,OTHER,2,11,0,2,11,0.0,100.0,100.0,9,2025-08-15 16:41:31,tam_roster_turnover_detailed.csv,2025-08-17 08:45:20,32
TAM,2023,2024,QB,2,2,2,0,0,100.0,0.0,0.0,0,2025-08-15 16:41:31,tam_roster_turnover_detailed.csv,2025-08-17 08:45:20,32
TAM,2023,2024,RB,4,4,2,2,2,50.0,50.0,50.0,0,2025-08-15 16:41:31,tam_roster_turnover_detailed.csv,2025-08-17 08:45:20,32
TAM,2023,2024,ST,3,6,3,0,3,100.0,0.0,50.0,3,2025-08-15 16:41:31,tam_roster_turnover_detailed.csv,2025-08-17 08:45:20,32
TAM,2023,2024,TE,4,4,3,1,1,75.0,25.0,25.0,0,2025-08-15 16:41:31,tam_roster_turnover_detailed.csv,2025-08-17 08:45:20,32
TAM,2023,2024,WR,7,10,5,2,5,71.43,28.57,50.0,3,2025-08-15 16:41:31,tam_roster_turnover_detailed.csv,2025-08-17 08:45:20,32
WAS,2011,2012,DB,8,12,2,6,10,25.0,75.0,83.33,4,2025-08-15 16:41:28,was_roster_turnover_detailed.csv,2025-08-17 08:45:20,32
WAS,2011,2012,DL,6,7,2,4,5,33.33,66.67,71.43,1,2025-08-15 16:41:28,was_roster_turnover_detailed.csv,2025-08-17 08:45:20,32
WAS,2011,2012,LB,4,5,1,3,4,25.0,75.0,80.0,1,2025-08-15 16:41:28,was_roster_turnover_detailed.csv,2025-08-17 08:45:20,32
WAS,2011,2012,OL,5,4,1,4,3,20.0,80.0,75.0,-1,2025-08-15 16:41:28,was_roster_turnover_detailed.csv,2025-08-17 08:45:20,32
WAS,2011,2012,OTHER,13,12,8,5,4,61.54,38.46,33.33,-1,2025-08-15 16:41:28,was_roster_turnover_detailed.csv,2025-08-17 08:45:20,32
WAS,2011,2012,QB,2,2,0,2,2,0.0,100.0,100.0,0,2025-08-15 16:41:28,was_roster_turnover_detailed.csv,2025-08-17 08:45:20,32
WAS,2011,2012,RB,7,6,3,4,3,42.86,57.14,50.0,-1,2025-08-15 16:41:28,was_roster_turnover_detailed.csv,2025-08-17 08:45:20,32
WAS,2011,2012,ST,3,5,2,1,3,66.67,33.33,60.0,2,2025-08-15 16:41:28,was_roster_turnover_detailed.csv,2025-08-17 08:45:20,32
WAS,2011,2012,TE,6,3,3,3,0,50.0,50.0,0.0,-3,2025-08-15 16:41:28,was_roster_turnover_detailed.csv,2025-08-17 08:45:20,32
WAS,2011,2012,WR,9,8,4,5,4,44.44,55.56,50.0,-1,2025-08-15 16:41:28,was_roster_turnover_detailed.csv,2025-08-17 08:45:20,32
WAS,2012,2013,DB,12,9,4,8,5,33.33,66.67,55.56,-3,2025-08-15 16:41:28,was_roster_turnover_detailed.csv,2025-08-17 08:45:20,32
WAS,2012,2013,DL,7,7,2,5,5,28.57,71.43,71.43,0,2025-08-15 16:41:28,was_roster_turnover_detailed.csv,2025-08-17 08:45:20,32
WAS,2012,2013,LB,5,4,1,4,3,20.0,80.0,75.0,-1,2025-08-15 16:41:28,was_roster_turnover_detailed.csv,2025-08-17 08:45:20,32
WAS,2012,2013,OL,4,3,1,3,2,25.0,75.0,66.67,-1,2025-08-15 16:41:28,was_roster_turnover_detailed.csv,2025-08-17 08:45:20,32
WAS,2012,2013,OTHER,12,13,11,1,2,91.67,8.33,15.38,1,2025-08-15 16:41:28,was_roster_turnover_detailed.csv,2025-08-17 08:45:20,32
WAS,2012,2013,QB,2,2,2,0,0,100.0,0.0,0.0,0,2025-08-15 16:41:28,was_roster_turnover_detailed.csv,2025-08-17 08:45:20,32
WAS,2012,2013,RB,6,5,4,2,1,66.67,33.33,20.0,-1,2025-08-15 16:41:28,was_roster_turnover_detailed.csv,2025-08-17 08:45:20,32
WAS,2012,2013,ST,5,5,3,2,2,60.0,40.0,40.0,0,2025-08-15 16:41:28,was_roster_turnover_detailed.csv,2025-08-17 08:45:20,32
WAS,2012,2013,TE,3,3,2,1,1,66.67,33.33,33.33,0,2025-08-15 16:41:28,was_roster_turnover_detailed.csv,2025-08-17 08:45:20,32
WAS,2012,2013,WR,8,9,6,2,3,75.0,25.0,33.33,1,2025-08-15 16:41:28,was_roster_turnover_detailed.csv,2025-08-17 08:45:20,32
WAS,2013,2014,DB,9,15,4,5,11,44.44,55.56,73.33,6,2025-08-15 16:41:28,was_roster_turnover_detailed.csv,2025-08-17 08:45:20,32
WAS,2013,2014,DL,7,9,2,5,7,28.57,71.43,77.78,2,2025-08-15 16:41:28,was_roster_turnover_detailed.csv,2025-08-17 08:45:20,32
WAS,2013,2014,LB,4,5,0,4,5,0.0,100.0,100.0,1,2025-08-15 16:41:28,was_roster_turnover_detailed.csv,2025-08-17 08:45:20,32
WAS,2013,2014,OL,3,4,0,3,4,0.0,100.0,100.0,1,2025-08-15 16:41:28,was_roster_turnover_detailed.csv,2025-08-17 08:45:20,32
WAS,2013,2014,OTHER,13,15,7,6,8,53.85,46.15,53.33,2,2025-08-15 16:41:28,was_roster_turnover_detailed.csv,2025-08-17 08:45:20,32
WAS,2013,2014,QB,2,3,2,0,1,100.0,0.0,33.33,1,2025-08-15 16:41:28,was_roster_turnover_detailed.csv,2025-08-17 08:45:20,32
WAS,2013,2014,RB,5,5,4,1,1,80.0,20.0,20.0,0,2025-08-15 16:41:28,was_roster_turnover_detailed.csv,2025-08-17 08:45:20,32
WAS,2013,2014,ST,5,3,2,3,1,40.0,60.0,33.33,-2,2025-08-15 16:41:28,was_roster_turnover_detailed.csv,2025-08-17 08:45:20,32
WAS,2013,2014,TE,3,3,2,1,1,66.67,33.33,33.33,0,2025-08-15 16:41:28,was_roster_turnover_detailed.csv,2025-08-17 08:45:20,32
WAS,2013,2014,WR,9,8,4,5,4,44.44,55.56,50.0,-1,2025-08-15 16:41:28,was_roster_turnover_detailed.csv,2025-08-17 08:45:20,32
WAS,2014,2015,DB,15,13,4,11,9,26.67,73.33,69.23,-2,2025-08-15 16:41:28,was_roster_turnover_detailed.csv,2025-08-17 08:45:20,32
WAS,2014,2015,DL,9,7,3,6,4,33.33,66.67,57.14,-2,2025-08-15 16:41:28,was_roster_turnover_detailed.csv,2025-08-17 08:45:20,32
WAS,2014,2015,LB,5,5,0,5,5,0.0,100.0,100.0,0,2025-08-15 16:41:28,was_roster_turnover_detailed.csv,2025-08-17 08:45:20,32
WAS,2014,2015,OL,4,7,2,2,5,50.0,50.0,71.43,3,2025-08-15 16:41:28,was_roster_turnover_detailed.csv,2025-08-17 08:45:20,32
WAS,2014,2015,OTHER,15,15,8,7,7,53.33,46.67,46.67,0,2025-08-15 16:41:28,was_roster_turnover_detailed.csv,2025-08-17 08:45:20,32
WAS,2014,2015,QB,3,2,2,1,0,66.67,33.33,0.0,-1,2025-08-15 16:41:28,was_roster_turnover_detailed.csv,2025-08-17 08:45:20,32
WAS,2014,2015,RB,5,4,2,3,2,40.0,60.0,50.0,-1,2025-08-15 16:41:28,was_roster_turnover_detailed.csv,2025-08-17 08:45:20,32
WAS,2014,2015,ST,3,4,3,0,1,100.0,0.0,25.0,1,2025-08-15 16:41:28,was_roster_turnover_detailed.csv,2025-08-17 08:45:20,32
WAS,2014,2015,TE,3,6,1,2,5,33.33,66.67,83.33,3,2025-08-15 16:41:28,was_roster_turnover_detailed.csv,2025-08-17 08:45:20,32
WAS,2014,2015,WR,8,6,5,3,1,62.5,37.5,16.67,-2,2025-08-15 16:41:28,was_roster_turnover_detailed.csv,2025-08-17 08:45:20,32
WAS,2015,2016,DB,13,12,5,8,7,38.46,61.54,58.33,-1,2025-08-15 16:41:28,was_roster_turnover_detailed.csv,2025-08-17 08:45:20,32
WAS,2015,2016,DL,7,7,1,6,6,14.29,85.71,85.71,0,2025-08-15 16:41:28,was_roster_turnover_detailed.csv,2025-08-17 08:45:20,32
WAS,2015,2016,LB,5,7,2,3,5,40.0,60.0,71.43,2,2025-08-15 16:41:28,was_roster_turnover_detailed.csv,2025-08-17 08:45:20,32
WAS,2015,2016,OL,7,6,3,4,3,42.86,57.14,50.0,-1,2025-08-15 16:41:28,was_roster_turnover_detailed.csv,2025-08-17 08:45:20,32
WAS,2015,2016,OTHER,15,12,8,7,4,53.33,46.67,33.33,-3,2025-08-15 16:41:28,was_roster_turnover_detailed.csv,2025-08-17 08:45:20,32
WAS,2015,2016,QB,2,1,1,1,0,50.0,50.0,0.0,-1,2025-08-15 16:41:28,was_roster_turnover_detailed.csv,2025-08-17 08:45:20,32
WAS,2015,2016,RB,4,3,2,2,1,50.0,50.0,33.33,-1,2025-08-15 16:41:28,was_roster_turnover_detailed.csv,2025-08-17 08:45:20,32
WAS,2015,2016,ST,4,4,3,1,1,75.0,25.0,25.0,0,2025-08-15 16:41:28,was_roster_turnover_detailed.csv,2025-08-17 08:45:20,32
WAS,2015,2016,TE,6,3,2,4,1,33.33,66.67,33.33,-3,2025-08-15 16:41:28,was_roster_turnover_detailed.csv,2025-08-17 08:45:20,32
WAS,2015,2016,WR,6,8,5,1,3,83.33,16.67,37.5,2,2025-08-15 16:41:28,was_roster_turnover_detailed.csv,2025-08-17 08:45:20,32
WAS,2016,2017,DB,12,12,5,7,7,41.67,58.33,58.33,0,2025-08-15 16:41:28,was_roster_turnover_detailed.csv,2025-08-17 08:45:20,32
WAS,2016,2017,DL,7,7,2,5,5,28.57,71.43,71.43,0,2025-08-15 16:41:28,was_roster_turnover_detailed.csv,2025-08-17 08:45:20,32
WAS,2016,2017,LB,7,7,1,6,6,14.29,85.71,85.71,0,2025-08-15 16:41:28,was_roster_turnover_detailed.csv,2025-08-17 08:45:20,32
WAS,2016,2017,OL,6,7,1,5,6,16.67,83.33,85.71,1,2025-08-15 16:41:28,was_roster_turnover_detailed.csv,2025-08-17 08:45:20,32
WAS,2016,2017,OTHER,12,15,8,4,7,66.67,33.33,46.67,3,2025-08-15 16:41:28,was_roster_turnover_detailed.csv,2025-08-17 08:45:20,32
WAS,2016,2017,QB,1,2,1,0,1,100.0,0.0,50.0,1,2025-08-15 16:41:28,was_roster_turnover_detailed.csv,2025-08-17 08:45:20,32
WAS,2016,2017,RB,3,7,2,1,5,66.67,33.33,71.43,4,2025-08-15 16:41:28,was_roster_turnover_detailed.csv,2025-08-17 08:45:20,32
WAS,2016,2017,ST,4,4,3,1,1,75.0,25.0,25.0,0,2025-08-15 16:41:28,was_roster_turnover_detailed.csv,2025-08-17 08:45:20,32
WAS,2016,2017,TE,3,4,2,1,2,66.67,33.33,50.0,1,2025-08-15 16:41:28,was_roster_turnover_detailed.csv,2025-08-17 08:45:20,32
WAS,2016,2017,WR,8,7,4,4,3,50.0,50.0,42.86,-1,2025-08-15 16:41:28,was_roster_turnover_detailed.csv,2025-08-17 08:45:20,32
WAS,2017,2018,DB,12,14,5,7,9,41.67,58.33,64.29,2,2025-08-15 16:41:28,was_roster_turnover_detailed.csv,2025-08-17 08:45:20,32
WAS,2017,2018,DL,7,6,1,6,5,14.29,85.71,83.33,-1,2025-08-15 16:41:28,was_roster_turnover_detailed.csv,2025-08-17 08:45:20,32
WAS,2017,2018,LB,7,5,1,6,4,14.29,85.71,80.0,-2,2025-08-15 16:41:28,was_roster_turnover_detailed.csv,2025-08-17 08:45:20,32
WAS,2017,2018,OL,7,10,1,6,9,14.29,85.71,90.0,3,2025-08-15 16:41:28,was_roster_turnover_detailed.csv,2025-08-17 08:45:20,32
WAS,2017,2018,OTHER,15,15,11,4,4,73.33,26.67,26.67,0,2025-08-15 16:41:28,was_roster_turnover_detailed.csv,2025-08-17 08:45:20,32
WAS,2017,2018,QB,2,4,1,1,3,50.0,50.0,75.0,2,2025-08-15 16:41:28,was_roster_turnover_detailed.csv,2025-08-17 08:45:20,32
WAS,2017,2018,RB,7,6,5,2,1,71.43,28.57,16.67,-1,2025-08-15 16:41:28,was_roster_turnover_detailed.csv,2025-08-17 08:45:20,32
WAS,2017,2018,ST,4,3,3,1,0,75.0,25.0,0.0,-1,2025-08-15 16:41:28,was_roster_turnover_detailed.csv,2025-08-17 08:45:20,32
WAS,2017,2018,TE,4,4,3,1,1,75.0,25.0,25.0,0,2025-08-15 16:41:28,was_roster_turnover_detailed.csv,2025-08-17 08:45:20,32
WAS,2017,2018,WR,7,10,4,3,6,57.14,42.86,60.0,3,2025-08-15 16:41:28,was_roster_turnover_detailed.csv,2025-08-17 08:45:20,32
WAS,2018,2019,DB,14,18,8,6,10,57.14,42.86,55.56,4,2025-08-15 16:41:28,was_roster_turnover_detailed.csv,2025-08-17 08:45:20,32
WAS,2018,2019,DL,6,8,3,3,5,50.0,50.0,62.5,2,2025-08-15 16:41:28,was_roster_turnover_detailed.csv,2025-08-17 08:45:20,32
WAS,2018,2019,LB,5,5,3,2,2,60.0,40.0,40.0,0,2025-08-15 16:41:28,was_roster_turnover_detailed.csv,2025-08-17 08:45:20,32
WAS,2018,2019,OL,10,4,3,7,1,30.0,70.0,25.0,-6,2025-08-15 16:41:28,was_roster_turnover_detailed.csv,2025-08-17 08:45:20,32
WAS,2018,2019,OTHER,15,14,7,8,7,46.67,53.33,50.0,-1,2025-08-15 16:41:28,was_roster_turnover_detailed.csv,2025-08-17 08:45:20,32
WAS,2018,2019,QB,4,3,1,3,2,25.0,75.0,66.67,-1,2025-08-15 16:41:28,was_roster_turnover_detailed.csv,2025-08-17 08:45:20,32
WAS,2018,2019,RB,6,7,2,4,5,33.33,66.67,71.43,1,2025-08-15 16:41:28,was_roster_turnover_detailed.csv,2025-08-17 08:45:20,32
WAS,2018,2019,ST,3,3,3,0,0,100.0,0.0,0.0,0,2025-08-15 16:41:28,was_roster_turnover_detailed.csv,2025-08-17 08:45:20,32
WAS,2018,2019,TE,4,6,2,2,4,50.0,50.0,66.67,2,2025-08-15 16:41:28,was_roster_turnover_detailed.csv,2025-08-17 08:45:20,32
WAS,2018,2019,WR,10,9,4,6,5,40.0,60.0,55.56,-1,2025-08-15 16:41:28,was_roster_turnover_detailed.csv,2025-08-17 08:45:20,32
WAS,2019,2020,DB,18,11,7,11,4,38.89,61.11,36.36,-7,2025-08-15 16:41:28,was_roster_turnover_detailed.csv,2025-08-17 08:45:20,32
WAS,2019,2020,DL,8,7,2,6,5,25.0,75.0,71.43,-1,2025-08-15 16:41:28,was_roster_turnover_detailed.csv,2025-08-17 08:45:20,32
WAS,2019,2020,LB,5,7,2,3,5,40.0,60.0,71.43,2,2025-08-15 16:41:28,was_roster_turnover_detailed.csv,2025-08-17 08:45:20,32
WAS,2019,2020,OL,4,6,1,3,5,25.0,75.0,83.33,2,2025-08-15 16:41:28,was_roster_turnover_detailed.csv,2025-08-17 08:45:20,32
WAS,2019,2020,OTHER,14,14,6,8,8,42.86,57.14,57.14,0,2025-08-15 16:41:28,was_roster_turnover_detailed.csv,2025-08-17 08:45:20,32
WAS,2019,2020,QB,3,4,1,2,3,33.33,66.67,75.0,1,2025-08-15 16:41:28,was_roster_turnover_detailed.csv,2025-08-17 08:45:20,32
WAS,2019,2020,RB,7,5,0,7,5,0.0,100.0,100.0,-2,2025-08-15 16:41:28,was_roster_turnover_detailed.csv,2025-08-17 08:45:20,32
WAS,2019,2020,ST,3,3,3,0,0,100.0,0.0,0.0,0,2025-08-15 16:41:28,was_roster_turnover_detailed.csv,2025-08-17 08:45:20,32
WAS,2019,2020,TE,6,4,1,5,3,16.67,83.33,75.0,-2,2025-08-15 16:41:28,was_roster_turnover_detailed.csv,2025-08-17 08:45:20,32
WAS,2019,2020,WR,9,9,3,6,6,33.33,66.67,66.67,0,2025-08-15 16:41:28,was_roster_turnover_detailed.csv,2025-08-17 08:45:20,32
WAS,2020,2021,DB,11,14,7,4,7,63.64,36.36,50.0,3,2025-08-15 16:41:28,was_roster_turnover_detailed.csv,2025-08-17 08:45:20,32
WAS,2020,2021,DL,7,7,3,4,4,42.86,57.14,57.14,0,2025-08-15 16:41:28,was_roster_turnover_detailed.csv,2025-08-17 08:45:20,32
WAS,2020,2021,LB,7,7,2,5,5,28.57,71.43,71.43,0,2025-08-15 16:41:28,was_roster_turnover_detailed.csv,2025-08-17 08:45:20,32
WAS,2020,2021,OL,6,8,4,2,4,66.67,33.33,50.0,2,2025-08-15 16:41:28,was_roster_turnover_detailed.csv,2025-08-17 08:45:20,32
WAS,2020,2021,OTHER,14,16,9,5,7,64.29,35.71,43.75,2,2025-08-15 16:41:28,was_roster_turnover_detailed.csv,2025-08-17 08:45:20,32
WAS,2020,2021,QB,4,4,2,2,2,50.0,50.0,50.0,0,2025-08-15 16:41:28,was_roster_turnover_detailed.csv,2025-08-17 08:45:20,32
WAS,2020,2021,RB,5,6,2,3,4,40.0,60.0,66.67,1,2025-08-15 16:41:28,was_roster_turnover_detailed.csv,2025-08-17 08:45:20,32
WAS,2020,2021,ST,3,7,2,1,5,66.67,33.33,71.43,4,2025-08-15 16:41:28,was_roster_turnover_detailed.csv,2025-08-17 08:45:20,32
WAS,2020,2021,TE,4,5,2,2,3,50.0,50.0,60.0,1,2025-08-15 16:41:28,was_roster_turnover_detailed.csv,2025-08-17 08:45:20,32
WAS,2020,2021,WR,9,8,3,6,5,33.33,66.67,62.5,-1,2025-08-15 16:41:28,was_roster_turnover_detailed.csv,2025-08-17 08:45:20,32
WAS,2021,2022,DB,14,12,7,7,5,50.0,50.0,41.67,-2,2025-08-15 16:41:28,was_roster_turnover_detailed.csv,2025-08-17 08:45:20,32
WAS,2021,2022,DL,7,11,2,5,9,28.57,71.43,81.82,4,2025-08-15 16:41:28,was_roster_turnover_detailed.csv,2025-08-17 08:45:20,32
WAS,2021,2022,LB,7,7,3,4,4,42.86,57.14,57.14,0,2025-08-15 16:41:28,was_roster_turnover_detailed.csv,2025-08-17 08:45:20,32
WAS,2021,2022,OL,8,7,3,5,4,37.5,62.5,57.14,-1,2025-08-15 16:41:28,was_roster_turnover_detailed.csv,2025-08-17 08:45:20,32
WAS,2021,2022,OTHER,16,12,8,8,4,50.0,50.0,33.33,-4,2025-08-15 16:41:28,was_roster_turnover_detailed.csv,2025-08-17 08:45:20,32
WAS,2021,2022,QB,4,3,1,3,2,25.0,75.0,66.67,-1,2025-08-15 16:41:28,was_roster_turnover_detailed.csv,2025-08-17 08:45:20,32
WAS,2021,2022,RB,6,6,5,1,1,83.33,16.67,16.67,0,2025-08-15 16:41:28,was_roster_turnover_detailed.csv,2025-08-17 08:45:20,32
WAS,2021,2022,ST,7,3,3,4,0,42.86,57.14,0.0,-4,2025-08-15 16:41:28,was_roster_turnover_detailed.csv,2025-08-17 08:45:20,32
WAS,2021,2022,TE,5,4,2,3,2,40.0,60.0,50.0,-1,2025-08-15 16:41:28,was_roster_turnover_detailed.csv,2025-08-17 08:45:20,32
WAS,2021,2022,WR,8,8,5,3,3,62.5,37.5,37.5,0,2025-08-15 16:41:28,was_roster_turnover_detailed.csv,2025-08-17 08:45:20,32
WAS,2022,2023,DB,12,16,7,5,9,58.33,41.67,56.25,4,2025-08-15 16:41:28,was_roster_turnover_detailed.csv,2025-08-17 08:45:20,32
WAS,2022,2023,DL,11,13,5,6,8,45.45,54.55,61.54,2,2025-08-15 16:41:28,was_roster_turnover_detailed.csv,2025-08-17 08:45:20,32
WAS,2022,2023,LB,7,6,2,5,4,28.57,71.43,66.67,-1,2025-08-15 16:41:28,was_roster_turnover_detailed.csv,2025-08-17 08:45:20,32
WAS,2022,2023,OL,7,11,3,4,8,42.86,57.14,72.73,4,2025-08-15 16:41:28,was_roster_turnover_detailed.csv,2025-08-17 08:45:20,32
WAS,2022,2023,OTHER,12,3,2,10,1,16.67,83.33,33.33,-9,2025-08-15 16:41:28,was_roster_turnover_detailed.csv,2025-08-17 08:45:20,32
WAS,2022,2023,QB,3,2,1,2,1,33.33,66.67,50.0,-1,2025-08-15 16:41:28,was_roster_turnover_detailed.csv,2025-08-17 08:45:20,32
WAS,2022,2023,RB,6,6,4,2,2,66.67,33.33,33.33,0,2025-08-15 16:41:28,was_roster_turnover_detailed.csv,2025-08-17 08:45:20,32
WAS,2022,2023,ST,3,4,3,0,1,100.0,0.0,25.0,1,2025-08-15 16:41:28,was_roster_turnover_detailed.csv,2025-08-17 08:45:20,32
WAS,2022,2023,TE,4,3,3,1,0,75.0,25.0,0.0,-1,2025-08-15 16:41:28,was_roster_turnover_detailed.csv,2025-08-17 08:45:20,32
WAS,2022,2023,WR,8,7,4,4,3,50.0,50.0,42.86,-1,2025-08-15 16:41:28,was_roster_turnover_detailed.csv,2025-08-17 08:45:20,32
WAS,2023,2024,DB,16,13,5,11,8,31.25,68.75,61.54,-3,2025-08-15 16:41:28,was_roster_turnover_detailed.csv,2025-08-17 08:45:20,32
WAS,2023,2024,DL,13,10,4,9,6,30.77,69.23,60.0,-3,2025-08-15 16:41:28,was_roster_turnover_detailed.csv,2025-08-17 08:45:20,32
WAS,2023,2024,LB,6,4,0,6,4,0.0,100.0,100.0,-2,2025-08-15 16:41:28,was_roster_turnover_detailed.csv,2025-08-17 08:45:20,32
WAS,2023,2024,OL,11,5,3,8,2,27.27,72.73,40.0,-6,2025-08-15 16:41:28,was_roster_turnover_detailed.csv,2025-08-17 08:45:20,32
WAS,2023,2024,OTHER,3,12,0,3,12,0.0,100.0,100.0,9,2025-08-15 16:41:28,was_roster_turnover_detailed.csv,2025-08-17 08:45:20,32
WAS,2023,2024,QB,2,3,0,2,3,0.0,100.0,100.0,1,2025-08-15 16:41:28,was_roster_turnover_detailed.csv,2025-08-17 08:45:20,32
WAS,2023,2024,RB,6,4,2,4,2,33.33,66.67,50.0,-2,2025-08-15 16:41:28,was_roster_turnover_detailed.csv,2025-08-17 08:45:20,32
WAS,2023,2024,ST,4,6,1,3,5,25.0,75.0,83.33,2,2025-08-15 16:41:28,was_roster_turnover_detailed.csv,2025-08-17 08:45:20,32
WAS,2023,2024,TE,3,4,1,2,3,33.33,66.67,75.0,1,2025-08-15 16:41:28,was_roster_turnover_detailed.csv,2025-08-17 08:45:20,32
WAS,2023,2024,WR,7,9,3,4,6,42.86,57.14,66.67,2,2025-08-15 16:41:28,was_roster_turnover_detailed.csv,2025-08-17 08:45:20,32
