Team,Year,W,L,T,Games,Win_Pct,SoS,Extraction_Date
AKR,1920,8,0,3,11,0.8636,7.3,2025-08-16 09:41:02
AKR,1921,8,3,1,12,0.7083,2.0,2025-08-16 09:41:02
AKR,1922,3,5,2,10,0.4,2.3,2025-08-16 09:41:02
AKR,1923,1,6,0,7,0.1429,9.7,2025-08-16 09:41:02
AKR,1924,2,6,0,8,0.25,2.4,2025-08-16 09:41:02
AKR,1925,4,2,2,8,0.625,2.7,2025-08-16 09:41:02
AKR,1926,1,4,3,8,0.3125,0.9,2025-08-16 09:41:02
ATL,1966,3,11,0,14,0.2143,1.1,2025-08-16 09:41:02
ATL,1967,1,12,1,14,0.1071,3.2,2025-08-16 09:41:02
ATL,1968,2,12,0,14,0.1429,3.7,2025-08-16 09:41:02
ATL,1969,6,8,0,14,0.4286,2.3,2025-08-16 09:41:02
ATL,1970,4,8,2,14,0.3571,1.6,2025-08-16 09:41:02
ATL,1971,7,6,1,14,0.5357,1.5,2025-08-16 09:41:02
ATL,1972,7,7,0,14,0.5,-1.6,2025-08-16 09:41:02
ATL,1973,9,5,0,14,0.6429,-0.9,2025-08-16 09:41:02
ATL,1974,3,11,0,14,0.2143,-0.9,2025-08-16 09:41:02
ATL,1975,4,10,0,14,0.2857,0.0,2025-08-16 09:41:02
ATL,1976,4,10,0,14,0.2857,-0.3,2025-08-16 09:41:02
ATL,1977,7,7,0,14,0.5,-3.1,2025-08-16 09:41:02
ATL,1978,9,7,0,16,0.5625,-1.5,2025-08-16 09:41:02
ATL,1979,6,10,0,16,0.375,-1.1,2025-08-16 09:41:02
ATL,1980,12,4,0,16,0.75,-0.5,2025-08-16 09:41:02
ATL,1981,7,9,0,16,0.4375,-0.5,2025-08-16 09:41:02
ATL,1982,5,4,0,9,0.5556,-2.0,2025-08-16 09:41:02
ATL,1983,7,9,0,16,0.4375,2.0,2025-08-16 09:41:02
ATL,1984,4,12,0,16,0.25,-0.3,2025-08-16 09:41:02
ATL,1985,4,12,0,16,0.25,1.7,2025-08-16 09:41:02
ATL,1986,7,8,1,16,0.4688,-0.5,2025-08-16 09:41:02
ATL,1987,3,12,0,15,0.2,1.6,2025-08-16 09:41:02
ATL,1988,5,11,0,16,0.3125,-0.1,2025-08-16 09:41:02
ATL,1989,3,13,0,16,0.1875,0.8,2025-08-16 09:41:02
ATL,1990,5,11,0,16,0.3125,-1.1,2025-08-16 09:41:02
ATL,1991,10,6,0,16,0.625,2.0,2025-08-16 09:41:02
ATL,1992,6,10,0,16,0.375,1.4,2025-08-16 09:41:02
ATL,1993,6,10,0,16,0.375,-0.1,2025-08-16 09:41:02
ATL,1994,7,9,0,16,0.4375,0.0,2025-08-16 09:41:02
ATL,1995,9,7,0,16,0.5625,-0.7,2025-08-16 09:41:02
ATL,1996,3,13,0,16,0.1875,0.4,2025-08-16 09:41:02
ATL,1997,7,9,0,16,0.4375,-1.6,2025-08-16 09:41:02
ATL,1998,14,2,0,16,0.875,0.4,2025-08-16 09:41:02
ATL,1999,5,11,0,16,0.3125,-1.1,2025-08-16 09:41:02
ATL,2000,4,12,0,16,0.25,1.5,2025-08-16 09:41:02
ATL,2001,7,9,0,16,0.4375,0.7,2025-08-16 09:41:02
ATL,2002,9,6,1,16,0.5938,-0.4,2025-08-16 09:41:02
ATL,2003,5,11,0,16,0.3125,0.3,2025-08-16 09:41:02
ATL,2004,11,5,0,16,0.6875,-2.4,2025-08-16 09:41:02
ATL,2005,8,8,0,16,0.5,-1.9,2025-08-16 09:41:02
ATL,2006,7,9,0,16,0.4375,-0.8,2025-08-16 09:41:02
ATL,2007,4,12,0,16,0.25,-0.9,2025-08-16 09:41:02
ATL,2008,11,5,0,16,0.6875,-0.3,2025-08-16 09:41:02
ATL,2009,9,7,0,16,0.5625,2.7,2025-08-16 09:41:02
ATL,2010,13,3,0,16,0.8125,-1.8,2025-08-16 09:41:02
ATL,2011,10,6,0,16,0.625,0.3,2025-08-16 09:41:02
ATL,2012,13,3,0,16,0.8125,-1.1,2025-08-16 09:41:02
ATL,2013,4,12,0,16,0.25,2.9,2025-08-16 09:41:02
ATL,2014,6,10,0,16,0.375,-1.6,2025-08-16 09:41:02
ATL,2015,8,8,0,16,0.5,-3.4,2025-08-16 09:41:02
ATL,2016,11,5,0,16,0.6875,0.1,2025-08-16 09:41:02
ATL,2017,10,6,0,16,0.625,1.9,2025-08-16 09:41:02
ATL,2018,7,9,0,16,0.4375,0.4,2025-08-16 09:41:02
ATL,2019,7,9,0,16,0.4375,1.1,2025-08-16 09:41:02
ATL,2020,4,12,0,16,0.25,1.9,2025-08-16 09:41:02
ATL,2021,7,10,0,17,0.4118,0.1,2025-08-16 09:41:02
ATL,2022,7,10,0,17,0.4118,-0.9,2025-08-16 09:41:02
ATL,2023,7,10,0,17,0.4118,-1.9,2025-08-16 09:41:02
ATL,2024,8,9,0,17,0.4706,-0.2,2025-08-16 09:41:02
BBA,1946,3,10,1,14,0.25,1.1,2025-08-16 09:41:02
BBA,1947,8,4,2,14,0.6429,-0.3,2025-08-16 09:41:02
BBA,1948,7,7,0,14,0.5,0.0,2025-08-16 09:41:02
BBA,1949,5,5,2,12,0.5,0.2,2025-08-16 09:41:02
BCL,1947,2,11,1,14,0.1786,1.9,2025-08-16 09:41:02
BCL,1948,7,7,0,14,0.5,-0.1,2025-08-16 09:41:02
BCL,1949,1,11,0,12,0.0833,1.8,2025-08-16 09:41:02
BCL,1950,1,11,0,12,0.0833,1.0,2025-08-16 09:41:02
BDA,1946,3,10,1,14,0.25,1.0,2025-08-16 09:41:02
BDA,1947,3,10,1,14,0.25,1.4,2025-08-16 09:41:02
BDA,1948,2,12,0,14,0.1429,1.2,2025-08-16 09:41:02
BFF,1920,9,1,1,11,0.8636,-7.9,2025-08-16 09:41:02
BFF,1921,9,1,2,12,0.8333,-5.0,2025-08-16 09:41:02
BFF,1922,5,4,1,10,0.55,1.7,2025-08-16 09:41:02
BFF,1923,5,4,3,12,0.5417,-0.5,2025-08-16 09:41:02
BFF,1924,6,5,0,11,0.5455,-10.6,2025-08-16 09:41:02
BFF,1925,1,6,2,9,0.2222,2.4,2025-08-16 09:41:02
BFF,1926,4,4,2,10,0.5,-0.9,2025-08-16 09:41:02
BFF,1927,0,5,0,5,0.0,-2.2,2025-08-16 09:41:02
BFF,1929,1,7,1,9,0.1667,0.4,2025-08-16 09:41:02
BKN,1930,7,4,1,12,0.625,-2.1,2025-08-16 09:41:02
BKN,1931,2,12,0,14,0.1429,1.4,2025-08-16 09:41:02
BKN,1932,3,9,0,12,0.25,-0.6,2025-08-16 09:41:02
BKN,1933,5,4,1,10,0.55,-3.7,2025-08-16 09:41:02
BKN,1934,4,7,0,11,0.3636,0.4,2025-08-16 09:41:02
BKN,1935,5,6,1,12,0.4583,-1.6,2025-08-16 09:41:02
BKN,1936,3,8,1,12,0.2917,-1.8,2025-08-16 09:41:02
BKN,1937,3,7,1,11,0.3182,-0.9,2025-08-16 09:41:02
BKN,1938,4,4,3,11,0.5,0.2,2025-08-16 09:41:02
BKN,1939,4,6,1,11,0.4091,-0.3,2025-08-16 09:41:02
BKN,1940,8,3,0,11,0.7273,-2.3,2025-08-16 09:41:02
BKN,1941,7,4,0,11,0.6364,-3.3,2025-08-16 09:41:02
BKN,1942,3,8,0,11,0.2727,1.1,2025-08-16 09:41:02
BKN,1943,2,8,0,10,0.2,2.1,2025-08-16 09:41:02
BKN,1944,0,10,0,10,0.0,3.1,2025-08-16 09:41:02
BRL,1926,3,8,0,11,0.2727,-1.4,2025-08-16 09:41:02
BUF,1960,5,8,1,14,0.3929,0.1,2025-08-16 09:41:02
BUF,1961,6,8,0,14,0.4286,0.4,2025-08-16 09:41:02
BUF,1962,7,6,1,14,0.5357,-0.3,2025-08-16 09:41:02
BUF,1963,7,6,1,14,0.5357,-0.1,2025-08-16 09:41:02
BUF,1964,12,2,0,14,0.8571,-1.4,2025-08-16 09:41:02
BUF,1965,10,3,1,14,0.75,-0.8,2025-08-16 09:41:02
BUF,1966,9,4,1,14,0.6786,-0.2,2025-08-16 09:41:02
BUF,1967,4,10,0,14,0.2857,-0.2,2025-08-16 09:41:02
BUF,1968,1,12,1,14,0.1071,1.2,2025-08-16 09:41:02
BUF,1969,4,10,0,14,0.2857,0.9,2025-08-16 09:41:02
BUF,1970,3,10,1,14,0.25,-2.8,2025-08-16 09:41:02
BUF,1971,1,13,0,14,0.0714,1.6,2025-08-16 09:41:02
BUF,1972,4,9,1,14,0.3214,1.4,2025-08-16 09:41:02
BUF,1973,9,5,0,14,0.6429,-1.7,2025-08-16 09:41:02
BUF,1974,9,5,0,14,0.6429,-0.4,2025-08-16 09:41:02
BUF,1975,8,6,0,14,0.5714,2.4,2025-08-16 09:41:02
BUF,1976,2,12,0,14,0.1429,-0.8,2025-08-16 09:41:02
BUF,1977,3,11,0,14,0.2143,3.0,2025-08-16 09:41:02
BUF,1978,5,11,0,16,0.3125,0.0,2025-08-16 09:41:02
BUF,1979,7,9,0,16,0.4375,0.4,2025-08-16 09:41:02
BUF,1980,11,5,0,16,0.6875,0.2,2025-08-16 09:41:02
BUF,1981,10,6,0,16,0.625,-0.9,2025-08-16 09:41:02
BUF,1982,4,5,0,9,0.4444,1.9,2025-08-16 09:41:02
BUF,1983,8,8,0,16,0.5,0.5,2025-08-16 09:41:02
BUF,1984,2,14,0,16,0.125,0.7,2025-08-16 09:41:02
BUF,1985,2,14,0,16,0.125,1.5,2025-08-16 09:41:02
BUF,1986,4,12,0,16,0.25,-2.0,2025-08-16 09:41:02
BUF,1987,7,8,0,15,0.4667,2.1,2025-08-16 09:41:02
BUF,1988,12,4,0,16,0.75,0.6,2025-08-16 09:41:02
BUF,1989,9,7,0,16,0.5625,-1.4,2025-08-16 09:41:02
BUF,1990,13,3,0,16,0.8125,-1.7,2025-08-16 09:41:02
BUF,1991,13,3,0,16,0.8125,-5.2,2025-08-16 09:41:02
BUF,1992,11,5,0,16,0.6875,-1.9,2025-08-16 09:41:02
BUF,1993,12,4,0,16,0.75,-0.6,2025-08-16 09:41:02
BUF,1994,7,9,0,16,0.4375,0.8,2025-08-16 09:41:02
BUF,1995,10,6,0,16,0.625,-1.8,2025-08-16 09:41:02
BUF,1996,10,6,0,16,0.625,-0.4,2025-08-16 09:41:02
BUF,1997,6,10,0,16,0.375,2.5,2025-08-16 09:41:02
BUF,1998,10,6,0,16,0.625,1.0,2025-08-16 09:41:02
BUF,1999,11,5,0,16,0.6875,1.5,2025-08-16 09:41:02
BUF,2000,8,8,0,16,0.5,2.2,2025-08-16 09:41:02
BUF,2001,3,13,0,16,0.1875,0.2,2025-08-16 09:41:02
BUF,2002,8,8,0,16,0.5,0.9,2025-08-16 09:41:02
BUF,2003,6,10,0,16,0.375,1.3,2025-08-16 09:41:02
BUF,2004,9,7,0,16,0.5625,1.1,2025-08-16 09:41:02
BUF,2005,5,11,0,16,0.3125,0.2,2025-08-16 09:41:02
BUF,2006,7,9,0,16,0.4375,2.9,2025-08-16 09:41:02
BUF,2007,7,9,0,16,0.4375,2.3,2025-08-16 09:41:02
BUF,2008,7,9,0,16,0.4375,-3.0,2025-08-16 09:41:02
BUF,2009,6,10,0,16,0.375,2.4,2025-08-16 09:41:02
BUF,2010,4,12,0,16,0.25,4.3,2025-08-16 09:41:02
BUF,2011,6,10,0,16,0.375,0.5,2025-08-16 09:41:02
BUF,2012,6,10,0,16,0.375,-1.0,2025-08-16 09:41:02
BUF,2013,6,10,0,16,0.375,-0.1,2025-08-16 09:41:02
BUF,2014,9,7,0,16,0.5625,1.6,2025-08-16 09:41:02
BUF,2015,8,8,0,16,0.5,-1.2,2025-08-16 09:41:02
BUF,2016,7,9,0,16,0.4375,-1.6,2025-08-16 09:41:02
BUF,2017,9,7,0,16,0.5625,-0.5,2025-08-16 09:41:02
BUF,2018,6,10,0,16,0.375,-0.3,2025-08-16 09:41:02
BUF,2019,10,6,0,16,0.625,-1.3,2025-08-16 09:41:02
BUF,2020,13,3,0,16,0.8125,-0.2,2025-08-16 09:41:02
BUF,2021,11,6,0,17,0.6471,-1.6,2025-08-16 09:41:02
BUF,2022,13,3,0,16,0.8125,0.4,2025-08-16 09:41:02
BUF,2023,11,6,0,17,0.6471,-1.8,2025-08-16 09:41:02
BUF,2024,13,4,0,17,0.7647,-1.1,2025-08-16 09:41:02
BYK,1944,2,8,0,10,0.2,3.9,2025-08-16 09:41:02
BYK,1945,3,6,1,10,0.35,1.6,2025-08-16 09:41:02
BYK,1946,2,8,1,11,0.2273,0.5,2025-08-16 09:41:02
BYK,1947,4,7,1,12,0.375,-1.6,2025-08-16 09:41:02
BYK,1948,3,9,0,12,0.25,0.9,2025-08-16 09:41:02
CAR,1995,7,9,0,16,0.4375,-1.5,2025-08-16 09:41:02
CAR,1996,12,4,0,16,0.75,-2.3,2025-08-16 09:41:02
CAR,1997,7,9,0,16,0.4375,-0.5,2025-08-16 09:41:02
CAR,1998,4,12,0,16,0.25,3.5,2025-08-16 09:41:02
CAR,1999,8,8,0,16,0.5,-3.6,2025-08-16 09:41:02
CAR,2000,7,9,0,16,0.4375,-1.1,2025-08-16 09:41:02
CAR,2001,1,15,0,16,0.0625,0.9,2025-08-16 09:41:02
CAR,2002,7,9,0,16,0.4375,-0.5,2025-08-16 09:41:02
CAR,2003,11,5,0,16,0.6875,-2.2,2025-08-16 09:41:02
CAR,2004,7,9,0,16,0.4375,-1.7,2025-08-16 09:41:02
CAR,2005,11,5,0,16,0.6875,-3.2,2025-08-16 09:41:02
CAR,2006,8,8,0,16,0.5,-0.5,2025-08-16 09:41:02
CAR,2007,7,9,0,16,0.4375,-0.8,2025-08-16 09:41:02
CAR,2008,12,4,0,16,0.75,0.3,2025-08-16 09:41:02
CAR,2009,8,8,0,16,0.5,3.5,2025-08-16 09:41:02
CAR,2010,2,14,0,16,0.125,0.1,2025-08-16 09:41:02
CAR,2011,6,10,0,16,0.375,0.1,2025-08-16 09:41:02
CAR,2012,7,9,0,16,0.4375,1.2,2025-08-16 09:41:02
CAR,2013,12,4,0,16,0.75,1.4,2025-08-16 09:41:02
CAR,2014,7,8,1,16,0.4688,-0.9,2025-08-16 09:41:02
CAR,2015,15,1,0,16,0.9375,-3.9,2025-08-16 09:41:02
CAR,2016,6,10,0,16,0.375,1.1,2025-08-16 09:41:02
CAR,2017,11,5,0,16,0.6875,2.1,2025-08-16 09:41:02
CAR,2018,7,9,0,16,0.4375,1.3,2025-08-16 09:41:02
CAR,2019,5,11,0,16,0.3125,1.1,2025-08-16 09:41:02
CAR,2020,5,11,0,16,0.3125,2.2,2025-08-16 09:41:02
CAR,2021,5,12,0,17,0.2941,0.4,2025-08-16 09:41:02
CAR,2022,7,10,0,17,0.4118,-0.6,2025-08-16 09:41:02
CAR,2023,2,15,0,17,0.1176,0.7,2025-08-16 09:41:02
CAR,2024,5,12,0,17,0.2941,0.4,2025-08-16 09:41:02
CBD,1920,7,4,2,13,0.6154,6.6,2025-08-16 09:41:02
CBD,1921,5,2,3,10,0.65,7.2,2025-08-16 09:41:02
CBD,1922,10,0,2,12,0.9167,-3.4,2025-08-16 09:41:02
CBD,1923,11,0,1,12,0.9583,-3.1,2025-08-16 09:41:02
CBD,1925,4,4,0,8,0.5,-0.7,2025-08-16 09:41:02
CBD,1926,1,9,3,13,0.1923,-0.6,2025-08-16 09:41:02
CCL,1921,1,3,0,4,0.25,0.1,2025-08-16 09:41:02
CHI,1920,10,1,2,13,0.8462,-0.3,2025-08-16 09:41:02
CHI,1921,9,1,1,11,0.8636,-3.9,2025-08-16 09:41:02
CHI,1922,9,3,0,12,0.75,-0.4,2025-08-16 09:41:02
CHI,1923,9,2,1,12,0.7917,-2.2,2025-08-16 09:41:02
CHI,1924,6,1,4,11,0.7273,0.1,2025-08-16 09:41:02
CHI,1925,9,5,3,17,0.6176,-0.5,2025-08-16 09:41:02
CHI,1926,12,1,3,16,0.8438,-1.4,2025-08-16 09:41:02
CHI,1927,9,3,2,14,0.7143,-1.0,2025-08-16 09:41:02
CHI,1928,7,5,1,13,0.5769,-4.3,2025-08-16 09:41:02
CHI,1929,4,9,2,15,0.3333,1.8,2025-08-16 09:41:02
CHI,1930,9,4,1,14,0.6786,0.8,2025-08-16 09:41:02
CHI,1931,8,5,0,13,0.6154,1.6,2025-08-16 09:41:02
CHI,1932,7,1,6,14,0.7143,-0.5,2025-08-16 09:41:02
CHI,1933,10,2,1,13,0.8077,3.0,2025-08-16 09:41:02
CHI,1934,13,0,0,13,1.0,-1.0,2025-08-16 09:41:02
CHI,1935,6,4,2,12,0.5833,1.1,2025-08-16 09:41:02
CHI,1936,9,3,0,12,0.75,0.4,2025-08-16 09:41:02
CHI,1937,9,1,1,11,0.8636,0.6,2025-08-16 09:41:02
CHI,1938,6,5,0,11,0.5455,-0.1,2025-08-16 09:41:02
CHI,1939,8,3,0,11,0.7273,-0.6,2025-08-16 09:41:02
CHI,1940,8,3,0,11,0.7273,1.2,2025-08-16 09:41:02
CHI,1941,10,1,0,11,0.9091,-2.4,2025-08-16 09:41:02
CHI,1942,11,0,0,11,1.0,-5.2,2025-08-16 09:41:02
CHI,1943,8,1,1,10,0.85,-1.7,2025-08-16 09:41:02
CHI,1944,6,3,1,10,0.65,-1.6,2025-08-16 09:41:02
CHI,1945,3,7,0,10,0.3,1.4,2025-08-16 09:41:02
CHI,1946,8,2,1,11,0.7727,-0.9,2025-08-16 09:41:02
CHI,1947,8,4,0,12,0.6667,1.5,2025-08-16 09:41:02
CHI,1948,10,2,0,12,0.8333,-1.3,2025-08-16 09:41:02
CHI,1949,9,3,0,12,0.75,0.3,2025-08-16 09:41:02
CHI,1950,9,3,0,12,0.75,-3.7,2025-08-16 09:41:02
CHI,1951,7,5,0,12,0.5833,-1.5,2025-08-16 09:41:02
CHI,1952,5,7,0,12,0.4167,0.0,2025-08-16 09:41:02
CHI,1953,3,8,1,12,0.2917,-0.9,2025-08-16 09:41:02
CHI,1954,8,4,0,12,0.6667,2.9,2025-08-16 09:41:02
CHI,1955,8,4,0,12,0.6667,-3.6,2025-08-16 09:41:02
CHI,1956,9,2,1,12,0.7917,0.3,2025-08-16 09:41:02
CHI,1957,5,7,0,12,0.4167,0.1,2025-08-16 09:41:02
CHI,1958,8,4,0,12,0.6667,0.2,2025-08-16 09:41:02
CHI,1959,8,4,0,12,0.6667,0.8,2025-08-16 09:41:02
CHI,1960,5,6,1,12,0.4583,0.8,2025-08-16 09:41:02
CHI,1961,8,6,0,14,0.5714,2.5,2025-08-16 09:41:02
CHI,1962,9,5,0,14,0.6429,3.6,2025-08-16 09:41:02
CHI,1963,11,1,2,14,0.8571,-1.8,2025-08-16 09:41:02
CHI,1964,5,9,0,14,0.3571,3.9,2025-08-16 09:41:02
CHI,1965,9,5,0,14,0.6429,5.0,2025-08-16 09:41:02
CHI,1966,5,7,2,14,0.4286,2.5,2025-08-16 09:41:02
CHI,1967,7,6,1,14,0.5357,1.5,2025-08-16 09:41:02
CHI,1968,7,7,0,14,0.5,0.9,2025-08-16 09:41:02
CHI,1969,1,13,0,14,0.0714,3.4,2025-08-16 09:41:02
CHI,1970,6,8,0,14,0.4286,2.6,2025-08-16 09:41:02
CHI,1971,6,8,0,14,0.4286,3.1,2025-08-16 09:41:02
CHI,1972,4,9,1,14,0.3214,2.2,2025-08-16 09:41:02
CHI,1973,3,11,0,14,0.2143,1.1,2025-08-16 09:41:02
CHI,1974,4,10,0,14,0.2857,-1.2,2025-08-16 09:41:02
CHI,1975,4,10,0,14,0.2857,1.9,2025-08-16 09:41:02
CHI,1976,7,7,0,14,0.5,1.9,2025-08-16 09:41:02
CHI,1977,9,5,0,14,0.6429,-3.7,2025-08-16 09:41:02
CHI,1978,7,9,0,16,0.4375,-1.1,2025-08-16 09:41:02
CHI,1979,10,6,0,16,0.625,-3.6,2025-08-16 09:41:02
CHI,1980,7,9,0,16,0.4375,-1.1,2025-08-16 09:41:02
CHI,1981,6,10,0,16,0.375,1.6,2025-08-16 09:41:02
CHI,1982,3,6,0,9,0.3333,-1.7,2025-08-16 09:41:02
CHI,1983,8,8,0,16,0.5,-1.7,2025-08-16 09:41:02
CHI,1984,10,6,0,16,0.625,-0.1,2025-08-16 09:41:02
CHI,1985,15,1,0,16,0.9375,-0.2,2025-08-16 09:41:02
CHI,1986,14,2,0,16,0.875,-2.7,2025-08-16 09:41:02
CHI,1987,11,4,0,15,0.7333,-1.1,2025-08-16 09:41:02
CHI,1988,12,4,0,16,0.75,0.5,2025-08-16 09:41:02
CHI,1989,6,10,0,16,0.375,1.2,2025-08-16 09:41:02
CHI,1990,11,5,0,16,0.6875,-0.8,2025-08-16 09:41:02
CHI,1991,11,5,0,16,0.6875,-1.0,2025-08-16 09:41:02
CHI,1992,5,11,0,16,0.3125,0.6,2025-08-16 09:41:02
CHI,1993,7,9,0,16,0.4375,-0.5,2025-08-16 09:41:02
CHI,1994,9,7,0,16,0.5625,0.3,2025-08-16 09:41:02
CHI,1995,9,7,0,16,0.5625,0.3,2025-08-16 09:41:02
CHI,1996,7,9,0,16,0.4375,1.1,2025-08-16 09:41:02
CHI,1997,4,12,0,16,0.25,1.4,2025-08-16 09:41:02
CHI,1998,4,12,0,16,0.25,2.0,2025-08-16 09:41:02
CHI,1999,6,10,0,16,0.375,2.3,2025-08-16 09:41:02
CHI,2000,5,11,0,16,0.3125,2.4,2025-08-16 09:41:02
CHI,2001,13,3,0,16,0.8125,-0.5,2025-08-16 09:41:02
CHI,2002,4,12,0,16,0.25,0.9,2025-08-16 09:41:02
CHI,2003,7,9,0,16,0.4375,0.4,2025-08-16 09:41:02
CHI,2004,5,11,0,16,0.3125,-2.0,2025-08-16 09:41:02
CHI,2005,11,5,0,16,0.6875,-2.2,2025-08-16 09:41:02
CHI,2006,13,3,0,16,0.8125,-2.9,2025-08-16 09:41:02
CHI,2007,7,9,0,16,0.4375,2.1,2025-08-16 09:41:02
CHI,2008,9,7,0,16,0.5625,0.5,2025-08-16 09:41:02
CHI,2009,7,9,0,16,0.4375,-0.9,2025-08-16 09:41:02
CHI,2010,11,5,0,16,0.6875,1.1,2025-08-16 09:41:02
CHI,2011,8,8,0,16,0.5,0.9,2025-08-16 09:41:02
CHI,2012,10,6,0,16,0.625,0.8,2025-08-16 09:41:02
CHI,2013,8,8,0,16,0.5,-2.1,2025-08-16 09:41:02
CHI,2014,5,11,0,16,0.3125,1.0,2025-08-16 09:41:02
CHI,2015,6,10,0,16,0.375,2.6,2025-08-16 09:41:02
CHI,2016,3,13,0,16,0.1875,0.0,2025-08-16 09:41:02
CHI,2017,5,11,0,16,0.3125,2.2,2025-08-16 09:41:02
CHI,2018,12,4,0,16,0.75,-2.3,2025-08-16 09:41:02
CHI,2019,8,8,0,16,0.5,0.2,2025-08-16 09:41:02
CHI,2020,8,8,0,16,0.5,0.1,2025-08-16 09:41:02
CHI,2021,6,11,0,17,0.3529,0.5,2025-08-16 09:41:02
CHI,2022,3,14,0,17,0.1765,1.6,2025-08-16 09:41:02
CHI,2023,7,10,0,17,0.4118,-0.9,2025-08-16 09:41:02
CHI,2024,5,12,0,17,0.2941,1.2,2025-08-16 09:41:02
CHT,1920,2,5,1,8,0.3125,-2.5,2025-08-16 09:41:02
CIB,1923,3,1,3,7,0.6429,-2.5,2025-08-16 09:41:02
CIB,1924,7,1,1,9,0.8333,-7.3,2025-08-16 09:41:02
CIB,1925,5,8,1,14,0.3929,3.7,2025-08-16 09:41:02
CIB,1927,8,4,1,13,0.6538,1.8,2025-08-16 09:41:02
CIN,1968,3,11,0,14,0.2143,1.8,2025-08-16 09:41:02
CIN,1969,4,9,1,14,0.3214,2.0,2025-08-16 09:41:02
CIN,1970,8,6,0,14,0.5714,-3.5,2025-08-16 09:41:02
CIN,1971,4,10,0,14,0.2857,-1.9,2025-08-16 09:41:02
CIN,1972,8,6,0,14,0.5714,-0.9,2025-08-16 09:41:02
CIN,1973,10,4,0,14,0.7143,-0.9,2025-08-16 09:41:02
CIN,1974,7,7,0,14,0.5,0.5,2025-08-16 09:41:02
CIN,1975,11,3,0,14,0.7857,0.2,2025-08-16 09:41:02
CIN,1976,10,4,0,14,0.7143,1.2,2025-08-16 09:41:02
CIN,1977,8,6,0,14,0.5714,2.0,2025-08-16 09:41:02
CIN,1978,4,12,0,16,0.25,0.7,2025-08-16 09:41:02
CIN,1979,4,12,0,16,0.25,3.9,2025-08-16 09:41:02
CIN,1980,6,10,0,16,0.375,0.6,2025-08-16 09:41:02
CIN,1981,12,4,0,16,0.75,-1.8,2025-08-16 09:41:02
CIN,1982,7,2,0,9,0.7778,-2.5,2025-08-16 09:41:02
CIN,1983,7,9,0,16,0.4375,-2.3,2025-08-16 09:41:02
CIN,1984,8,8,0,16,0.5,-1.2,2025-08-16 09:41:02
CIN,1985,7,9,0,16,0.4375,-0.9,2025-08-16 09:41:02
CIN,1986,10,6,0,16,0.625,0.5,2025-08-16 09:41:02
CIN,1987,4,11,0,15,0.2667,2.0,2025-08-16 09:41:02
CIN,1988,12,4,0,16,0.75,-1.3,2025-08-16 09:41:02
CIN,1989,8,8,0,16,0.5,-0.5,2025-08-16 09:41:02
CIN,1990,9,7,0,16,0.5625,-1.6,2025-08-16 09:41:02
CIN,1991,3,13,0,16,0.1875,2.1,2025-08-16 09:41:02
CIN,1992,5,11,0,16,0.3125,-1.0,2025-08-16 09:41:02
CIN,1993,3,13,0,16,0.1875,-0.2,2025-08-16 09:41:02
CIN,1994,3,13,0,16,0.1875,1.2,2025-08-16 09:41:02
CIN,1995,7,9,0,16,0.4375,-0.2,2025-08-16 09:41:02
CIN,1996,8,8,0,16,0.5,-0.3,2025-08-16 09:41:02
CIN,1997,7,9,0,16,0.4375,1.0,2025-08-16 09:41:02
CIN,1998,3,13,0,16,0.1875,0.5,2025-08-16 09:41:02
CIN,1999,4,12,0,16,0.25,-0.5,2025-08-16 09:41:02
CIN,2000,4,12,0,16,0.25,0.4,2025-08-16 09:41:02
CIN,2001,6,10,0,16,0.375,1.7,2025-08-16 09:41:02
CIN,2002,2,14,0,16,0.125,0.6,2025-08-16 09:41:02
CIN,2003,8,8,0,16,0.5,0.0,2025-08-16 09:41:02
CIN,2004,8,8,0,16,0.5,2.5,2025-08-16 09:41:02
CIN,2005,11,5,0,16,0.6875,-0.6,2025-08-16 09:41:02
CIN,2006,8,8,0,16,0.5,1.5,2025-08-16 09:41:02
CIN,2007,7,9,0,16,0.4375,-2.1,2025-08-16 09:41:02
CIN,2008,4,11,1,16,0.2812,3.0,2025-08-16 09:41:02
CIN,2009,10,6,0,16,0.625,-0.2,2025-08-16 09:41:02
CIN,2010,4,12,0,16,0.25,3.1,2025-08-16 09:41:02
CIN,2011,9,7,0,16,0.5625,-0.9,2025-08-16 09:41:02
CIN,2012,10,6,0,16,0.625,-2.4,2025-08-16 09:41:02
CIN,2013,11,5,0,16,0.6875,-2.5,2025-08-16 09:41:02
CIN,2014,10,5,1,16,0.6562,-0.6,2025-08-16 09:41:02
CIN,2015,12,4,0,16,0.75,1.9,2025-08-16 09:41:02
CIN,2016,6,9,1,16,0.4062,0.4,2025-08-16 09:41:02
CIN,2017,7,9,0,16,0.4375,-1.3,2025-08-16 09:41:02
CIN,2018,6,10,0,16,0.375,2.0,2025-08-16 09:41:02
CIN,2019,2,14,0,16,0.125,1.5,2025-08-16 09:41:02
CIN,2020,4,11,1,16,0.2812,-0.4,2025-08-16 09:41:02
CIN,2021,10,7,0,17,0.5882,-1.9,2025-08-16 09:41:02
CIN,2022,12,4,0,16,0.75,0.9,2025-08-16 09:41:02
CIN,2023,9,8,0,17,0.5294,2.8,2025-08-16 09:41:02
CIN,2024,9,8,0,17,0.5294,-0.8,2025-08-16 09:41:02
CLE,1946,12,2,0,14,0.8571,-2.6,2025-08-16 09:41:02
CLE,1947,12,1,1,14,0.8929,-2.0,2025-08-16 09:41:02
CLE,1948,14,0,0,14,1.0,-1.8,2025-08-16 09:41:02
CLE,1949,9,1,2,12,0.8333,-2.2,2025-08-16 09:41:02
CLE,1950,10,2,0,12,0.8333,1.7,2025-08-16 09:41:02
CLE,1951,11,1,0,12,0.9167,-0.3,2025-08-16 09:41:02
CLE,1952,8,4,0,12,0.6667,0.7,2025-08-16 09:41:02
CLE,1953,11,1,0,12,0.9167,-1.5,2025-08-16 09:41:02
CLE,1954,9,3,0,12,0.75,-4.1,2025-08-16 09:41:02
CLE,1955,9,2,1,12,0.7917,1.1,2025-08-16 09:41:02
CLE,1956,5,7,0,12,0.4167,-1.6,2025-08-16 09:41:02
CLE,1957,9,2,1,12,0.7917,-1.2,2025-08-16 09:41:02
CLE,1958,9,3,0,12,0.75,-2.0,2025-08-16 09:41:02
CLE,1959,7,5,0,12,0.5833,-1.6,2025-08-16 09:41:02
CLE,1960,8,3,1,12,0.7083,-1.1,2025-08-16 09:41:02
CLE,1961,8,5,1,14,0.6071,-1.9,2025-08-16 09:41:02
CLE,1962,7,6,1,14,0.5357,-4.0,2025-08-16 09:41:02
CLE,1963,10,4,0,14,0.7143,-1.0,2025-08-16 09:41:02
CLE,1964,10,3,1,14,0.75,-3.5,2025-08-16 09:41:02
CLE,1965,11,3,0,14,0.7857,-7.1,2025-08-16 09:41:02
CLE,1966,9,5,0,14,0.6429,-2.7,2025-08-16 09:41:02
CLE,1967,9,5,0,14,0.6429,-1.3,2025-08-16 09:41:02
CLE,1968,10,4,0,14,0.7143,-1.5,2025-08-16 09:41:02
CLE,1969,10,3,1,14,0.75,-2.8,2025-08-16 09:41:02
CLE,1970,7,7,0,14,0.5,-0.9,2025-08-16 09:41:02
CLE,1971,9,5,0,14,0.6429,-0.6,2025-08-16 09:41:02
CLE,1972,10,4,0,14,0.7143,-1.1,2025-08-16 09:41:02
CLE,1973,7,5,2,14,0.5714,0.3,2025-08-16 09:41:02
CLE,1974,4,10,0,14,0.2857,2.4,2025-08-16 09:41:02
CLE,1975,3,11,0,14,0.2143,4.2,2025-08-16 09:41:02
CLE,1976,9,5,0,14,0.6429,-0.3,2025-08-16 09:41:02
CLE,1977,6,8,0,14,0.4286,2.4,2025-08-16 09:41:02
CLE,1978,8,8,0,16,0.5,-0.6,2025-08-16 09:41:02
CLE,1979,9,7,0,16,0.5625,2.6,2025-08-16 09:41:02
CLE,1980,11,5,0,16,0.6875,-1.1,2025-08-16 09:41:02
CLE,1981,5,11,0,16,0.3125,-0.3,2025-08-16 09:41:02
CLE,1982,4,5,0,9,0.4444,1.2,2025-08-16 09:41:02
CLE,1983,9,7,0,16,0.5625,-3.1,2025-08-16 09:41:02
CLE,1984,5,11,0,16,0.3125,-0.8,2025-08-16 09:41:02
CLE,1985,8,8,0,16,0.5,-0.8,2025-08-16 09:41:02
CLE,1986,12,4,0,16,0.75,-1.4,2025-08-16 09:41:02
CLE,1987,10,5,0,15,0.6667,0.7,2025-08-16 09:41:02
CLE,1988,10,6,0,16,0.625,-0.5,2025-08-16 09:41:02
CLE,1989,9,6,1,16,0.5938,-0.6,2025-08-16 09:41:02
CLE,1990,3,13,0,16,0.1875,1.7,2025-08-16 09:41:02
CLE,1991,6,10,0,16,0.375,0.0,2025-08-16 09:41:02
CLE,1992,7,9,0,16,0.4375,-0.8,2025-08-16 09:41:02
CLE,1993,7,9,0,16,0.4375,-1.0,2025-08-16 09:41:02
CLE,1994,11,5,0,16,0.6875,-1.2,2025-08-16 09:41:02
CLE,1995,5,11,0,16,0.3125,0.4,2025-08-16 09:41:02
CLE,1999,2,14,0,16,0.125,-0.3,2025-08-16 09:41:02
CLE,2000,3,13,0,16,0.1875,1.5,2025-08-16 09:41:02
CLE,2001,7,9,0,16,0.4375,1.3,2025-08-16 09:41:02
CLE,2002,9,7,0,16,0.5625,-0.3,2025-08-16 09:41:02
CLE,2003,5,11,0,16,0.3125,1.3,2025-08-16 09:41:02
CLE,2004,4,12,0,16,0.25,3.7,2025-08-16 09:41:02
CLE,2005,6,10,0,16,0.375,0.1,2025-08-16 09:41:02
CLE,2006,4,12,0,16,0.25,1.5,2025-08-16 09:41:02
CLE,2007,10,6,0,16,0.625,-2.3,2025-08-16 09:41:02
CLE,2008,4,12,0,16,0.25,2.7,2025-08-16 09:41:02
CLE,2009,5,11,0,16,0.3125,-0.3,2025-08-16 09:41:02
CLE,2010,5,11,0,16,0.3125,2.3,2025-08-16 09:41:02
CLE,2011,4,12,0,16,0.25,0.2,2025-08-16 09:41:02
CLE,2012,5,11,0,16,0.3125,-1.2,2025-08-16 09:41:02
CLE,2013,4,12,0,16,0.25,-1.6,2025-08-16 09:41:02
CLE,2014,7,9,0,16,0.4375,-1.5,2025-08-16 09:41:02
CLE,2015,3,13,0,16,0.1875,3.5,2025-08-16 09:41:02
CLE,2016,1,15,0,16,0.0625,1.7,2025-08-16 09:41:02
CLE,2017,0,16,0,16,0.0,0.0,2025-08-16 09:41:02
CLE,2018,7,8,1,16,0.4688,1.7,2025-08-16 09:41:02
CLE,2019,6,10,0,16,0.375,1.7,2025-08-16 09:41:02
CLE,2020,11,5,0,16,0.6875,-1.9,2025-08-16 09:41:02
CLE,2021,8,9,0,17,0.4706,0.0,2025-08-16 09:41:02
CLE,2022,7,10,0,17,0.4118,1.1,2025-08-16 09:41:02
CLE,2023,11,6,0,17,0.6471,1.3,2025-08-16 09:41:02
CLE,2024,3,14,0,17,0.1765,1.2,2025-08-16 09:41:02
CLI,1931,2,8,0,10,0.2,2.8,2025-08-16 09:41:02
CLT,1953,3,9,0,12,0.25,2.0,2025-08-16 09:41:02
CLT,1954,3,9,0,12,0.25,4.1,2025-08-16 09:41:02
CLT,1955,5,6,1,12,0.4583,-2.5,2025-08-16 09:41:02
CLT,1956,5,7,0,12,0.4167,1.3,2025-08-16 09:41:02
CLT,1957,7,5,0,12,0.5833,-0.4,2025-08-16 09:41:02
CLT,1958,9,3,0,12,0.75,-0.7,2025-08-16 09:41:02
CLT,1959,9,3,0,12,0.75,-0.2,2025-08-16 09:41:02
CLT,1960,6,6,0,12,0.5,-2.5,2025-08-16 09:41:02
CLT,1961,8,6,0,14,0.5714,1.5,2025-08-16 09:41:02
CLT,1962,7,7,0,14,0.5,3.2,2025-08-16 09:41:02
CLT,1963,8,6,0,14,0.5714,-0.2,2025-08-16 09:41:02
CLT,1964,12,2,0,14,0.8571,1.0,2025-08-16 09:41:02
CLT,1965,10,3,1,14,0.75,5.4,2025-08-16 09:41:02
CLT,1966,9,5,0,14,0.6429,1.4,2025-08-16 09:41:02
CLT,1967,11,1,2,14,0.8571,-0.8,2025-08-16 09:41:02
CLT,1968,13,1,0,14,0.9286,-0.6,2025-08-16 09:41:02
CLT,1969,8,5,1,14,0.6071,2.2,2025-08-16 09:41:02
CLT,1970,11,2,1,14,0.8214,-5.8,2025-08-16 09:41:02
CLT,1971,10,4,0,14,0.7143,-1.9,2025-08-16 09:41:02
CLT,1972,5,9,0,14,0.3571,-1.1,2025-08-16 09:41:02
CLT,1973,4,10,0,14,0.2857,-0.2,2025-08-16 09:41:02
CLT,1974,2,12,0,14,0.1429,1.3,2025-08-16 09:41:02
CLT,1975,10,4,0,14,0.7143,-0.4,2025-08-16 09:41:02
CLT,1976,11,3,0,14,0.7857,-2.5,2025-08-16 09:41:02
CLT,1977,10,4,0,14,0.7143,-0.3,2025-08-16 09:41:02
CLT,1978,5,11,0,16,0.3125,2.6,2025-08-16 09:41:02
CLT,1979,5,11,0,16,0.3125,1.5,2025-08-16 09:41:02
CLT,1980,7,9,0,16,0.4375,0.5,2025-08-16 09:41:02
CLT,1981,2,14,0,16,0.125,1.3,2025-08-16 09:41:02
CLT,1982,0,8,1,9,0.0556,4.8,2025-08-16 09:41:02
CLT,1983,7,9,0,16,0.4375,-1.2,2025-08-16 09:41:02
CLT,1984,4,12,0,16,0.25,-0.2,2025-08-16 09:41:02
CLT,1985,5,11,0,16,0.3125,1.5,2025-08-16 09:41:02
CLT,1986,3,13,0,16,0.1875,0.3,2025-08-16 09:41:02
CLT,1987,9,6,0,15,0.6,0.1,2025-08-16 09:41:02
CLT,1988,9,7,0,16,0.5625,0.8,2025-08-16 09:41:02
CLT,1989,8,8,0,16,0.5,-0.3,2025-08-16 09:41:02
CLT,1990,7,9,0,16,0.4375,0.6,2025-08-16 09:41:02
CLT,1991,1,15,0,16,0.0625,-2.4,2025-08-16 09:41:02
CLT,1992,9,7,0,16,0.5625,-1.6,2025-08-16 09:41:02
CLT,1993,4,12,0,16,0.25,0.5,2025-08-16 09:41:02
CLT,1994,8,8,0,16,0.5,-0.7,2025-08-16 09:41:02
CLT,1995,9,7,0,16,0.5625,-2.3,2025-08-16 09:41:02
CLT,1996,9,7,0,16,0.5625,-0.6,2025-08-16 09:41:02
CLT,1997,3,13,0,16,0.1875,1.2,2025-08-16 09:41:02
CLT,1998,3,13,0,16,0.1875,3.0,2025-08-16 09:41:02
CLT,1999,13,3,0,16,0.8125,0.5,2025-08-16 09:41:02
CLT,2000,10,6,0,16,0.625,1.5,2025-08-16 09:41:02
CLT,2001,6,10,0,16,0.375,0.8,2025-08-16 09:41:02
CLT,2002,10,6,0,16,0.625,-1.1,2025-08-16 09:41:02
CLT,2003,12,4,0,16,0.75,0.0,2025-08-16 09:41:02
CLT,2004,12,4,0,16,0.75,0.7,2025-08-16 09:41:02
CLT,2005,14,2,0,16,0.875,-1.2,2025-08-16 09:41:02
CLT,2006,12,4,0,16,0.75,1.7,2025-08-16 09:41:02
CLT,2007,13,3,0,16,0.8125,0.3,2025-08-16 09:41:02
CLT,2008,12,4,0,16,0.75,1.6,2025-08-16 09:41:02
CLT,2009,14,2,0,16,0.875,-0.9,2025-08-16 09:41:02
CLT,2010,10,6,0,16,0.625,-0.1,2025-08-16 09:41:02
CLT,2011,2,14,0,16,0.125,0.4,2025-08-16 09:41:02
CLT,2012,11,5,0,16,0.6875,-2.8,2025-08-16 09:41:02
CLT,2013,11,5,0,16,0.6875,0.6,2025-08-16 09:41:02
CLT,2014,11,5,0,16,0.6875,-1.1,2025-08-16 09:41:02
CLT,2015,8,8,0,16,0.5,-2.0,2025-08-16 09:41:02
CLT,2016,8,8,0,16,0.5,-0.8,2025-08-16 09:41:02
CLT,2017,4,12,0,16,0.25,-1.3,2025-08-16 09:41:02
CLT,2018,10,6,0,16,0.625,-2.2,2025-08-16 09:41:02
CLT,2019,7,9,0,16,0.4375,-1.1,2025-08-16 09:41:02
CLT,2020,11,5,0,16,0.6875,-2.8,2025-08-16 09:41:02
CLT,2021,9,8,0,17,0.5294,-0.6,2025-08-16 09:41:02
CLT,2022,4,12,1,17,0.2647,-0.5,2025-08-16 09:41:02
CLT,2023,9,8,0,17,0.5294,-0.2,2025-08-16 09:41:02
CLT,2024,8,9,0,17,0.4706,-0.7,2025-08-16 09:41:02
COL,1920,2,6,2,10,0.3,6.6,2025-08-16 09:41:02
COL,1921,1,8,0,9,0.1111,7.8,2025-08-16 09:41:02
COL,1922,0,8,0,8,0.0,7.3,2025-08-16 09:41:02
COL,1923,5,4,1,10,0.55,-4.2,2025-08-16 09:41:02
COL,1924,4,4,0,8,0.5,-0.8,2025-08-16 09:41:02
COL,1925,0,9,0,9,0.0,9.0,2025-08-16 09:41:02
COL,1926,1,6,0,7,0.1429,2.3,2025-08-16 09:41:02
CRA,1946,5,6,3,14,0.4643,0.5,2025-08-16 09:41:02
CRA,1947,1,13,0,14,0.0714,1.4,2025-08-16 09:41:02
CRA,1948,1,13,0,14,0.0714,2.1,2025-08-16 09:41:02
CRA,1949,4,8,0,12,0.3333,1.5,2025-08-16 09:41:02
CRD,1920,6,2,2,10,0.7,-1.9,2025-08-16 09:41:02
CRD,1921,3,3,2,8,0.5,-2.6,2025-08-16 09:41:02
CRD,1922,8,3,0,11,0.7273,-5.0,2025-08-16 09:41:02
CRD,1923,8,4,0,12,0.6667,-7.1,2025-08-16 09:41:02
CRD,1924,5,4,1,10,0.55,-6.4,2025-08-16 09:41:02
CRD,1925,11,2,1,14,0.8214,-10.1,2025-08-16 09:41:02
CRD,1926,5,6,1,12,0.4583,3.0,2025-08-16 09:41:02
CRD,1927,3,7,1,11,0.3182,1.8,2025-08-16 09:41:02
CRD,1928,1,5,0,6,0.1667,1.1,2025-08-16 09:41:02
CRD,1929,6,6,1,13,0.5,0.2,2025-08-16 09:41:02
CRD,1930,5,6,2,13,0.4615,1.4,2025-08-16 09:41:02
CRD,1931,5,4,0,9,0.5556,3.9,2025-08-16 09:41:02
CRD,1932,2,6,2,10,0.3,1.1,2025-08-16 09:41:02
CRD,1933,1,9,1,11,0.1364,-0.3,2025-08-16 09:41:02
CRD,1934,5,6,0,11,0.4545,2.7,2025-08-16 09:41:02
CRD,1935,6,4,2,12,0.5833,2.5,2025-08-16 09:41:02
CRD,1936,3,8,1,12,0.2917,4.3,2025-08-16 09:41:02
CRD,1937,5,5,1,11,0.5,2.6,2025-08-16 09:41:02
CRD,1938,2,9,0,11,0.1818,2.4,2025-08-16 09:41:02
CRD,1939,1,10,0,11,0.0909,5.8,2025-08-16 09:41:02
CRD,1940,2,7,2,11,0.2727,3.3,2025-08-16 09:41:02
CRD,1941,3,7,1,11,0.3182,4.8,2025-08-16 09:41:02
CRD,1942,3,8,0,11,0.2727,2.5,2025-08-16 09:41:02
CRD,1943,0,10,0,10,0.0,3.9,2025-08-16 09:41:02
CRD,1944,0,10,0,10,0.0,4.1,2025-08-16 09:41:02
CRD,1945,1,9,0,10,0.1,4.8,2025-08-16 09:41:02
CRD,1946,6,5,0,11,0.5455,-0.6,2025-08-16 09:41:02
CRD,1947,9,3,0,12,0.75,1.9,2025-08-16 09:41:02
CRD,1948,11,1,0,12,0.9167,-0.9,2025-08-16 09:41:02
CRD,1949,6,5,1,12,0.5417,-0.2,2025-08-16 09:41:02
CRD,1950,5,7,0,12,0.4167,5.7,2025-08-16 09:41:02
CRD,1951,3,9,0,12,0.25,2.5,2025-08-16 09:41:02
CRD,1952,4,8,0,12,0.3333,0.0,2025-08-16 09:41:02
CRD,1953,1,10,1,12,0.125,2.6,2025-08-16 09:41:02
CRD,1954,2,10,0,12,0.1667,-0.8,2025-08-16 09:41:02
CRD,1955,4,7,1,12,0.375,3.6,2025-08-16 09:41:02
CRD,1956,7,5,0,12,0.5833,-1.4,2025-08-16 09:41:02
CRD,1957,3,9,0,12,0.25,0.7,2025-08-16 09:41:02
CRD,1958,2,9,1,12,0.2083,0.5,2025-08-16 09:41:02
CRD,1959,2,10,0,12,0.1667,-0.7,2025-08-16 09:41:02
CRD,1960,6,5,1,12,0.5417,0.3,2025-08-16 09:41:02
CRD,1961,7,7,0,14,0.5,-2.4,2025-08-16 09:41:02
CRD,1962,4,9,1,14,0.3214,-2.0,2025-08-16 09:41:02
CRD,1963,9,5,0,14,0.6429,-0.1,2025-08-16 09:41:02
CRD,1964,9,3,2,14,0.7143,-2.5,2025-08-16 09:41:02
CRD,1965,5,9,0,14,0.3571,-6.1,2025-08-16 09:41:02
CRD,1966,8,5,1,14,0.6071,-2.3,2025-08-16 09:41:02
CRD,1967,6,7,1,14,0.4643,-0.7,2025-08-16 09:41:02
CRD,1968,9,4,1,14,0.6786,-0.7,2025-08-16 09:41:02
CRD,1969,4,9,1,14,0.3214,-1.7,2025-08-16 09:41:02
CRD,1970,8,5,1,14,0.6071,0.5,2025-08-16 09:41:02
CRD,1971,4,9,1,14,0.3214,-0.8,2025-08-16 09:41:02
CRD,1972,4,9,1,14,0.3214,2.2,2025-08-16 09:41:02
CRD,1973,4,9,1,14,0.3214,2.3,2025-08-16 09:41:02
CRD,1974,10,4,0,14,0.7143,1.0,2025-08-16 09:41:02
CRD,1975,11,3,0,14,0.7857,-2.2,2025-08-16 09:41:02
CRD,1976,10,4,0,14,0.7143,-0.4,2025-08-16 09:41:02
CRD,1977,7,7,0,14,0.5,-0.3,2025-08-16 09:41:02
CRD,1978,6,10,0,16,0.375,0.5,2025-08-16 09:41:02
CRD,1979,5,11,0,16,0.3125,0.4,2025-08-16 09:41:02
CRD,1980,5,11,0,16,0.3125,0.8,2025-08-16 09:41:02
CRD,1981,7,9,0,16,0.4375,1.1,2025-08-16 09:41:02
CRD,1982,5,4,0,9,0.5556,1.2,2025-08-16 09:41:02
CRD,1983,8,7,1,16,0.5312,2.3,2025-08-16 09:41:02
CRD,1984,9,7,0,16,0.5625,0.5,2025-08-16 09:41:02
CRD,1985,5,11,0,16,0.3125,-1.6,2025-08-16 09:41:02
CRD,1986,4,11,1,16,0.2812,0.2,2025-08-16 09:41:02
CRD,1987,7,8,0,15,0.4667,-0.5,2025-08-16 09:41:02
CRD,1988,7,9,0,16,0.4375,0.2,2025-08-16 09:41:02
CRD,1989,5,11,0,16,0.3125,0.3,2025-08-16 09:41:02
CRD,1990,5,11,0,16,0.3125,1.3,2025-08-16 09:41:02
CRD,1991,4,12,0,16,0.25,3.8,2025-08-16 09:41:02
CRD,1992,4,12,0,16,0.25,2.5,2025-08-16 09:41:02
CRD,1993,7,9,0,16,0.4375,0.4,2025-08-16 09:41:02
CRD,1994,8,8,0,16,0.5,-0.3,2025-08-16 09:41:02
CRD,1995,4,12,0,16,0.25,1.7,2025-08-16 09:41:02
CRD,1996,7,9,0,16,0.4375,-1.4,2025-08-16 09:41:02
CRD,1997,4,12,0,16,0.25,-0.4,2025-08-16 09:41:02
CRD,1998,9,7,0,16,0.5625,-4.1,2025-08-16 09:41:02
CRD,1999,6,10,0,16,0.375,-0.2,2025-08-16 09:41:02
CRD,2000,3,13,0,16,0.1875,-0.7,2025-08-16 09:41:02
CRD,2001,7,9,0,16,0.4375,-1.2,2025-08-16 09:41:02
CRD,2002,5,11,0,16,0.3125,-0.2,2025-08-16 09:41:02
CRD,2003,4,12,0,16,0.25,1.6,2025-08-16 09:41:02
CRD,2004,6,10,0,16,0.375,-2.5,2025-08-16 09:41:02
CRD,2005,5,11,0,16,0.3125,-0.2,2025-08-16 09:41:02
CRD,2006,5,11,0,16,0.3125,-2.2,2025-08-16 09:41:02
CRD,2007,8,8,0,16,0.5,-4.3,2025-08-16 09:41:02
CRD,2008,9,7,0,16,0.5625,-1.9,2025-08-16 09:41:02
CRD,2009,10,6,0,16,0.625,-3.4,2025-08-16 09:41:02
CRD,2010,5,11,0,16,0.3125,-3.6,2025-08-16 09:41:02
CRD,2011,8,8,0,16,0.5,0.0,2025-08-16 09:41:02
CRD,2012,5,11,0,16,0.3125,3.5,2025-08-16 09:41:02
CRD,2013,10,6,0,16,0.625,3.0,2025-08-16 09:41:02
CRD,2014,11,5,0,16,0.6875,1.3,2025-08-16 09:41:02
CRD,2015,13,3,0,16,0.8125,1.3,2025-08-16 09:41:02
CRD,2016,7,8,1,16,0.4688,-1.9,2025-08-16 09:41:02
CRD,2017,8,8,0,16,0.5,0.4,2025-08-16 09:41:02
CRD,2018,3,13,0,16,0.1875,1.0,2025-08-16 09:41:02
CRD,2019,5,10,1,16,0.3438,1.8,2025-08-16 09:41:02
CRD,2020,8,8,0,16,0.5,-0.1,2025-08-16 09:41:02
CRD,2021,11,6,0,17,0.6471,0.3,2025-08-16 09:41:02
CRD,2022,4,13,0,17,0.2353,0.2,2025-08-16 09:41:02
CRD,2023,4,13,0,17,0.2353,1.9,2025-08-16 09:41:02
CRD,2024,8,9,0,17,0.4706,0.9,2025-08-16 09:41:02
CTI,1920,2,4,2,8,0.375,11.4,2025-08-16 09:41:02
CTI,1921,3,5,0,8,0.375,-3.4,2025-08-16 09:41:02
DAL,1960,0,11,1,12,0.0417,1.2,2025-08-16 09:41:02
DAL,1961,4,9,1,14,0.3214,-2.1,2025-08-16 09:41:02
DAL,1962,5,8,1,14,0.3929,-3.7,2025-08-16 09:41:02
DAL,1963,4,10,0,14,0.2857,0.2,2025-08-16 09:41:02
DAL,1964,5,8,1,14,0.3929,-2.7,2025-08-16 09:41:02
DAL,1965,7,7,0,14,0.5,-6.5,2025-08-16 09:41:02
DAL,1966,10,3,1,14,0.75,-4.0,2025-08-16 09:41:02
DAL,1967,9,5,0,14,0.6429,-2.4,2025-08-16 09:41:02
DAL,1968,12,2,0,14,0.8571,-3.7,2025-08-16 09:41:02
DAL,1969,11,2,1,14,0.8214,-3.5,2025-08-16 09:41:02
DAL,1970,10,4,0,14,0.7143,1.4,2025-08-16 09:41:02
DAL,1971,11,3,0,14,0.7857,-3.3,2025-08-16 09:41:02
DAL,1972,10,4,0,14,0.7143,0.5,2025-08-16 09:41:02
DAL,1973,10,4,0,14,0.7143,0.0,2025-08-16 09:41:02
DAL,1974,8,6,0,14,0.5714,1.5,2025-08-16 09:41:02
DAL,1975,10,4,0,14,0.7143,-1.7,2025-08-16 09:41:02
DAL,1976,11,3,0,14,0.7857,-2.8,2025-08-16 09:41:02
DAL,1977,12,2,0,14,0.8571,-1.7,2025-08-16 09:41:02
DAL,1978,12,4,0,16,0.75,0.0,2025-08-16 09:41:02
DAL,1979,11,5,0,16,0.6875,-0.3,2025-08-16 09:41:02
DAL,1980,12,4,0,16,0.75,-1.0,2025-08-16 09:41:02
DAL,1981,12,4,0,16,0.75,0.5,2025-08-16 09:41:02
DAL,1982,6,3,0,9,0.6667,-0.8,2025-08-16 09:41:02
DAL,1983,12,4,0,16,0.75,1.1,2025-08-16 09:41:02
DAL,1984,9,7,0,16,0.5625,1.0,2025-08-16 09:41:02
DAL,1985,10,6,0,16,0.625,-1.3,2025-08-16 09:41:02
DAL,1986,7,9,0,16,0.4375,1.5,2025-08-16 09:41:02
DAL,1987,7,8,0,15,0.4667,-1.5,2025-08-16 09:41:02
DAL,1988,3,13,0,16,0.1875,1.2,2025-08-16 09:41:02
DAL,1989,1,15,0,16,0.0625,1.4,2025-08-16 09:41:02
DAL,1990,7,9,0,16,0.4375,0.3,2025-08-16 09:41:02
DAL,1991,11,5,0,16,0.6875,2.4,2025-08-16 09:41:02
DAL,1992,13,3,0,16,0.8125,-0.4,2025-08-16 09:41:02
DAL,1993,12,4,0,16,0.75,0.4,2025-08-16 09:41:02
DAL,1994,12,4,0,16,0.75,-0.3,2025-08-16 09:41:02
DAL,1995,12,4,0,16,0.75,0.7,2025-08-16 09:41:02
DAL,1996,10,6,0,16,0.625,0.1,2025-08-16 09:41:02
DAL,1997,6,10,0,16,0.375,-0.1,2025-08-16 09:41:02
DAL,1998,10,6,0,16,0.625,-3.1,2025-08-16 09:41:02
DAL,1999,8,8,0,16,0.5,-1.6,2025-08-16 09:41:02
DAL,2000,5,11,0,16,0.3125,-0.4,2025-08-16 09:41:02
DAL,2001,5,11,0,16,0.3125,-0.2,2025-08-16 09:41:02
DAL,2002,5,11,0,16,0.3125,-1.5,2025-08-16 09:41:02
DAL,2003,10,6,0,16,0.625,-2.3,2025-08-16 09:41:02
DAL,2004,6,10,0,16,0.375,-0.8,2025-08-16 09:41:02
DAL,2005,9,7,0,16,0.5625,2.1,2025-08-16 09:41:02
DAL,2006,9,7,0,16,0.5625,-1.0,2025-08-16 09:41:02
DAL,2007,13,3,0,16,0.8125,1.3,2025-08-16 09:41:02
DAL,2008,9,7,0,16,0.5625,0.8,2025-08-16 09:41:02
DAL,2009,11,5,0,16,0.6875,0.2,2025-08-16 09:41:02
DAL,2010,6,10,0,16,0.375,0.5,2025-08-16 09:41:02
DAL,2011,8,8,0,16,0.5,0.3,2025-08-16 09:41:02
DAL,2012,8,8,0,16,0.5,1.8,2025-08-16 09:41:02
DAL,2013,8,8,0,16,0.5,-1.1,2025-08-16 09:41:02
DAL,2014,12,4,0,16,0.75,-1.8,2025-08-16 09:41:02
DAL,2015,4,12,0,16,0.25,-0.7,2025-08-16 09:41:02
DAL,2016,13,3,0,16,0.8125,-0.2,2025-08-16 09:41:02
DAL,2017,9,7,0,16,0.5625,0.2,2025-08-16 09:41:02
DAL,2018,10,6,0,16,0.625,0.2,2025-08-16 09:41:02
DAL,2019,8,8,0,16,0.5,-1.8,2025-08-16 09:41:02
DAL,2020,6,10,0,16,0.375,-0.2,2025-08-16 09:41:02
DAL,2021,12,5,0,17,0.7059,-0.2,2025-08-16 09:41:02
DAL,2022,12,5,0,17,0.7059,-0.8,2025-08-16 09:41:02
DAL,2023,12,5,0,17,0.7059,-2.2,2025-08-16 09:41:02
DAL,2024,7,10,0,17,0.4118,0.6,2025-08-16 09:41:02
DAY,1920,5,2,2,9,0.6667,-0.5,2025-08-16 09:41:02
DAY,1921,4,4,1,9,0.5,2.5,2025-08-16 09:41:02
DAY,1922,4,3,1,8,0.5625,1.2,2025-08-16 09:41:02
DAY,1923,1,6,1,8,0.1875,8.3,2025-08-16 09:41:02
DAY,1924,2,6,0,8,0.25,5.2,2025-08-16 09:41:02
DAY,1925,0,7,1,8,0.0625,8.9,2025-08-16 09:41:02
DAY,1926,1,4,1,6,0.25,3.8,2025-08-16 09:41:02
DAY,1927,1,6,1,8,0.1875,3.8,2025-08-16 09:41:02
DAY,1928,0,7,0,7,0.0,7.0,2025-08-16 09:41:02
DAY,1929,0,6,0,6,0.0,5.3,2025-08-16 09:41:02
DEN,1960,4,9,1,14,0.3214,0.8,2025-08-16 09:41:02
DEN,1961,3,11,0,14,0.2143,1.6,2025-08-16 09:41:02
DEN,1962,7,7,0,14,0.5,-0.2,2025-08-16 09:41:02
DEN,1963,2,11,1,14,0.1786,1.5,2025-08-16 09:41:02
DEN,1964,2,11,1,14,0.1786,1.8,2025-08-16 09:41:02
DEN,1965,4,10,0,14,0.2857,0.8,2025-08-16 09:41:02
DEN,1966,4,10,0,14,0.2857,1.2,2025-08-16 09:41:02
DEN,1967,3,11,0,14,0.2143,2.5,2025-08-16 09:41:02
DEN,1968,5,9,0,14,0.3571,1.7,2025-08-16 09:41:02
DEN,1969,5,8,1,14,0.3929,1.4,2025-08-16 09:41:02
DEN,1970,5,8,1,14,0.3929,-1.8,2025-08-16 09:41:02
DEN,1971,4,9,1,14,0.3214,0.6,2025-08-16 09:41:02
DEN,1972,5,9,0,14,0.3571,-0.1,2025-08-16 09:41:02
DEN,1973,7,5,2,14,0.5714,-1.2,2025-08-16 09:41:02
DEN,1974,7,6,1,14,0.5357,0.1,2025-08-16 09:41:02
DEN,1975,6,8,0,14,0.4286,0.3,2025-08-16 09:41:02
DEN,1976,9,5,0,14,0.6429,-0.8,2025-08-16 09:41:02
DEN,1977,12,2,0,14,0.8571,2.3,2025-08-16 09:41:02
DEN,1978,10,6,0,16,0.625,-0.2,2025-08-16 09:41:02
DEN,1979,10,6,0,16,0.625,2.4,2025-08-16 09:41:02
DEN,1980,8,8,0,16,0.5,1.3,2025-08-16 09:41:02
DEN,1981,10,6,0,16,0.625,-0.7,2025-08-16 09:41:02
DEN,1982,2,7,0,9,0.2222,-1.1,2025-08-16 09:41:02
DEN,1983,9,7,0,16,0.5625,-1.2,2025-08-16 09:41:02
DEN,1984,13,3,0,16,0.8125,0.7,2025-08-16 09:41:02
DEN,1985,11,5,0,16,0.6875,0.4,2025-08-16 09:41:02
DEN,1986,11,5,0,16,0.6875,2.0,2025-08-16 09:41:02
DEN,1987,10,4,1,15,0.7,-1.9,2025-08-16 09:41:02
DEN,1988,8,8,0,16,0.5,-1.8,2025-08-16 09:41:02
DEN,1989,11,5,0,16,0.6875,0.8,2025-08-16 09:41:02
DEN,1990,5,11,0,16,0.3125,1.9,2025-08-16 09:41:02
DEN,1991,12,4,0,16,0.75,-0.9,2025-08-16 09:41:02
DEN,1992,8,8,0,16,0.5,0.8,2025-08-16 09:41:02
DEN,1993,9,7,0,16,0.5625,-0.5,2025-08-16 09:41:02
DEN,1994,7,9,0,16,0.4375,-0.3,2025-08-16 09:41:02
DEN,1995,8,8,0,16,0.5,0.4,2025-08-16 09:41:02
DEN,1996,13,3,0,16,0.8125,0.3,2025-08-16 09:41:02
DEN,1997,12,4,0,16,0.75,-0.9,2025-08-16 09:41:02
DEN,1998,14,2,0,16,0.875,-3.1,2025-08-16 09:41:02
DEN,1999,6,10,0,16,0.375,3.6,2025-08-16 09:41:02
DEN,2000,11,5,0,16,0.6875,-2.2,2025-08-16 09:41:02
DEN,2001,8,8,0,16,0.5,-0.5,2025-08-16 09:41:02
DEN,2002,9,7,0,16,0.5625,1.9,2025-08-16 09:41:02
DEN,2003,10,6,0,16,0.625,0.5,2025-08-16 09:41:02
DEN,2004,10,6,0,16,0.625,1.0,2025-08-16 09:41:02
DEN,2005,13,3,0,16,0.8125,2.2,2025-08-16 09:41:02
DEN,2006,9,7,0,16,0.5625,0.4,2025-08-16 09:41:02
DEN,2007,7,9,0,16,0.4375,1.6,2025-08-16 09:41:02
DEN,2008,8,8,0,16,0.5,-0.9,2025-08-16 09:41:02
DEN,2009,8,8,0,16,0.5,0.2,2025-08-16 09:41:02
DEN,2010,4,12,0,16,0.25,-1.0,2025-08-16 09:41:02
DEN,2011,8,8,0,16,0.5,-0.2,2025-08-16 09:41:02
DEN,2012,13,3,0,16,0.8125,-1.9,2025-08-16 09:41:02
DEN,2013,13,3,0,16,0.8125,-1.6,2025-08-16 09:41:02
DEN,2014,12,4,0,16,0.75,1.6,2025-08-16 09:41:02
DEN,2015,12,4,0,16,0.75,2.1,2025-08-16 09:41:02
DEN,2016,9,7,0,16,0.5625,1.8,2025-08-16 09:41:02
DEN,2017,5,11,0,16,0.3125,-0.9,2025-08-16 09:41:02
DEN,2018,6,10,0,16,0.375,0.7,2025-08-16 09:41:02
DEN,2019,7,9,0,16,0.4375,0.0,2025-08-16 09:41:02
DEN,2020,5,11,0,16,0.3125,1.7,2025-08-16 09:41:02
DEN,2021,7,10,0,17,0.4118,-1.3,2025-08-16 09:41:02
DEN,2022,5,12,0,17,0.2941,-0.7,2025-08-16 09:41:02
DEN,2023,8,9,0,17,0.4706,-0.5,2025-08-16 09:41:02
DEN,2024,10,7,0,17,0.5882,-0.3,2025-08-16 09:41:02
DET,1930,5,6,3,14,0.4643,-0.7,2025-08-16 09:41:02
DET,1931,11,3,0,14,0.7857,-2.9,2025-08-16 09:41:02
DET,1932,6,2,4,12,0.6667,0.9,2025-08-16 09:41:02
DET,1933,6,5,0,11,0.5455,1.4,2025-08-16 09:41:02
DET,1934,10,3,0,13,0.7692,-1.5,2025-08-16 09:41:02
DET,1935,7,3,2,12,0.6667,1.1,2025-08-16 09:41:02
DET,1936,8,4,0,12,0.6667,-0.1,2025-08-16 09:41:02
DET,1937,7,4,0,11,0.6364,0.9,2025-08-16 09:41:02
DET,1938,7,4,0,11,0.6364,-0.8,2025-08-16 09:41:02
DET,1939,6,5,0,11,0.5455,2.3,2025-08-16 09:41:02
DET,1940,5,5,1,11,0.5,0.6,2025-08-16 09:41:02
DET,1941,4,6,1,11,0.4091,4.1,2025-08-16 09:41:02
DET,1942,0,11,0,11,0.0,2.8,2025-08-16 09:41:02
DET,1943,3,6,1,10,0.35,1.4,2025-08-16 09:41:02
DET,1944,6,3,1,10,0.65,-3.1,2025-08-16 09:41:02
DET,1945,7,3,0,10,0.7,0.6,2025-08-16 09:41:02
DET,1946,1,10,0,11,0.0909,1.7,2025-08-16 09:41:02
DET,1947,3,9,0,12,0.25,2.8,2025-08-16 09:41:02
DET,1948,2,10,0,12,0.1667,3.9,2025-08-16 09:41:02
DET,1949,4,8,0,12,0.3333,1.2,2025-08-16 09:41:02
DET,1950,6,6,0,12,0.5,-4.6,2025-08-16 09:41:02
DET,1951,7,4,1,12,0.625,-2.1,2025-08-16 09:41:02
DET,1952,9,3,0,12,0.75,-1.4,2025-08-16 09:41:02
DET,1953,10,2,0,12,0.8333,-2.1,2025-08-16 09:41:02
DET,1954,9,2,1,12,0.7917,2.5,2025-08-16 09:41:02
DET,1955,3,9,0,12,0.25,-2.8,2025-08-16 09:41:02
DET,1956,9,3,0,12,0.75,-0.7,2025-08-16 09:41:02
DET,1957,8,4,0,12,0.6667,0.4,2025-08-16 09:41:02
DET,1958,4,7,1,12,0.375,2.3,2025-08-16 09:41:02
DET,1959,3,8,1,12,0.2917,2.3,2025-08-16 09:41:02
DET,1960,7,5,0,12,0.5833,-1.1,2025-08-16 09:41:02
DET,1961,8,5,1,14,0.6071,2.5,2025-08-16 09:41:02
DET,1962,11,3,0,14,0.7857,2.5,2025-08-16 09:41:02
DET,1963,5,8,1,14,0.3929,-0.6,2025-08-16 09:41:02
DET,1964,7,5,2,14,0.5714,2.7,2025-08-16 09:41:02
DET,1965,6,7,1,14,0.4643,6.7,2025-08-16 09:41:02
DET,1966,4,9,1,14,0.3214,3.0,2025-08-16 09:41:02
DET,1967,5,7,2,14,0.4286,1.7,2025-08-16 09:41:02
DET,1968,4,8,2,14,0.3571,0.5,2025-08-16 09:41:02
DET,1969,9,4,1,14,0.6786,1.6,2025-08-16 09:41:02
DET,1970,10,4,0,14,0.7143,3.7,2025-08-16 09:41:02
DET,1971,7,6,1,14,0.5357,0.2,2025-08-16 09:41:02
DET,1972,8,5,1,14,0.6071,0.9,2025-08-16 09:41:02
DET,1973,6,7,1,14,0.4643,0.3,2025-08-16 09:41:02
DET,1974,7,7,0,14,0.5,-0.6,2025-08-16 09:41:02
DET,1975,7,7,0,14,0.5,-0.7,2025-08-16 09:41:02
DET,1976,6,8,0,14,0.4286,-0.2,2025-08-16 09:41:02
DET,1977,6,8,0,14,0.4286,-2.5,2025-08-16 09:41:02
DET,1978,7,9,0,16,0.4375,-1.2,2025-08-16 09:41:02
DET,1979,2,14,0,16,0.125,-1.9,2025-08-16 09:41:02
DET,1980,9,7,0,16,0.5625,-2.2,2025-08-16 09:41:02
DET,1981,8,8,0,16,0.5,0.6,2025-08-16 09:41:02
DET,1982,4,5,0,9,0.4444,0.8,2025-08-16 09:41:02
DET,1983,9,7,0,16,0.5625,-1.7,2025-08-16 09:41:02
DET,1984,4,11,1,16,0.2812,1.6,2025-08-16 09:41:02
DET,1985,7,9,0,16,0.4375,2.0,2025-08-16 09:41:02
DET,1986,5,11,0,16,0.3125,-1.2,2025-08-16 09:41:02
DET,1987,4,11,0,15,0.2667,-2.2,2025-08-16 09:41:02
DET,1988,4,12,0,16,0.25,1.8,2025-08-16 09:41:02
DET,1989,7,9,0,16,0.4375,-0.2,2025-08-16 09:41:02
DET,1990,6,10,0,16,0.375,0.9,2025-08-16 09:41:02
DET,1991,12,4,0,16,0.75,-1.8,2025-08-16 09:41:02
DET,1992,5,11,0,16,0.3125,1.8,2025-08-16 09:41:02
DET,1993,10,6,0,16,0.625,-0.7,2025-08-16 09:41:02
DET,1994,9,7,0,16,0.5625,1.4,2025-08-16 09:41:02
DET,1995,10,6,0,16,0.625,0.6,2025-08-16 09:41:02
DET,1996,5,11,0,16,0.3125,1.2,2025-08-16 09:41:02
DET,1997,9,7,0,16,0.5625,-0.6,2025-08-16 09:41:02
DET,1998,5,11,0,16,0.3125,1.1,2025-08-16 09:41:02
DET,1999,8,8,0,16,0.5,2.0,2025-08-16 09:41:02
DET,2000,9,7,0,16,0.5625,1.4,2025-08-16 09:41:02
DET,2001,2,14,0,16,0.125,2.4,2025-08-16 09:41:02
DET,2002,3,13,0,16,0.1875,-0.1,2025-08-16 09:41:02
DET,2003,5,11,0,16,0.3125,1.0,2025-08-16 09:41:02
DET,2004,6,10,0,16,0.375,-1.8,2025-08-16 09:41:02
DET,2005,5,11,0,16,0.3125,-1.0,2025-08-16 09:41:02
DET,2006,3,13,0,16,0.1875,-0.5,2025-08-16 09:41:02
DET,2007,7,9,0,16,0.4375,2.6,2025-08-16 09:41:02
DET,2008,0,16,0,16,0.0,2.5,2025-08-16 09:41:02
DET,2009,2,14,0,16,0.125,0.1,2025-08-16 09:41:02
DET,2010,6,10,0,16,0.375,2.3,2025-08-16 09:41:02
DET,2011,10,6,0,16,0.625,0.6,2025-08-16 09:41:02
DET,2012,4,12,0,16,0.25,1.8,2025-08-16 09:41:02
DET,2013,7,9,0,16,0.4375,-2.8,2025-08-16 09:41:02
DET,2014,11,5,0,16,0.6875,-0.4,2025-08-16 09:41:02
DET,2015,7,9,0,16,0.4375,2.4,2025-08-16 09:41:02
DET,2016,9,7,0,16,0.5625,-0.6,2025-08-16 09:41:02
DET,2017,9,7,0,16,0.5625,0.6,2025-08-16 09:41:02
DET,2018,6,10,0,16,0.375,-0.8,2025-08-16 09:41:02
DET,2019,3,12,1,16,0.2188,-0.1,2025-08-16 09:41:02
DET,2020,5,11,0,16,0.3125,1.2,2025-08-16 09:41:02
DET,2021,3,13,1,17,0.2059,0.6,2025-08-16 09:41:02
DET,2022,9,8,0,17,0.5294,0.7,2025-08-16 09:41:02
DET,2023,12,5,0,17,0.7059,0.4,2025-08-16 09:41:02
DET,2024,15,2,0,17,0.8824,0.7,2025-08-16 09:41:02
DHR,1920,2,3,3,8,0.4375,-0.8,2025-08-16 09:41:02
DPN,1925,8,2,2,12,0.75,-8.4,2025-08-16 09:41:02
DPN,1926,4,6,2,12,0.4167,-2.6,2025-08-16 09:41:02
DTI,1921,1,5,1,7,0.2143,8.6,2025-08-16 09:41:02
DTX,1952,1,11,0,12,0.0833,2.4,2025-08-16 09:41:02
DUL,1923,4,3,0,7,0.5714,1.8,2025-08-16 09:41:02
DUL,1924,5,1,0,6,0.8333,2.1,2025-08-16 09:41:02
DUL,1925,0,3,0,3,0.0,-0.1,2025-08-16 09:41:02
DUL,1926,6,5,3,14,0.5357,4.1,2025-08-16 09:41:02
DUL,1927,1,8,0,9,0.1111,6.9,2025-08-16 09:41:02
DWL,1928,7,2,1,10,0.75,1.3,2025-08-16 09:41:02
ECG,1921,3,2,0,5,0.6,-20.9,2025-08-16 09:41:02
ECG,1922,0,3,0,3,0.0,2.1,2025-08-16 09:41:02
FYJ,1924,11,2,1,14,0.8214,-8.4,2025-08-16 09:41:02
FYJ,1925,13,7,0,20,0.65,-1.0,2025-08-16 09:41:02
FYJ,1926,14,1,2,17,0.8824,-3.5,2025-08-16 09:41:02
FYJ,1927,6,9,3,18,0.4167,-2.4,2025-08-16 09:41:02
FYJ,1928,11,3,2,16,0.75,-2.5,2025-08-16 09:41:02
FYJ,1929,10,4,5,19,0.6579,-0.1,2025-08-16 09:41:02
FYJ,1930,4,13,1,18,0.25,1.0,2025-08-16 09:41:02
FYJ,1931,1,6,1,8,0.1875,2.0,2025-08-16 09:41:02
GNB,1921,3,2,1,6,0.5833,-2.4,2025-08-16 09:41:02
GNB,1922,4,3,3,10,0.55,-0.5,2025-08-16 09:41:02
GNB,1923,7,2,1,10,0.75,-2.1,2025-08-16 09:41:02
GNB,1924,7,4,0,11,0.6364,2.8,2025-08-16 09:41:02
GNB,1925,8,5,0,13,0.6154,-1.8,2025-08-16 09:41:02
GNB,1926,7,3,3,13,0.6538,-0.3,2025-08-16 09:41:02
GNB,1927,7,2,1,10,0.75,-1.9,2025-08-16 09:41:02
GNB,1928,6,4,3,13,0.5769,-2.0,2025-08-16 09:41:02
GNB,1929,12,0,1,13,0.9615,-1.3,2025-08-16 09:41:02
GNB,1930,10,3,1,14,0.75,0.8,2025-08-16 09:41:02
GNB,1931,12,2,0,14,0.8571,-2.0,2025-08-16 09:41:02
GNB,1932,10,3,1,14,0.75,-0.1,2025-08-16 09:41:02
GNB,1933,5,7,1,13,0.4231,1.7,2025-08-16 09:41:02
GNB,1934,7,6,0,13,0.5385,2.2,2025-08-16 09:41:02
GNB,1935,8,4,0,12,0.6667,1.8,2025-08-16 09:41:02
GNB,1936,10,1,1,12,0.875,1.7,2025-08-16 09:41:02
GNB,1937,7,4,0,11,0.6364,1.0,2025-08-16 09:41:02
GNB,1938,8,3,0,11,0.7273,-1.1,2025-08-16 09:41:02
GNB,1939,9,2,0,11,0.8182,0.2,2025-08-16 09:41:02
GNB,1940,6,4,1,11,0.5909,-1.4,2025-08-16 09:41:02
GNB,1941,10,1,0,11,0.9091,-0.1,2025-08-16 09:41:02
GNB,1942,8,2,1,11,0.7727,-1.5,2025-08-16 09:41:02
GNB,1943,7,2,1,10,0.75,-0.4,2025-08-16 09:41:02
GNB,1944,8,2,0,10,0.8,-1.5,2025-08-16 09:41:02
GNB,1945,6,4,0,10,0.6,-0.6,2025-08-16 09:41:02
GNB,1946,6,5,0,11,0.5455,0.3,2025-08-16 09:41:02
GNB,1947,6,5,1,12,0.5417,2.0,2025-08-16 09:41:02
GNB,1948,3,9,0,12,0.25,1.5,2025-08-16 09:41:02
GNB,1949,2,10,0,12,0.1667,1.8,2025-08-16 09:41:02
GNB,1950,3,9,0,12,0.25,-2.8,2025-08-16 09:41:02
GNB,1951,3,9,0,12,0.25,0.0,2025-08-16 09:41:02
GNB,1952,6,6,0,12,0.5,-0.9,2025-08-16 09:41:02
GNB,1953,2,9,1,12,0.2083,1.7,2025-08-16 09:41:02
GNB,1954,4,8,0,12,0.3333,3.3,2025-08-16 09:41:02
GNB,1955,6,6,0,12,0.5,-2.3,2025-08-16 09:41:02
GNB,1956,4,8,0,12,0.3333,2.1,2025-08-16 09:41:02
GNB,1957,3,9,0,12,0.25,1.6,2025-08-16 09:41:02
GNB,1958,1,10,1,12,0.125,2.8,2025-08-16 09:41:02
GNB,1959,7,5,0,12,0.5833,1.4,2025-08-16 09:41:02
GNB,1960,8,4,0,12,0.6667,-2.8,2025-08-16 09:41:02
GNB,1961,11,3,0,14,0.7857,1.6,2025-08-16 09:41:02
GNB,1962,13,1,0,14,0.9286,0.6,2025-08-16 09:41:02
GNB,1963,11,2,1,14,0.8214,-1.1,2025-08-16 09:41:02
GNB,1964,8,5,1,14,0.6071,2.4,2025-08-16 09:41:02
GNB,1965,10,3,1,14,0.75,5.1,2025-08-16 09:41:02
GNB,1966,12,2,0,14,0.8571,1.2,2025-08-16 09:41:02
GNB,1967,9,4,1,14,0.6786,0.6,2025-08-16 09:41:02
GNB,1968,6,7,1,14,0.4643,-0.3,2025-08-16 09:41:02
GNB,1969,8,6,0,14,0.5714,1.8,2025-08-16 09:41:02
GNB,1970,6,8,0,14,0.4286,5.1,2025-08-16 09:41:02
GNB,1971,4,8,2,14,0.3571,0.7,2025-08-16 09:41:02
GNB,1972,10,4,0,14,0.7143,1.5,2025-08-16 09:41:02
GNB,1973,5,7,2,14,0.4286,-0.8,2025-08-16 09:41:02
GNB,1974,6,8,0,14,0.4286,-1.6,2025-08-16 09:41:02
GNB,1975,4,10,0,14,0.2857,0.0,2025-08-16 09:41:02
GNB,1976,5,9,0,14,0.3571,1.3,2025-08-16 09:41:02
GNB,1977,4,10,0,14,0.2857,-2.6,2025-08-16 09:41:02
GNB,1978,8,7,1,16,0.5312,0.7,2025-08-16 09:41:02
GNB,1979,5,11,0,16,0.3125,-2.5,2025-08-16 09:41:02
GNB,1980,5,10,1,16,0.3438,-0.3,2025-08-16 09:41:02
GNB,1981,8,8,0,16,0.5,0.6,2025-08-16 09:41:02
GNB,1982,5,3,1,9,0.6111,-0.2,2025-08-16 09:41:02
GNB,1983,8,8,0,16,0.5,-1.2,2025-08-16 09:41:02
GNB,1984,8,8,0,16,0.5,-0.1,2025-08-16 09:41:02
GNB,1985,8,8,0,16,0.5,1.3,2025-08-16 09:41:02
GNB,1986,4,12,0,16,0.25,0.7,2025-08-16 09:41:02
GNB,1987,5,9,1,15,0.3667,-0.4,2025-08-16 09:41:02
GNB,1988,4,12,0,16,0.25,1.4,2025-08-16 09:41:02
GNB,1989,10,6,0,16,0.625,-1.3,2025-08-16 09:41:02
GNB,1990,6,10,0,16,0.375,0.6,2025-08-16 09:41:02
GNB,1991,4,12,0,16,0.25,-2.3,2025-08-16 09:41:02
GNB,1992,9,7,0,16,0.5625,-0.3,2025-08-16 09:41:02
GNB,1993,9,7,0,16,0.5625,-0.4,2025-08-16 09:41:02
GNB,1994,9,7,0,16,0.5625,0.1,2025-08-16 09:41:02
GNB,1995,11,5,0,16,0.6875,0.4,2025-08-16 09:41:02
GNB,1996,13,3,0,16,0.8125,-0.1,2025-08-16 09:41:02
GNB,1997,13,3,0,16,0.8125,-1.1,2025-08-16 09:41:02
GNB,1998,11,5,0,16,0.6875,-0.6,2025-08-16 09:41:02
GNB,1999,8,8,0,16,0.5,0.6,2025-08-16 09:41:02
GNB,2000,9,7,0,16,0.5625,0.6,2025-08-16 09:41:02
GNB,2001,12,4,0,16,0.75,-1.1,2025-08-16 09:41:02
GNB,2002,12,4,0,16,0.75,-0.8,2025-08-16 09:41:02
GNB,2003,10,6,0,16,0.625,-0.3,2025-08-16 09:41:02
GNB,2004,10,6,0,16,0.625,-2.4,2025-08-16 09:41:02
GNB,2005,4,12,0,16,0.25,-0.8,2025-08-16 09:41:02
GNB,2006,8,8,0,16,0.5,-0.4,2025-08-16 09:41:02
GNB,2007,13,3,0,16,0.8125,0.0,2025-08-16 09:41:02
GNB,2008,6,10,0,16,0.375,0.5,2025-08-16 09:41:02
GNB,2009,11,5,0,16,0.6875,-2.9,2025-08-16 09:41:02
GNB,2010,10,6,0,16,0.625,1.7,2025-08-16 09:41:02
GNB,2011,15,1,0,16,0.9375,-1.2,2025-08-16 09:41:02
GNB,2012,11,5,0,16,0.6875,1.2,2025-08-16 09:41:02
GNB,2013,8,7,1,16,0.5312,-2.4,2025-08-16 09:41:02
GNB,2014,12,4,0,16,0.75,-0.3,2025-08-16 09:41:02
GNB,2015,10,6,0,16,0.625,2.5,2025-08-16 09:41:02
GNB,2016,10,6,0,16,0.625,0.1,2025-08-16 09:41:02
GNB,2017,7,9,0,16,0.4375,2.1,2025-08-16 09:41:02
GNB,2018,6,9,1,16,0.4062,-1.2,2025-08-16 09:41:02
GNB,2019,13,3,0,16,0.8125,-0.7,2025-08-16 09:41:02
GNB,2020,13,3,0,16,0.8125,-1.1,2025-08-16 09:41:02
GNB,2021,13,4,0,17,0.7647,-0.2,2025-08-16 09:41:02
GNB,2022,8,9,0,17,0.4706,0.4,2025-08-16 09:41:02
GNB,2023,9,8,0,17,0.5294,-0.8,2025-08-16 09:41:02
GNB,2024,11,6,0,17,0.6471,0.9,2025-08-16 09:41:02
GUN,1934,1,2,0,3,0.3333,0.0,2025-08-16 09:41:02
HAM,1920,2,5,0,7,0.2857,1.8,2025-08-16 09:41:02
HAM,1921,1,3,1,5,0.3,9.8,2025-08-16 09:41:02
HAM,1922,0,5,1,6,0.0833,11.4,2025-08-16 09:41:02
HAM,1923,1,5,1,7,0.2143,8.0,2025-08-16 09:41:02
HAM,1924,2,2,1,5,0.5,7.8,2025-08-16 09:41:02
HAM,1925,1,4,0,5,0.2,9.6,2025-08-16 09:41:02
HAM,1926,0,4,0,4,0.0,-1.1,2025-08-16 09:41:02
HRT,1926,3,7,0,10,0.3,-3.6,2025-08-16 09:41:02
HTX,2002,4,12,0,16,0.25,-0.5,2025-08-16 09:41:02
HTX,2003,5,11,0,16,0.3125,1.9,2025-08-16 09:41:02
HTX,2004,7,9,0,16,0.4375,1.2,2025-08-16 09:41:02
HTX,2005,2,14,0,16,0.125,0.7,2025-08-16 09:41:02
HTX,2006,6,10,0,16,0.375,1.7,2025-08-16 09:41:02
HTX,2007,8,8,0,16,0.5,0.3,2025-08-16 09:41:02
HTX,2008,8,8,0,16,0.5,1.4,2025-08-16 09:41:02
HTX,2009,9,7,0,16,0.5625,-1.5,2025-08-16 09:41:02
HTX,2010,6,10,0,16,0.375,0.5,2025-08-16 09:41:02
HTX,2011,10,6,0,16,0.625,-1.9,2025-08-16 09:41:02
HTX,2012,12,4,0,16,0.75,-1.8,2025-08-16 09:41:02
HTX,2013,2,14,0,16,0.125,1.9,2025-08-16 09:41:02
HTX,2014,9,7,0,16,0.5625,-2.3,2025-08-16 09:41:02
HTX,2015,9,7,0,16,0.5625,-2.4,2025-08-16 09:41:02
HTX,2016,9,7,0,16,0.5625,0.4,2025-08-16 09:41:02
HTX,2017,4,12,0,16,0.25,-0.3,2025-08-16 09:41:02
HTX,2018,11,5,0,16,0.6875,-1.5,2025-08-16 09:41:02
HTX,2019,10,6,0,16,0.625,1.0,2025-08-16 09:41:02
HTX,2020,4,12,0,16,0.25,-0.5,2025-08-16 09:41:02
HTX,2021,4,13,0,17,0.2353,0.4,2025-08-16 09:41:02
HTX,2022,3,13,1,17,0.2059,-0.8,2025-08-16 09:41:02
HTX,2023,10,7,0,17,0.5882,-1.0,2025-08-16 09:41:02
HTX,2024,10,7,0,17,0.5882,-0.7,2025-08-16 09:41:02
JAX,1995,4,12,0,16,0.25,0.0,2025-08-16 09:41:02
JAX,1996,9,7,0,16,0.5625,-0.9,2025-08-16 09:41:02
JAX,1997,11,5,0,16,0.6875,0.7,2025-08-16 09:41:02
JAX,1998,11,5,0,16,0.6875,-0.9,2025-08-16 09:41:02
JAX,1999,14,2,0,16,0.875,-4.8,2025-08-16 09:41:02
JAX,2000,7,9,0,16,0.4375,-1.4,2025-08-16 09:41:02
JAX,2001,6,10,0,16,0.375,0.4,2025-08-16 09:41:02
JAX,2002,6,10,0,16,0.375,-1.0,2025-08-16 09:41:02
JAX,2003,5,11,0,16,0.3125,1.0,2025-08-16 09:41:02
JAX,2004,9,7,0,16,0.5625,1.9,2025-08-16 09:41:02
JAX,2005,12,4,0,16,0.75,-1.0,2025-08-16 09:41:02
JAX,2006,8,8,0,16,0.5,1.4,2025-08-16 09:41:02
JAX,2007,11,5,0,16,0.6875,0.1,2025-08-16 09:41:02
JAX,2008,5,11,0,16,0.3125,1.6,2025-08-16 09:41:02
JAX,2009,7,9,0,16,0.4375,-0.9,2025-08-16 09:41:02
JAX,2010,8,8,0,16,0.5,-0.4,2025-08-16 09:41:02
JAX,2011,5,11,0,16,0.3125,-0.3,2025-08-16 09:41:02
JAX,2012,2,14,0,16,0.125,-1.1,2025-08-16 09:41:02
JAX,2013,4,12,0,16,0.25,1.5,2025-08-16 09:41:02
JAX,2014,3,13,0,16,0.1875,-0.3,2025-08-16 09:41:02
JAX,2015,5,11,0,16,0.3125,-3.0,2025-08-16 09:41:02
JAX,2016,3,13,0,16,0.1875,0.2,2025-08-16 09:41:02
JAX,2017,10,6,0,16,0.625,-2.8,2025-08-16 09:41:02
JAX,2018,5,11,0,16,0.3125,0.4,2025-08-16 09:41:02
JAX,2019,6,10,0,16,0.375,-0.6,2025-08-16 09:41:02
JAX,2020,1,15,0,16,0.0625,-0.1,2025-08-16 09:41:02
JAX,2021,3,14,0,17,0.1765,0.6,2025-08-16 09:41:02
JAX,2022,9,8,0,17,0.5294,-1.4,2025-08-16 09:41:02
JAX,2023,9,8,0,17,0.5294,1.1,2025-08-16 09:41:02
JAX,2024,4,13,0,17,0.2353,-0.8,2025-08-16 09:41:02
KAN,1960,8,6,0,14,0.5714,-1.0,2025-08-16 09:41:02
KAN,1961,6,8,0,14,0.4286,0.1,2025-08-16 09:41:02
KAN,1962,11,3,0,14,0.7857,-1.4,2025-08-16 09:41:02
KAN,1963,5,7,2,14,0.4286,-0.8,2025-08-16 09:41:02
KAN,1964,7,7,0,14,0.5,-0.5,2025-08-16 09:41:02
KAN,1965,7,5,2,14,0.5714,-0.3,2025-08-16 09:41:02
KAN,1966,11,2,1,14,0.8214,-1.3,2025-08-16 09:41:02
KAN,1967,9,5,0,14,0.6429,-0.7,2025-08-16 09:41:02
KAN,1968,12,2,0,14,0.8571,-0.4,2025-08-16 09:41:02
KAN,1969,11,3,0,14,0.7857,-1.1,2025-08-16 09:41:02
KAN,1970,7,5,2,14,0.5714,-0.5,2025-08-16 09:41:02
KAN,1971,10,3,1,14,0.75,-1.7,2025-08-16 09:41:02
KAN,1972,8,6,0,14,0.5714,0.2,2025-08-16 09:41:02
KAN,1973,7,5,2,14,0.5714,-1.8,2025-08-16 09:41:02
KAN,1974,5,9,0,14,0.3571,1.9,2025-08-16 09:41:02
KAN,1975,5,9,0,14,0.3571,0.0,2025-08-16 09:41:02
KAN,1976,5,9,0,14,0.3571,1.4,2025-08-16 09:41:02
KAN,1977,2,12,0,14,0.1429,3.9,2025-08-16 09:41:02
KAN,1978,4,12,0,16,0.25,0.9,2025-08-16 09:41:02
KAN,1979,7,9,0,16,0.4375,2.9,2025-08-16 09:41:02
KAN,1980,8,8,0,16,0.5,0.6,2025-08-16 09:41:02
KAN,1981,9,7,0,16,0.5625,-0.1,2025-08-16 09:41:02
KAN,1982,3,6,0,9,0.3333,0.7,2025-08-16 09:41:02
KAN,1983,6,10,0,16,0.375,0.9,2025-08-16 09:41:02
KAN,1984,8,8,0,16,0.5,1.5,2025-08-16 09:41:02
KAN,1985,6,10,0,16,0.375,1.1,2025-08-16 09:41:02
KAN,1986,10,6,0,16,0.625,-1.0,2025-08-16 09:41:02
KAN,1987,4,11,0,15,0.2667,-0.3,2025-08-16 09:41:02
KAN,1988,4,11,1,16,0.2812,-1.6,2025-08-16 09:41:02
KAN,1989,8,7,1,16,0.5312,0.0,2025-08-16 09:41:02
KAN,1990,11,5,0,16,0.6875,-0.3,2025-08-16 09:41:02
KAN,1991,10,6,0,16,0.625,2.0,2025-08-16 09:41:02
KAN,1992,10,6,0,16,0.625,-0.7,2025-08-16 09:41:02
KAN,1993,11,5,0,16,0.6875,0.6,2025-08-16 09:41:02
KAN,1994,9,7,0,16,0.5625,-0.4,2025-08-16 09:41:02
KAN,1995,13,3,0,16,0.8125,0.3,2025-08-16 09:41:02
KAN,1996,9,7,0,16,0.5625,2.0,2025-08-16 09:41:02
KAN,1997,13,3,0,16,0.8125,-0.5,2025-08-16 09:41:02
KAN,1998,7,9,0,16,0.4375,-0.8,2025-08-16 09:41:02
KAN,1999,9,7,0,16,0.5625,2.6,2025-08-16 09:41:02
KAN,2000,7,9,0,16,0.4375,0.6,2025-08-16 09:41:02
KAN,2001,6,10,0,16,0.375,0.3,2025-08-16 09:41:02
KAN,2002,8,8,0,16,0.5,1.9,2025-08-16 09:41:02
KAN,2003,13,3,0,16,0.8125,-1.2,2025-08-16 09:41:02
KAN,2004,7,9,0,16,0.4375,2.3,2025-08-16 09:41:02
KAN,2005,10,6,0,16,0.625,2.1,2025-08-16 09:41:02
KAN,2006,9,7,0,16,0.5625,0.0,2025-08-16 09:41:02
KAN,2007,4,12,0,16,0.25,1.4,2025-08-16 09:41:02
KAN,2008,2,14,0,16,0.125,0.1,2025-08-16 09:41:02
KAN,2009,4,12,0,16,0.25,-0.3,2025-08-16 09:41:02
KAN,2010,10,6,0,16,0.625,-3.2,2025-08-16 09:41:02
KAN,2011,7,9,0,16,0.4375,-0.2,2025-08-16 09:41:02
KAN,2012,2,14,0,16,0.125,-0.6,2025-08-16 09:41:02
KAN,2013,11,5,0,16,0.6875,-1.7,2025-08-16 09:41:02
KAN,2014,9,7,0,16,0.5625,1.2,2025-08-16 09:41:02
KAN,2015,11,5,0,16,0.6875,1.6,2025-08-16 09:41:02
KAN,2016,12,4,0,16,0.75,0.7,2025-08-16 09:41:02
KAN,2017,10,6,0,16,0.625,-1.3,2025-08-16 09:41:02
KAN,2018,12,4,0,16,0.75,-0.1,2025-08-16 09:41:02
KAN,2019,12,4,0,16,0.75,0.2,2025-08-16 09:41:02
KAN,2020,14,2,0,16,0.875,-0.1,2025-08-16 09:41:02
KAN,2021,12,5,0,17,0.7059,0.6,2025-08-16 09:41:02
KAN,2022,14,3,0,17,0.8235,-1.2,2025-08-16 09:41:02
KAN,2023,11,6,0,17,0.6471,-0.8,2025-08-16 09:41:02
KAN,2024,15,2,0,17,0.8824,0.7,2025-08-16 09:41:02
KCB,1924,2,7,0,9,0.2222,6.0,2025-08-16 09:41:02
KCB,1925,2,5,1,8,0.3125,8.5,2025-08-16 09:41:02
KCB,1926,8,3,0,11,0.7273,3.4,2025-08-16 09:41:02
KEN,1924,0,4,1,5,0.1,6.5,2025-08-16 09:41:02
LAB,1926,6,3,1,10,0.65,4.9,2025-08-16 09:41:02
LDA,1946,7,5,2,14,0.5714,-0.1,2025-08-16 09:41:02
LDA,1947,7,7,0,14,0.5,-0.6,2025-08-16 09:41:02
LDA,1948,7,7,0,14,0.5,0.4,2025-08-16 09:41:02
LDA,1949,4,8,0,12,0.3333,0.8,2025-08-16 09:41:02
LOU,1921,0,2,0,2,0.0,-12.0,2025-08-16 09:41:02
LOU,1922,1,3,0,4,0.25,-0.8,2025-08-16 09:41:02
LOU,1923,0,3,0,3,0.0,4.9,2025-08-16 09:41:02
LOU,1926,0,4,0,4,0.0,6.9,2025-08-16 09:41:02
MIA,1966,3,11,0,14,0.2143,0.9,2025-08-16 09:41:02
MIA,1967,4,10,0,14,0.2857,1.2,2025-08-16 09:41:02
MIA,1968,5,8,1,14,0.3929,-0.9,2025-08-16 09:41:02
MIA,1969,3,10,1,14,0.25,0.4,2025-08-16 09:41:02
MIA,1970,10,4,0,14,0.7143,-6.3,2025-08-16 09:41:02
MIA,1971,10,3,1,14,0.75,-2.4,2025-08-16 09:41:02
MIA,1972,14,0,0,14,1.0,-4.3,2025-08-16 09:41:02
MIA,1973,12,2,0,14,0.8571,-0.5,2025-08-16 09:41:02
MIA,1974,11,3,0,14,0.7857,-1.8,2025-08-16 09:41:02
MIA,1975,10,4,0,14,0.7143,-0.3,2025-08-16 09:41:02
MIA,1976,6,8,0,14,0.4286,0.0,2025-08-16 09:41:02
MIA,1977,10,4,0,14,0.7143,-0.5,2025-08-16 09:41:02
MIA,1978,11,5,0,16,0.6875,0.2,2025-08-16 09:41:02
MIA,1979,10,6,0,16,0.625,-0.9,2025-08-16 09:41:02
MIA,1980,8,8,0,16,0.5,0.9,2025-08-16 09:41:02
MIA,1981,11,4,1,16,0.7188,-1.5,2025-08-16 09:41:02
MIA,1982,7,2,0,9,0.7778,0.8,2025-08-16 09:41:02
MIA,1983,12,4,0,16,0.75,-1.0,2025-08-16 09:41:02
MIA,1984,14,2,0,16,0.875,-2.9,2025-08-16 09:41:02
MIA,1985,12,4,0,16,0.75,0.3,2025-08-16 09:41:02
MIA,1986,8,8,0,16,0.5,-1.1,2025-08-16 09:41:02
MIA,1987,8,7,0,15,0.5333,0.3,2025-08-16 09:41:02
MIA,1988,6,10,0,16,0.375,1.0,2025-08-16 09:41:02
MIA,1989,8,8,0,16,0.5,-1.8,2025-08-16 09:41:02
MIA,1990,12,4,0,16,0.75,-1.2,2025-08-16 09:41:02
MIA,1991,8,8,0,16,0.5,-3.7,2025-08-16 09:41:02
MIA,1992,11,5,0,16,0.6875,-2.2,2025-08-16 09:41:02
MIA,1993,9,7,0,16,0.5625,-0.3,2025-08-16 09:41:02
MIA,1994,10,6,0,16,0.625,0.3,2025-08-16 09:41:02
MIA,1995,9,7,0,16,0.5625,-1.4,2025-08-16 09:41:02
MIA,1996,8,8,0,16,0.5,-0.6,2025-08-16 09:41:02
MIA,1997,9,7,0,16,0.5625,0.6,2025-08-16 09:41:02
MIA,1998,10,6,0,16,0.625,2.4,2025-08-16 09:41:02
MIA,1999,9,7,0,16,0.5625,2.5,2025-08-16 09:41:02
MIA,2000,11,5,0,16,0.6875,1.0,2025-08-16 09:41:02
MIA,2001,11,5,0,16,0.6875,-0.7,2025-08-16 09:41:02
MIA,2002,9,7,0,16,0.5625,1.2,2025-08-16 09:41:02
MIA,2003,10,6,0,16,0.625,0.3,2025-08-16 09:41:02
MIA,2004,4,12,0,16,0.25,2.7,2025-08-16 09:41:02
MIA,2005,9,7,0,16,0.5625,-0.8,2025-08-16 09:41:02
MIA,2006,6,10,0,16,0.375,2.1,2025-08-16 09:41:02
MIA,2007,1,15,0,16,0.0625,2.3,2025-08-16 09:41:02
MIA,2008,11,5,0,16,0.6875,-2.3,2025-08-16 09:41:02
MIA,2009,7,9,0,16,0.4375,3.6,2025-08-16 09:41:02
MIA,2010,7,9,0,16,0.4375,4.1,2025-08-16 09:41:02
MIA,2011,6,10,0,16,0.375,-0.1,2025-08-16 09:41:02
MIA,2012,7,9,0,16,0.4375,-0.8,2025-08-16 09:41:02
MIA,2013,8,8,0,16,0.5,0.3,2025-08-16 09:41:02
MIA,2014,8,8,0,16,0.5,1.6,2025-08-16 09:41:02
MIA,2015,6,10,0,16,0.375,-1.9,2025-08-16 09:41:02
MIA,2016,10,6,0,16,0.625,-1.3,2025-08-16 09:41:02
MIA,2017,6,10,0,16,0.375,0.7,2025-08-16 09:41:02
MIA,2018,7,9,0,16,0.4375,-1.7,2025-08-16 09:41:02
MIA,2019,5,11,0,16,0.3125,0.2,2025-08-16 09:41:02
MIA,2020,10,6,0,16,0.625,-1.2,2025-08-16 09:41:02
MIA,2021,9,8,0,17,0.5294,-0.8,2025-08-16 09:41:02
MIA,2022,9,8,0,17,0.5294,2.0,2025-08-16 09:41:02
MIA,2023,11,6,0,17,0.6471,-1.8,2025-08-16 09:41:02
MIA,2024,8,9,0,17,0.4706,-1.9,2025-08-16 09:41:02
MIL,1922,2,4,3,9,0.3889,0.4,2025-08-16 09:41:02
MIL,1923,7,2,3,12,0.7083,-0.2,2025-08-16 09:41:02
MIL,1924,5,8,0,13,0.3846,2.5,2025-08-16 09:41:02
MIL,1925,0,6,0,6,0.0,6.6,2025-08-16 09:41:02
MIL,1926,2,7,0,9,0.2222,1.1,2025-08-16 09:41:02
MIN,1961,3,11,0,14,0.2143,2.1,2025-08-16 09:41:02
MIN,1962,2,11,1,14,0.1786,4.4,2025-08-16 09:41:02
MIN,1963,5,8,1,14,0.3929,0.4,2025-08-16 09:41:02
MIN,1964,8,5,1,14,0.6071,1.6,2025-08-16 09:41:02
MIN,1965,7,7,0,14,0.5,6.5,2025-08-16 09:41:02
MIN,1966,4,9,1,14,0.3214,3.0,2025-08-16 09:41:02
MIN,1967,3,8,3,14,0.3214,2.3,2025-08-16 09:41:02
MIN,1968,8,6,0,14,0.5714,-0.2,2025-08-16 09:41:02
MIN,1969,12,2,0,14,0.8571,0.0,2025-08-16 09:41:02
MIN,1970,12,2,0,14,0.8571,1.4,2025-08-16 09:41:02
MIN,1971,11,3,0,14,0.7857,-1.1,2025-08-16 09:41:02
MIN,1972,7,7,0,14,0.5,2.6,2025-08-16 09:41:02
MIN,1973,12,2,0,14,0.8571,-0.5,2025-08-16 09:41:02
MIN,1974,10,4,0,14,0.7143,-2.1,2025-08-16 09:41:02
MIN,1975,12,2,0,14,0.8571,-5.2,2025-08-16 09:41:02
MIN,1976,11,2,1,14,0.8214,0.1,2025-08-16 09:41:02
MIN,1977,9,5,0,14,0.6429,-1.9,2025-08-16 09:41:02
MIN,1978,8,7,1,16,0.5312,0.6,2025-08-16 09:41:02
MIN,1979,7,9,0,16,0.4375,-2.7,2025-08-16 09:41:02
MIN,1980,9,7,0,16,0.5625,-0.9,2025-08-16 09:41:02
MIN,1981,7,9,0,16,0.4375,0.7,2025-08-16 09:41:02
MIN,1982,5,4,0,9,0.5556,2.4,2025-08-16 09:41:02
MIN,1983,8,8,0,16,0.5,-1.1,2025-08-16 09:41:02
MIN,1984,3,13,0,16,0.1875,2.1,2025-08-16 09:41:02
MIN,1985,7,9,0,16,0.4375,-0.4,2025-08-16 09:41:02
MIN,1986,9,7,0,16,0.5625,-1.3,2025-08-16 09:41:02
MIN,1987,8,7,0,15,0.5333,-2.7,2025-08-16 09:41:02
MIN,1988,11,5,0,16,0.6875,0.0,2025-08-16 09:41:02
MIN,1989,10,6,0,16,0.625,-0.4,2025-08-16 09:41:02
MIN,1990,6,10,0,16,0.375,0.9,2025-08-16 09:41:02
MIN,1991,8,8,0,16,0.5,-1.7,2025-08-16 09:41:02
MIN,1992,11,5,0,16,0.6875,-0.1,2025-08-16 09:41:02
MIN,1993,9,7,0,16,0.5625,0.7,2025-08-16 09:41:02
MIN,1994,10,6,0,16,0.625,0.6,2025-08-16 09:41:02
MIN,1995,8,8,0,16,0.5,2.0,2025-08-16 09:41:02
MIN,1996,9,7,0,16,0.5625,0.9,2025-08-16 09:41:02
MIN,1997,9,7,0,16,0.5625,0.2,2025-08-16 09:41:02
MIN,1998,15,1,0,16,0.9375,-1.4,2025-08-16 09:41:02
MIN,1999,10,6,0,16,0.625,0.4,2025-08-16 09:41:02
MIN,2000,11,5,0,16,0.6875,0.3,2025-08-16 09:41:02
MIN,2001,5,11,0,16,0.3125,1.5,2025-08-16 09:41:02
MIN,2002,6,10,0,16,0.375,0.2,2025-08-16 09:41:02
MIN,2003,9,7,0,16,0.5625,-1.0,2025-08-16 09:41:02
MIN,2004,8,8,0,16,0.5,-2.3,2025-08-16 09:41:02
MIN,2005,9,7,0,16,0.5625,-1.1,2025-08-16 09:41:02
MIN,2006,6,10,0,16,0.375,-1.3,2025-08-16 09:41:02
MIN,2007,8,8,0,16,0.5,0.4,2025-08-16 09:41:02
MIN,2008,10,6,0,16,0.625,1.2,2025-08-16 09:41:02
MIN,2009,12,4,0,16,0.75,-2.7,2025-08-16 09:41:02
MIN,2010,6,10,0,16,0.375,2.6,2025-08-16 09:41:02
MIN,2011,3,13,0,16,0.1875,1.1,2025-08-16 09:41:02
MIN,2012,10,6,0,16,0.625,1.4,2025-08-16 09:41:02
MIN,2013,5,10,1,16,0.3438,-1.1,2025-08-16 09:41:02
MIN,2014,7,9,0,16,0.4375,-0.5,2025-08-16 09:41:02
MIN,2015,11,5,0,16,0.6875,1.9,2025-08-16 09:41:02
MIN,2016,8,8,0,16,0.5,-0.3,2025-08-16 09:41:02
MIN,2017,13,3,0,16,0.8125,1.0,2025-08-16 09:41:02
MIN,2018,8,7,1,16,0.5312,-0.6,2025-08-16 09:41:02
MIN,2019,10,6,0,16,0.625,-1.1,2025-08-16 09:41:02
MIN,2020,7,9,0,16,0.4375,0.4,2025-08-16 09:41:02
MIN,2021,8,9,0,17,0.4706,0.3,2025-08-16 09:41:02
MIN,2022,13,4,0,17,0.7647,0.1,2025-08-16 09:41:02
MIN,2023,7,10,0,17,0.4118,0.5,2025-08-16 09:41:02
MIN,2024,14,3,0,17,0.8235,0.3,2025-08-16 09:41:02
MNN,1921,1,3,0,4,0.25,2.6,2025-08-16 09:41:02
MNN,1922,1,3,0,4,0.25,5.0,2025-08-16 09:41:02
MNN,1923,2,5,2,9,0.3333,0.1,2025-08-16 09:41:02
MNN,1924,0,6,0,6,0.0,7.9,2025-08-16 09:41:02
MNN,1929,1,9,0,10,0.1,2.4,2025-08-16 09:41:02
MNN,1930,1,7,1,9,0.1667,4.4,2025-08-16 09:41:02
MSA,1946,3,11,0,14,0.2143,1.9,2025-08-16 09:41:02
MUN,1920,0,1,0,1,0.0,5.6,2025-08-16 09:41:02
MUN,1921,0,2,0,2,0.0,-19.0,2025-08-16 09:41:02
NAA,1946,10,3,1,14,0.75,-0.7,2025-08-16 09:41:02
NAA,1947,11,2,1,14,0.8214,-1.2,2025-08-16 09:41:02
NAA,1948,6,8,0,14,0.4286,0.3,2025-08-16 09:41:02
NAA,1949,8,4,0,12,0.6667,0.1,2025-08-16 09:41:02
NG1,1921,0,2,0,2,0.0,5.7,2025-08-16 09:41:02
NOR,1967,3,11,0,14,0.2143,-0.4,2025-08-16 09:41:02
NOR,1968,4,9,1,14,0.3214,-0.7,2025-08-16 09:41:02
NOR,1969,5,9,0,14,0.3571,-1.5,2025-08-16 09:41:02
NOR,1970,2,11,1,14,0.1786,4.6,2025-08-16 09:41:02
NOR,1971,4,8,2,14,0.3571,3.0,2025-08-16 09:41:02
NOR,1972,2,11,1,14,0.1786,0.2,2025-08-16 09:41:02
NOR,1973,5,9,0,14,0.3571,1.9,2025-08-16 09:41:02
NOR,1974,5,9,0,14,0.3571,-0.4,2025-08-16 09:41:02
NOR,1975,2,12,0,14,0.1429,-0.1,2025-08-16 09:41:02
NOR,1976,4,10,0,14,0.2857,0.5,2025-08-16 09:41:02
NOR,1977,3,11,0,14,0.2143,-1.7,2025-08-16 09:41:02
NOR,1978,7,9,0,16,0.4375,-0.6,2025-08-16 09:41:02
NOR,1979,8,8,0,16,0.5,-1.8,2025-08-16 09:41:02
NOR,1980,1,15,0,16,0.0625,1.8,2025-08-16 09:41:02
NOR,1981,4,12,0,16,0.25,1.2,2025-08-16 09:41:02
NOR,1982,4,5,0,9,0.4444,-0.3,2025-08-16 09:41:02
NOR,1983,8,8,0,16,0.5,1.1,2025-08-16 09:41:02
NOR,1984,7,9,0,16,0.4375,1.0,2025-08-16 09:41:02
NOR,1985,5,11,0,16,0.3125,-0.1,2025-08-16 09:41:02
NOR,1986,7,9,0,16,0.4375,0.0,2025-08-16 09:41:02
NOR,1987,12,3,0,15,0.8,0.8,2025-08-16 09:41:02
NOR,1988,10,6,0,16,0.625,-0.3,2025-08-16 09:41:02
NOR,1989,9,7,0,16,0.5625,-0.7,2025-08-16 09:41:02
NOR,1990,8,8,0,16,0.5,-1.2,2025-08-16 09:41:02
NOR,1991,11,5,0,16,0.6875,0.9,2025-08-16 09:41:02
NOR,1992,12,4,0,16,0.75,-0.2,2025-08-16 09:41:02
NOR,1993,8,8,0,16,0.5,0.3,2025-08-16 09:41:02
NOR,1994,7,9,0,16,0.4375,0.1,2025-08-16 09:41:02
NOR,1995,7,9,0,16,0.4375,-0.3,2025-08-16 09:41:02
NOR,1996,3,13,0,16,0.1875,-1.2,2025-08-16 09:41:02
NOR,1997,6,10,0,16,0.375,-1.8,2025-08-16 09:41:02
NOR,1998,6,10,0,16,0.375,3.5,2025-08-16 09:41:02
NOR,1999,3,13,0,16,0.1875,-1.3,2025-08-16 09:41:02
NOR,2000,10,6,0,16,0.625,-2.2,2025-08-16 09:41:02
NOR,2001,7,9,0,16,0.4375,-0.1,2025-08-16 09:41:02
NOR,2002,9,7,0,16,0.5625,-0.3,2025-08-16 09:41:02
NOR,2003,8,8,0,16,0.5,-1.1,2025-08-16 09:41:02
NOR,2004,8,8,0,16,0.5,-2.0,2025-08-16 09:41:02
NOR,2005,3,13,0,16,0.1875,-0.9,2025-08-16 09:41:02
NOR,2006,10,6,0,16,0.625,-1.6,2025-08-16 09:41:02
NOR,2007,7,9,0,16,0.4375,-2.0,2025-08-16 09:41:02
NOR,2008,8,8,0,16,0.5,-0.3,2025-08-16 09:41:02
NOR,2009,13,3,0,16,0.8125,0.2,2025-08-16 09:41:02
NOR,2010,11,5,0,16,0.6875,-2.5,2025-08-16 09:41:02
NOR,2011,13,3,0,16,0.8125,-1.6,2025-08-16 09:41:02
NOR,2012,7,9,0,16,0.4375,1.0,2025-08-16 09:41:02
NOR,2013,11,5,0,16,0.6875,1.9,2025-08-16 09:41:02
NOR,2014,7,9,0,16,0.4375,-1.5,2025-08-16 09:41:02
NOR,2015,7,9,0,16,0.4375,-2.3,2025-08-16 09:41:02
NOR,2016,7,9,0,16,0.4375,0.6,2025-08-16 09:41:02
NOR,2017,11,5,0,16,0.6875,1.5,2025-08-16 09:41:02
NOR,2018,13,3,0,16,0.8125,0.6,2025-08-16 09:41:02
NOR,2019,13,3,0,16,0.8125,0.0,2025-08-16 09:41:02
NOR,2020,12,4,0,16,0.75,0.5,2025-08-16 09:41:02
NOR,2021,9,8,0,17,0.5294,0.3,2025-08-16 09:41:02
NOR,2022,7,10,0,17,0.4118,-0.3,2025-08-16 09:41:02
NOR,2023,9,8,0,17,0.5294,-2.2,2025-08-16 09:41:02
NOR,2024,5,12,0,17,0.2941,-0.6,2025-08-16 09:41:02
NWE,1960,5,9,0,14,0.3571,0.6,2025-08-16 09:41:02
NWE,1961,9,4,1,14,0.6786,-0.9,2025-08-16 09:41:02
NWE,1962,9,4,1,14,0.6786,-0.5,2025-08-16 09:41:02
NWE,1963,7,6,1,14,0.5357,-0.6,2025-08-16 09:41:02
NWE,1964,10,3,1,14,0.75,-0.6,2025-08-16 09:41:02
NWE,1965,4,8,2,14,0.3571,0.5,2025-08-16 09:41:02
NWE,1966,8,4,2,14,0.6429,0.3,2025-08-16 09:41:02
NWE,1967,3,10,1,14,0.25,1.1,2025-08-16 09:41:02
NWE,1968,4,10,0,14,0.2857,-0.2,2025-08-16 09:41:02
NWE,1969,4,10,0,14,0.2857,-0.5,2025-08-16 09:41:02
NWE,1970,2,12,0,14,0.1429,-0.7,2025-08-16 09:41:02
NWE,1971,6,8,0,14,0.4286,1.1,2025-08-16 09:41:02
NWE,1972,3,11,0,14,0.2143,0.7,2025-08-16 09:41:02
NWE,1973,5,9,0,14,0.3571,-3.0,2025-08-16 09:41:02
NWE,1974,7,7,0,14,0.5,0.6,2025-08-16 09:41:02
NWE,1975,3,11,0,14,0.2143,2.9,2025-08-16 09:41:02
NWE,1976,11,3,0,14,0.7857,-1.4,2025-08-16 09:41:02
NWE,1977,9,5,0,14,0.6429,-0.4,2025-08-16 09:41:02
NWE,1978,11,5,0,16,0.6875,0.5,2025-08-16 09:41:02
NWE,1979,9,7,0,16,0.5625,-0.2,2025-08-16 09:41:02
NWE,1980,10,6,0,16,0.625,-0.8,2025-08-16 09:41:02
NWE,1981,2,14,0,16,0.125,-0.7,2025-08-16 09:41:02
NWE,1982,5,4,0,9,0.5556,-0.8,2025-08-16 09:41:02
NWE,1983,8,8,0,16,0.5,-0.1,2025-08-16 09:41:02
NWE,1984,9,7,0,16,0.5625,-0.8,2025-08-16 09:41:02
NWE,1985,11,5,0,16,0.6875,1.3,2025-08-16 09:41:02
NWE,1986,11,5,0,16,0.6875,-0.9,2025-08-16 09:41:02
NWE,1987,8,7,0,15,0.5333,1.3,2025-08-16 09:41:02
NWE,1988,9,7,0,16,0.5625,2.0,2025-08-16 09:41:02
NWE,1989,5,11,0,16,0.3125,-1.2,2025-08-16 09:41:02
NWE,1990,1,15,0,16,0.0625,2.0,2025-08-16 09:41:02
NWE,1991,6,10,0,16,0.375,-2.8,2025-08-16 09:41:02
NWE,1992,2,14,0,16,0.125,-1.1,2025-08-16 09:41:02
NWE,1993,5,11,0,16,0.3125,-0.8,2025-08-16 09:41:02
NWE,1994,10,6,0,16,0.625,0.8,2025-08-16 09:41:02
NWE,1995,6,10,0,16,0.375,-0.2,2025-08-16 09:41:02
NWE,1996,11,5,0,16,0.6875,-1.5,2025-08-16 09:41:02
NWE,1997,10,6,0,16,0.625,0.3,2025-08-16 09:41:02
NWE,1998,9,7,0,16,0.5625,3.4,2025-08-16 09:41:02
NWE,1999,8,8,0,16,0.5,1.3,2025-08-16 09:41:02
NWE,2000,5,11,0,16,0.3125,1.4,2025-08-16 09:41:02
NWE,2001,11,5,0,16,0.6875,-1.9,2025-08-16 09:41:02
NWE,2002,9,7,0,16,0.5625,1.8,2025-08-16 09:41:02
NWE,2003,14,2,0,16,0.875,0.1,2025-08-16 09:41:02
NWE,2004,14,2,0,16,0.875,1.8,2025-08-16 09:41:02
NWE,2005,10,6,0,16,0.625,0.6,2025-08-16 09:41:02
NWE,2006,12,4,0,16,0.75,1.0,2025-08-16 09:41:02
NWE,2007,16,0,0,16,1.0,0.4,2025-08-16 09:41:02
NWE,2008,11,5,0,16,0.6875,-2.4,2025-08-16 09:41:02
NWE,2009,10,6,0,16,0.625,2.3,2025-08-16 09:41:02
NWE,2010,14,2,0,16,0.875,2.6,2025-08-16 09:41:02
NWE,2011,13,3,0,16,0.8125,-1.4,2025-08-16 09:41:02
NWE,2012,12,4,0,16,0.75,-1.4,2025-08-16 09:41:02
NWE,2013,12,4,0,16,0.75,-0.7,2025-08-16 09:41:02
NWE,2014,12,4,0,16,0.75,1.3,2025-08-16 09:41:02
NWE,2015,12,4,0,16,0.75,-2.4,2025-08-16 09:41:02
NWE,2016,14,2,0,16,0.875,-2.7,2025-08-16 09:41:02
NWE,2017,13,3,0,16,0.8125,-1.2,2025-08-16 09:41:02
NWE,2018,11,5,0,16,0.6875,-1.8,2025-08-16 09:41:02
NWE,2019,12,4,0,16,0.75,-1.8,2025-08-16 09:41:02
NWE,2020,7,9,0,16,0.4375,0.7,2025-08-16 09:41:02
NWE,2021,10,7,0,17,0.5882,-0.9,2025-08-16 09:41:02
NWE,2022,8,9,0,17,0.4706,1.0,2025-08-16 09:41:02
NWE,2023,4,13,0,17,0.2353,-0.2,2025-08-16 09:41:02
NWE,2024,4,13,0,17,0.2353,-0.6,2025-08-16 09:41:02
NYA,1927,7,8,1,16,0.4688,2.1,2025-08-16 09:41:02
NYA,1928,4,8,1,13,0.3462,2.7,2025-08-16 09:41:02
NYG,1925,8,4,0,12,0.6667,-4.6,2025-08-16 09:41:02
NYG,1926,8,4,1,13,0.6538,-0.9,2025-08-16 09:41:02
NYG,1927,11,1,1,13,0.8846,-1.7,2025-08-16 09:41:02
NYG,1928,4,7,2,13,0.3846,2.9,2025-08-16 09:41:02
NYG,1929,13,1,1,15,0.9,-1.2,2025-08-16 09:41:02
NYG,1930,13,4,0,17,0.7647,-0.6,2025-08-16 09:41:02
NYG,1931,7,6,1,14,0.5357,0.0,2025-08-16 09:41:02
NYG,1932,4,6,2,12,0.4167,0.2,2025-08-16 09:41:02
NYG,1933,11,3,0,14,0.7857,-0.2,2025-08-16 09:41:02
NYG,1934,8,5,0,13,0.6154,0.8,2025-08-16 09:41:02
NYG,1935,9,3,0,12,0.75,-3.1,2025-08-16 09:41:02
NYG,1936,5,6,1,12,0.4583,-0.7,2025-08-16 09:41:02
NYG,1937,6,3,2,11,0.6364,-1.1,2025-08-16 09:41:02
NYG,1938,8,2,1,11,0.7727,-2.9,2025-08-16 09:41:02
NYG,1939,9,1,1,11,0.8636,-3.2,2025-08-16 09:41:02
NYG,1940,6,4,1,11,0.5909,-1.0,2025-08-16 09:41:02
NYG,1941,8,3,0,11,0.7273,-6.5,2025-08-16 09:41:02
NYG,1942,5,5,1,11,0.5,1.6,2025-08-16 09:41:02
NYG,1943,6,3,1,10,0.65,-1.6,2025-08-16 09:41:02
NYG,1944,8,1,1,10,0.85,-3.2,2025-08-16 09:41:02
NYG,1945,3,6,1,10,0.35,0.2,2025-08-16 09:41:02
NYG,1946,7,3,1,11,0.6818,-0.2,2025-08-16 09:41:02
NYG,1947,2,8,2,12,0.25,-1.5,2025-08-16 09:41:02
NYG,1948,4,8,0,12,0.3333,1.1,2025-08-16 09:41:02
NYG,1949,6,6,0,12,0.5,-1.0,2025-08-16 09:41:02
NYG,1950,10,2,0,12,0.8333,2.7,2025-08-16 09:41:02
NYG,1951,9,2,1,12,0.7917,-2.0,2025-08-16 09:41:02
NYG,1952,7,5,0,12,0.5833,-1.1,2025-08-16 09:41:02
NYG,1953,3,9,0,12,0.25,2.6,2025-08-16 09:41:02
NYG,1954,7,5,0,12,0.5833,-5.0,2025-08-16 09:41:02
NYG,1955,6,5,1,12,0.5417,2.2,2025-08-16 09:41:02
NYG,1956,8,3,1,12,0.7083,-1.4,2025-08-16 09:41:02
NYG,1957,7,5,0,12,0.5833,-1.4,2025-08-16 09:41:02
NYG,1958,9,3,0,12,0.75,-1.1,2025-08-16 09:41:02
NYG,1959,10,2,0,12,0.8333,-3.4,2025-08-16 09:41:02
NYG,1960,6,4,2,12,0.5833,1.1,2025-08-16 09:41:02
NYG,1961,10,3,1,14,0.75,-3.1,2025-08-16 09:41:02
NYG,1962,12,2,0,14,0.8571,-3.8,2025-08-16 09:41:02
NYG,1963,11,3,0,14,0.7857,-2.1,2025-08-16 09:41:02
NYG,1964,2,10,2,14,0.2143,-1.3,2025-08-16 09:41:02
NYG,1965,7,7,0,14,0.5,-5.4,2025-08-16 09:41:02
NYG,1966,1,12,1,14,0.1071,0.2,2025-08-16 09:41:02
NYG,1967,7,7,0,14,0.5,-0.9,2025-08-16 09:41:02
NYG,1968,7,7,0,14,0.5,-0.1,2025-08-16 09:41:02
NYG,1969,6,8,0,14,0.4286,-2.0,2025-08-16 09:41:02
NYG,1970,9,5,0,14,0.6429,-0.2,2025-08-16 09:41:02
NYG,1971,4,10,0,14,0.2857,1.6,2025-08-16 09:41:02
NYG,1972,8,6,0,14,0.5714,-0.1,2025-08-16 09:41:02
NYG,1973,2,11,1,14,0.1786,2.2,2025-08-16 09:41:02
NYG,1974,2,12,0,14,0.1429,1.8,2025-08-16 09:41:02
NYG,1975,5,9,0,14,0.3571,-0.4,2025-08-16 09:41:02
NYG,1976,3,11,0,14,0.2143,2.3,2025-08-16 09:41:02
NYG,1977,5,9,0,14,0.3571,-0.2,2025-08-16 09:41:02
NYG,1978,6,10,0,16,0.375,-0.4,2025-08-16 09:41:02
NYG,1979,6,10,0,16,0.375,-0.8,2025-08-16 09:41:02
NYG,1980,4,12,0,16,0.25,1.3,2025-08-16 09:41:02
NYG,1981,9,7,0,16,0.5625,1.0,2025-08-16 09:41:02
NYG,1982,4,5,0,9,0.4444,0.5,2025-08-16 09:41:02
NYG,1983,3,12,1,16,0.2188,2.9,2025-08-16 09:41:02
NYG,1984,9,7,0,16,0.5625,1.0,2025-08-16 09:41:02
NYG,1985,10,6,0,16,0.625,-3.3,2025-08-16 09:41:02
NYG,1986,14,2,0,16,0.875,0.6,2025-08-16 09:41:02
NYG,1987,6,9,0,15,0.4,1.4,2025-08-16 09:41:02
NYG,1988,10,6,0,16,0.625,-1.3,2025-08-16 09:41:02
NYG,1989,12,4,0,16,0.75,0.4,2025-08-16 09:41:02
NYG,1990,13,3,0,16,0.8125,-0.1,2025-08-16 09:41:02
NYG,1991,8,8,0,16,0.5,2.0,2025-08-16 09:41:02
NYG,1992,6,10,0,16,0.375,2.0,2025-08-16 09:41:02
NYG,1993,11,5,0,16,0.6875,-0.5,2025-08-16 09:41:02
NYG,1994,9,7,0,16,0.5625,-0.1,2025-08-16 09:41:02
NYG,1995,5,11,0,16,0.3125,1.6,2025-08-16 09:41:02
NYG,1996,6,10,0,16,0.375,-0.7,2025-08-16 09:41:02
NYG,1997,10,5,1,16,0.6562,-1.1,2025-08-16 09:41:02
NYG,1998,8,8,0,16,0.5,-1.9,2025-08-16 09:41:02
NYG,1999,7,9,0,16,0.4375,0.7,2025-08-16 09:41:02
NYG,2000,12,4,0,16,0.75,-2.7,2025-08-16 09:41:02
NYG,2001,7,9,0,16,0.4375,-0.1,2025-08-16 09:41:02
NYG,2002,10,6,0,16,0.625,-1.7,2025-08-16 09:41:02
NYG,2003,4,12,0,16,0.25,0.4,2025-08-16 09:41:02
NYG,2004,6,10,0,16,0.375,-1.2,2025-08-16 09:41:02
NYG,2005,11,5,0,16,0.6875,0.7,2025-08-16 09:41:02
NYG,2006,8,8,0,16,0.5,0.5,2025-08-16 09:41:02
NYG,2007,10,6,0,16,0.625,1.9,2025-08-16 09:41:02
NYG,2008,12,4,0,16,0.75,0.1,2025-08-16 09:41:02
NYG,2009,8,8,0,16,0.5,1.6,2025-08-16 09:41:02
NYG,2010,10,6,0,16,0.625,-0.8,2025-08-16 09:41:02
NYG,2011,9,7,0,16,0.5625,2.0,2025-08-16 09:41:02
NYG,2012,9,7,0,16,0.5625,0.9,2025-08-16 09:41:02
NYG,2013,7,9,0,16,0.4375,0.2,2025-08-16 09:41:02
NYG,2014,6,10,0,16,0.375,-0.4,2025-08-16 09:41:02
NYG,2015,6,10,0,16,0.375,-2.2,2025-08-16 09:41:02
NYG,2016,11,5,0,16,0.6875,0.5,2025-08-16 09:41:02
NYG,2017,3,13,0,16,0.1875,1.3,2025-08-16 09:41:02
NYG,2018,5,11,0,16,0.3125,0.5,2025-08-16 09:41:02
NYG,2019,4,12,0,16,0.25,-1.0,2025-08-16 09:41:02
NYG,2020,6,10,0,16,0.375,0.4,2025-08-16 09:41:02
NYG,2021,4,13,0,17,0.2353,1.0,2025-08-16 09:41:02
NYG,2022,9,7,1,17,0.5588,0.0,2025-08-16 09:41:02
NYG,2023,6,11,0,17,0.3529,0.4,2025-08-16 09:41:02
NYG,2024,3,14,0,17,0.1765,0.3,2025-08-16 09:41:02
NYJ,1960,7,7,0,14,0.5,0.2,2025-08-16 09:41:02
NYJ,1961,7,7,0,14,0.5,0.8,2025-08-16 09:41:02
NYJ,1962,5,9,0,14,0.3571,1.3,2025-08-16 09:41:02
NYJ,1963,5,8,1,14,0.3929,1.3,2025-08-16 09:41:02
NYJ,1964,5,8,1,14,0.3929,0.3,2025-08-16 09:41:02
NYJ,1965,5,8,1,14,0.3929,0.2,2025-08-16 09:41:02
NYJ,1966,6,6,2,14,0.5,0.0,2025-08-16 09:41:02
NYJ,1967,8,5,1,14,0.6071,-0.6,2025-08-16 09:41:02
NYJ,1968,11,3,0,14,0.7857,-2.1,2025-08-16 09:41:02
NYJ,1969,10,4,0,14,0.7143,-2.0,2025-08-16 09:41:02
NYJ,1970,4,10,0,14,0.2857,-2.7,2025-08-16 09:41:02
NYJ,1971,6,8,0,14,0.4286,0.8,2025-08-16 09:41:02
NYJ,1972,7,7,0,14,0.5,-2.6,2025-08-16 09:41:02
NYJ,1973,4,10,0,14,0.2857,1.3,2025-08-16 09:41:02
NYJ,1974,7,7,0,14,0.5,-1.0,2025-08-16 09:41:02
NYJ,1975,3,11,0,14,0.2143,4.2,2025-08-16 09:41:02
NYJ,1976,3,11,0,14,0.2143,1.5,2025-08-16 09:41:02
NYJ,1977,3,11,0,14,0.2143,1.9,2025-08-16 09:41:02
NYJ,1978,8,8,0,16,0.5,1.4,2025-08-16 09:41:02
NYJ,1979,8,8,0,16,0.5,0.0,2025-08-16 09:41:02
NYJ,1980,4,12,0,16,0.25,0.7,2025-08-16 09:41:02
NYJ,1981,10,5,1,16,0.6562,-2.4,2025-08-16 09:41:02
NYJ,1982,6,3,0,9,0.6667,1.7,2025-08-16 09:41:02
NYJ,1983,7,9,0,16,0.4375,-0.1,2025-08-16 09:41:02
NYJ,1984,7,9,0,16,0.4375,-2.5,2025-08-16 09:41:02
NYJ,1985,11,5,0,16,0.6875,0.9,2025-08-16 09:41:02
NYJ,1986,10,6,0,16,0.625,0.0,2025-08-16 09:41:02
NYJ,1987,6,9,0,15,0.4,0.4,2025-08-16 09:41:02
NYJ,1988,8,7,1,16,0.5312,0.3,2025-08-16 09:41:02
NYJ,1989,4,12,0,16,0.25,-0.2,2025-08-16 09:41:02
NYJ,1990,6,10,0,16,0.375,-1.5,2025-08-16 09:41:02
NYJ,1991,8,8,0,16,0.5,-3.8,2025-08-16 09:41:02
NYJ,1992,4,12,0,16,0.25,-0.9,2025-08-16 09:41:02
NYJ,1993,8,8,0,16,0.5,-0.6,2025-08-16 09:41:02
NYJ,1994,6,10,0,16,0.375,1.3,2025-08-16 09:41:02
NYJ,1995,3,13,0,16,0.1875,-1.7,2025-08-16 09:41:02
NYJ,1996,1,15,0,16,0.0625,0.8,2025-08-16 09:41:02
NYJ,1997,9,7,0,16,0.5625,-0.9,2025-08-16 09:41:02
NYJ,1998,12,4,0,16,0.75,1.8,2025-08-16 09:41:02
NYJ,1999,8,8,0,16,0.5,3.1,2025-08-16 09:41:02
NYJ,2000,9,7,0,16,0.5625,3.5,2025-08-16 09:41:02
NYJ,2001,10,6,0,16,0.625,0.0,2025-08-16 09:41:02
NYJ,2002,9,7,0,16,0.5625,1.7,2025-08-16 09:41:02
NYJ,2003,6,10,0,16,0.375,0.4,2025-08-16 09:41:02
NYJ,2004,10,6,0,16,0.625,2.1,2025-08-16 09:41:02
NYJ,2005,4,12,0,16,0.25,0.8,2025-08-16 09:41:02
NYJ,2006,10,6,0,16,0.625,0.7,2025-08-16 09:41:02
NYJ,2007,4,12,0,16,0.25,1.7,2025-08-16 09:41:02
NYJ,2008,9,7,0,16,0.5625,-2.8,2025-08-16 09:41:02
NYJ,2009,9,7,0,16,0.5625,1.6,2025-08-16 09:41:02
NYJ,2010,11,5,0,16,0.6875,2.5,2025-08-16 09:41:02
NYJ,2011,8,8,0,16,0.5,0.0,2025-08-16 09:41:02
NYJ,2012,6,10,0,16,0.375,0.0,2025-08-16 09:41:02
NYJ,2013,8,8,0,16,0.5,0.0,2025-08-16 09:41:02
NYJ,2014,4,12,0,16,0.25,2.3,2025-08-16 09:41:02
NYJ,2015,10,6,0,16,0.625,-3.0,2025-08-16 09:41:02
NYJ,2016,5,11,0,16,0.3125,-0.1,2025-08-16 09:41:02
NYJ,2017,5,11,0,16,0.3125,0.3,2025-08-16 09:41:02
NYJ,2018,4,12,0,16,0.25,-1.1,2025-08-16 09:41:02
NYJ,2019,7,9,0,16,0.4375,-1.1,2025-08-16 09:41:02
NYJ,2020,2,14,0,16,0.125,1.9,2025-08-16 09:41:02
NYJ,2021,4,13,0,17,0.2353,1.0,2025-08-16 09:41:02
NYJ,2022,7,10,0,17,0.4118,2.0,2025-08-16 09:41:02
NYJ,2023,7,10,0,17,0.4118,-0.6,2025-08-16 09:41:02
NYJ,2024,5,12,0,17,0.2941,-0.5,2025-08-16 09:41:02
NYY,1949,1,10,1,12,0.125,1.3,2025-08-16 09:41:02
NYY,1950,7,5,0,12,0.5833,-3.5,2025-08-16 09:41:02
NYY,1951,1,9,2,12,0.1667,2.3,2025-08-16 09:41:02
OOR,1922,3,6,0,9,0.3333,9.1,2025-08-16 09:41:02
OOR,1923,1,10,0,11,0.0909,6.5,2025-08-16 09:41:02
OTI,1960,10,4,0,14,0.7143,-0.8,2025-08-16 09:41:02
OTI,1961,10,3,1,14,0.75,-2.4,2025-08-16 09:41:02
OTI,1962,11,3,0,14,0.7857,-1.0,2025-08-16 09:41:02
OTI,1963,6,8,0,14,0.4286,0.6,2025-08-16 09:41:02
OTI,1964,4,10,0,14,0.2857,0.4,2025-08-16 09:41:02
OTI,1965,4,10,0,14,0.2857,1.2,2025-08-16 09:41:02
OTI,1966,3,11,0,14,0.2143,-0.4,2025-08-16 09:41:02
OTI,1967,9,4,1,14,0.6786,-1.6,2025-08-16 09:41:02
OTI,1968,7,7,0,14,0.5,-0.8,2025-08-16 09:41:02
OTI,1969,6,6,2,14,0.5,-1.1,2025-08-16 09:41:02
OTI,1970,3,10,1,14,0.25,0.4,2025-08-16 09:41:02
OTI,1971,4,9,1,14,0.3214,-1.1,2025-08-16 09:41:02
OTI,1972,1,13,0,14,0.0714,2.4,2025-08-16 09:41:02
OTI,1973,1,13,0,14,0.0714,1.0,2025-08-16 09:41:02
OTI,1974,7,7,0,14,0.5,1.4,2025-08-16 09:41:02
OTI,1975,10,4,0,14,0.7143,1.6,2025-08-16 09:41:02
OTI,1976,5,9,0,14,0.3571,1.9,2025-08-16 09:41:02
OTI,1977,8,6,0,14,0.5714,1.7,2025-08-16 09:41:02
OTI,1978,10,6,0,16,0.625,0.5,2025-08-16 09:41:02
OTI,1979,11,5,0,16,0.6875,2.4,2025-08-16 09:41:02
OTI,1980,11,5,0,16,0.6875,-1.1,2025-08-16 09:41:02
OTI,1981,7,9,0,16,0.4375,-0.1,2025-08-16 09:41:02
OTI,1982,1,8,0,9,0.1111,1.1,2025-08-16 09:41:02
OTI,1983,2,14,0,16,0.125,-0.8,2025-08-16 09:41:02
OTI,1984,3,13,0,16,0.1875,0.3,2025-08-16 09:41:02
OTI,1985,5,11,0,16,0.3125,-0.9,2025-08-16 09:41:02
OTI,1986,5,11,0,16,0.3125,-0.5,2025-08-16 09:41:02
OTI,1987,9,6,0,15,0.6,2.2,2025-08-16 09:41:02
OTI,1988,10,6,0,16,0.625,-0.7,2025-08-16 09:41:02
OTI,1989,9,7,0,16,0.5625,0.4,2025-08-16 09:41:02
OTI,1990,9,7,0,16,0.5625,-0.9,2025-08-16 09:41:02
OTI,1991,11,5,0,16,0.6875,-0.1,2025-08-16 09:41:02
OTI,1992,10,6,0,16,0.625,-0.3,2025-08-16 09:41:02
OTI,1993,12,4,0,16,0.75,-0.9,2025-08-16 09:41:02
OTI,1994,2,14,0,16,0.125,0.6,2025-08-16 09:41:02
OTI,1995,7,9,0,16,0.4375,-0.7,2025-08-16 09:41:02
OTI,1996,8,8,0,16,0.5,-0.7,2025-08-16 09:41:02
OTI,1997,8,8,0,16,0.5,0.2,2025-08-16 09:41:02
OTI,1998,8,8,0,16,0.5,-0.6,2025-08-16 09:41:02
OTI,1999,13,3,0,16,0.8125,-3.2,2025-08-16 09:41:02
OTI,2000,13,3,0,16,0.8125,-1.3,2025-08-16 09:41:02
OTI,2001,7,9,0,16,0.4375,1.2,2025-08-16 09:41:02
OTI,2002,11,5,0,16,0.6875,-0.9,2025-08-16 09:41:02
OTI,2003,12,4,0,16,0.75,-0.5,2025-08-16 09:41:02
OTI,2004,5,11,0,16,0.3125,1.5,2025-08-16 09:41:02
OTI,2005,4,12,0,16,0.25,0.1,2025-08-16 09:41:02
OTI,2006,8,8,0,16,0.5,3.5,2025-08-16 09:41:02
OTI,2007,10,6,0,16,0.625,0.5,2025-08-16 09:41:02
OTI,2008,13,3,0,16,0.8125,0.1,2025-08-16 09:41:02
OTI,2009,8,8,0,16,0.5,0.2,2025-08-16 09:41:02
OTI,2010,6,10,0,16,0.375,0.0,2025-08-16 09:41:02
OTI,2011,9,7,0,16,0.5625,-1.5,2025-08-16 09:41:02
OTI,2012,6,10,0,16,0.375,-1.2,2025-08-16 09:41:02
OTI,2013,7,9,0,16,0.4375,0.4,2025-08-16 09:41:02
OTI,2014,2,14,0,16,0.125,-0.3,2025-08-16 09:41:02
OTI,2015,3,13,0,16,0.1875,-2.8,2025-08-16 09:41:02
OTI,2016,9,7,0,16,0.5625,-1.2,2025-08-16 09:41:02
OTI,2017,9,7,0,16,0.5625,-2.1,2025-08-16 09:41:02
OTI,2018,9,7,0,16,0.5625,-0.2,2025-08-16 09:41:02
OTI,2019,9,7,0,16,0.5625,-1.0,2025-08-16 09:41:02
OTI,2020,11,5,0,16,0.6875,-1.7,2025-08-16 09:41:02
OTI,2021,12,5,0,17,0.7059,-0.4,2025-08-16 09:41:02
OTI,2022,7,10,0,17,0.4118,0.0,2025-08-16 09:41:02
OTI,2023,6,11,0,17,0.3529,0.4,2025-08-16 09:41:02
OTI,2024,3,14,0,17,0.1765,0.4,2025-08-16 09:41:02
PHI,1933,3,5,1,9,0.3889,-0.3,2025-08-16 09:41:02
PHI,1934,4,7,0,11,0.3636,-4.2,2025-08-16 09:41:02
PHI,1935,2,9,0,11,0.1818,-0.2,2025-08-16 09:41:02
PHI,1936,1,11,0,12,0.0833,-0.9,2025-08-16 09:41:02
PHI,1937,2,8,1,11,0.2273,-1.5,2025-08-16 09:41:02
PHI,1938,5,6,0,11,0.4545,-0.7,2025-08-16 09:41:02
PHI,1939,1,9,1,11,0.1364,1.0,2025-08-16 09:41:02
PHI,1940,1,10,0,11,0.0909,0.5,2025-08-16 09:41:02
PHI,1941,2,8,1,11,0.2273,-0.9,2025-08-16 09:41:02
PHI,1942,2,9,0,11,0.1818,3.7,2025-08-16 09:41:02
PHI,1943,5,4,1,10,0.55,-1.0,2025-08-16 09:41:02
PHI,1944,7,1,2,10,0.8,-2.0,2025-08-16 09:41:02
PHI,1945,7,3,0,10,0.7,-3.8,2025-08-16 09:41:02
PHI,1946,6,5,0,11,0.5455,0.5,2025-08-16 09:41:02
PHI,1947,8,4,0,12,0.6667,-3.0,2025-08-16 09:41:02
PHI,1948,9,2,1,12,0.7917,-2.9,2025-08-16 09:41:02
PHI,1949,11,1,0,12,0.9167,-2.1,2025-08-16 09:41:02
PHI,1950,6,6,0,12,0.5,3.6,2025-08-16 09:41:02
PHI,1951,4,8,0,12,0.3333,1.0,2025-08-16 09:41:02
PHI,1952,7,5,0,12,0.5833,-0.8,2025-08-16 09:41:02
PHI,1953,7,4,1,12,0.625,-1.0,2025-08-16 09:41:02
PHI,1954,7,4,1,12,0.625,-2.9,2025-08-16 09:41:02
PHI,1955,4,7,1,12,0.375,3.2,2025-08-16 09:41:02
PHI,1956,3,8,1,12,0.2917,-0.5,2025-08-16 09:41:02
PHI,1957,4,8,0,12,0.3333,0.6,2025-08-16 09:41:02
PHI,1958,2,9,1,12,0.2083,-1.8,2025-08-16 09:41:02
PHI,1959,7,5,0,12,0.5833,-1.8,2025-08-16 09:41:02
PHI,1960,10,2,0,12,0.8333,0.4,2025-08-16 09:41:02
PHI,1961,10,4,0,14,0.7143,-2.6,2025-08-16 09:41:02
PHI,1962,3,10,1,14,0.25,-2.4,2025-08-16 09:41:02
PHI,1963,2,10,2,14,0.2143,1.6,2025-08-16 09:41:02
PHI,1964,6,8,0,14,0.4286,-3.5,2025-08-16 09:41:02
PHI,1965,5,9,0,14,0.3571,-6.3,2025-08-16 09:41:02
PHI,1966,9,5,0,14,0.6429,-2.0,2025-08-16 09:41:02
PHI,1967,6,7,1,14,0.4643,-1.2,2025-08-16 09:41:02
PHI,1968,2,12,0,14,0.1429,-0.1,2025-08-16 09:41:02
PHI,1969,4,9,1,14,0.3214,-1.3,2025-08-16 09:41:02
PHI,1970,3,10,1,14,0.25,2.0,2025-08-16 09:41:02
PHI,1971,6,7,1,14,0.4643,1.5,2025-08-16 09:41:02
PHI,1972,2,11,1,14,0.1786,0.2,2025-08-16 09:41:02
PHI,1973,5,8,1,14,0.3929,1.7,2025-08-16 09:41:02
PHI,1974,7,7,0,14,0.5,1.1,2025-08-16 09:41:02
PHI,1975,4,10,0,14,0.2857,0.9,2025-08-16 09:41:02
PHI,1976,4,10,0,14,0.2857,0.0,2025-08-16 09:41:02
PHI,1977,5,9,0,14,0.3571,-1.5,2025-08-16 09:41:02
PHI,1978,9,7,0,16,0.5625,1.1,2025-08-16 09:41:02
PHI,1979,11,5,0,16,0.6875,-0.9,2025-08-16 09:41:02
PHI,1980,12,4,0,16,0.75,-0.4,2025-08-16 09:41:02
PHI,1981,10,6,0,16,0.625,-0.5,2025-08-16 09:41:02
PHI,1982,3,6,0,9,0.3333,1.1,2025-08-16 09:41:02
PHI,1983,5,11,0,16,0.3125,2.4,2025-08-16 09:41:02
PHI,1984,6,9,1,16,0.4062,0.2,2025-08-16 09:41:02
PHI,1985,7,9,0,16,0.4375,-1.9,2025-08-16 09:41:02
PHI,1986,5,10,1,16,0.3438,2.0,2025-08-16 09:41:02
PHI,1987,7,8,0,15,0.4667,0.8,2025-08-16 09:41:02
PHI,1988,10,6,0,16,0.625,-0.3,2025-08-16 09:41:02
PHI,1989,11,5,0,16,0.6875,0.8,2025-08-16 09:41:02
PHI,1990,10,6,0,16,0.625,-0.5,2025-08-16 09:41:02
PHI,1991,10,6,0,16,0.625,2.1,2025-08-16 09:41:02
PHI,1992,11,5,0,16,0.6875,2.1,2025-08-16 09:41:02
PHI,1993,8,8,0,16,0.5,1.8,2025-08-16 09:41:02
PHI,1994,7,9,0,16,0.4375,0.6,2025-08-16 09:41:02
PHI,1995,10,6,0,16,0.625,-0.5,2025-08-16 09:41:02
PHI,1996,10,6,0,16,0.625,-0.8,2025-08-16 09:41:02
PHI,1997,6,9,1,16,0.4062,0.5,2025-08-16 09:41:02
PHI,1998,3,13,0,16,0.1875,-1.3,2025-08-16 09:41:02
PHI,1999,5,11,0,16,0.3125,1.1,2025-08-16 09:41:02
PHI,2000,11,5,0,16,0.6875,-3.6,2025-08-16 09:41:02
PHI,2001,11,5,0,16,0.6875,-0.7,2025-08-16 09:41:02
PHI,2002,12,4,0,16,0.75,-2.6,2025-08-16 09:41:02
PHI,2003,12,4,0,16,0.75,-1.0,2025-08-16 09:41:02
PHI,2004,13,3,0,16,0.8125,-2.3,2025-08-16 09:41:02
PHI,2005,6,10,0,16,0.375,2.6,2025-08-16 09:41:02
PHI,2006,10,6,0,16,0.625,-1.0,2025-08-16 09:41:02
PHI,2007,8,8,0,16,0.5,3.0,2025-08-16 09:41:02
PHI,2008,9,6,1,16,0.5938,-0.1,2025-08-16 09:41:02
PHI,2009,11,5,0,16,0.6875,0.2,2025-08-16 09:41:02
PHI,2010,10,6,0,16,0.625,0.3,2025-08-16 09:41:02
PHI,2011,8,8,0,16,0.5,0.5,2025-08-16 09:41:02
PHI,2012,4,12,0,16,0.25,1.4,2025-08-16 09:41:02
PHI,2013,10,6,0,16,0.625,-1.9,2025-08-16 09:41:02
PHI,2014,10,6,0,16,0.625,-0.7,2025-08-16 09:41:02
PHI,2015,7,9,0,16,0.4375,-1.3,2025-08-16 09:41:02
PHI,2016,7,9,0,16,0.4375,1.6,2025-08-16 09:41:02
PHI,2017,13,3,0,16,0.8125,-0.7,2025-08-16 09:41:02
PHI,2018,9,7,0,16,0.5625,0.5,2025-08-16 09:41:02
PHI,2019,9,7,0,16,0.5625,-1.7,2025-08-16 09:41:02
PHI,2020,4,11,1,16,0.2812,0.8,2025-08-16 09:41:02
PHI,2021,9,8,0,17,0.5294,-1.0,2025-08-16 09:41:02
PHI,2022,14,3,0,17,0.8235,-1.3,2025-08-16 09:41:02
PHI,2023,11,6,0,17,0.6471,-0.4,2025-08-16 09:41:02
PHI,2024,14,3,0,17,0.8235,-1.7,2025-08-16 09:41:02
PIT,1933,3,6,2,11,0.3636,-0.3,2025-08-16 09:41:02
PIT,1934,2,10,0,12,0.1667,-1.5,2025-08-16 09:41:02
PIT,1935,4,8,0,12,0.3333,-0.8,2025-08-16 09:41:02
PIT,1936,6,6,0,12,0.5,0.1,2025-08-16 09:41:02
PIT,1937,4,7,0,11,0.3636,-1.3,2025-08-16 09:41:02
PIT,1938,2,9,0,11,0.1818,1.0,2025-08-16 09:41:02
PIT,1939,1,9,1,11,0.1364,-0.2,2025-08-16 09:41:02
PIT,1940,2,7,2,11,0.2727,0.4,2025-08-16 09:41:02
PIT,1941,1,9,1,11,0.1364,1.3,2025-08-16 09:41:02
PIT,1942,7,4,0,11,0.6364,-1.6,2025-08-16 09:41:02
PIT,1945,2,8,0,10,0.2,-0.1,2025-08-16 09:41:02
PIT,1946,5,5,1,11,0.5,-1.0,2025-08-16 09:41:02
PIT,1947,8,4,0,12,0.6667,-2.5,2025-08-16 09:41:02
PIT,1948,4,8,0,12,0.3333,-1.7,2025-08-16 09:41:02
PIT,1949,6,5,1,12,0.5417,-1.0,2025-08-16 09:41:02
PIT,1950,6,6,0,12,0.5,4.5,2025-08-16 09:41:02
PIT,1951,4,7,1,12,0.375,0.2,2025-08-16 09:41:02
PIT,1952,5,7,0,12,0.4167,1.9,2025-08-16 09:41:02
PIT,1953,6,6,0,12,0.5,0.8,2025-08-16 09:41:02
PIT,1954,5,7,0,12,0.4167,-2.3,2025-08-16 09:41:02
PIT,1955,4,8,0,12,0.3333,4.0,2025-08-16 09:41:02
PIT,1956,5,7,0,12,0.4167,-0.2,2025-08-16 09:41:02
PIT,1957,6,6,0,12,0.5,-0.3,2025-08-16 09:41:02
PIT,1958,7,4,1,12,0.625,-1.7,2025-08-16 09:41:02
PIT,1959,6,5,1,12,0.5417,-2.3,2025-08-16 09:41:02
PIT,1960,5,6,1,12,0.4583,2.2,2025-08-16 09:41:02
PIT,1961,6,8,0,14,0.4286,-2.3,2025-08-16 09:41:02
PIT,1962,9,5,0,14,0.6429,-3.1,2025-08-16 09:41:02
PIT,1963,7,4,3,14,0.6071,1.1,2025-08-16 09:41:02
PIT,1964,5,9,0,14,0.3571,-2.4,2025-08-16 09:41:02
PIT,1965,2,12,0,14,0.1429,-4.4,2025-08-16 09:41:02
PIT,1966,5,8,1,14,0.3929,-2.3,2025-08-16 09:41:02
PIT,1967,4,9,1,14,0.3214,-0.6,2025-08-16 09:41:02
PIT,1968,2,11,1,14,0.1786,0.9,2025-08-16 09:41:02
PIT,1969,1,13,0,14,0.0714,-0.7,2025-08-16 09:41:02
PIT,1970,5,9,0,14,0.3571,-3.0,2025-08-16 09:41:02
PIT,1971,6,8,0,14,0.4286,-0.3,2025-08-16 09:41:02
PIT,1972,11,3,0,14,0.7857,-2.0,2025-08-16 09:41:02
PIT,1973,10,4,0,14,0.7143,-1.6,2025-08-16 09:41:02
PIT,1974,10,3,1,14,0.75,-1.5,2025-08-16 09:41:02
PIT,1975,12,2,0,14,0.8571,-0.9,2025-08-16 09:41:02
PIT,1976,10,4,0,14,0.7143,0.8,2025-08-16 09:41:02
PIT,1977,9,5,0,14,0.6429,3.4,2025-08-16 09:41:02
PIT,1978,14,2,0,16,0.875,-1.9,2025-08-16 09:41:02
PIT,1979,12,4,0,16,0.75,2.3,2025-08-16 09:41:02
PIT,1980,9,7,0,16,0.5625,-0.2,2025-08-16 09:41:02
PIT,1981,8,8,0,16,0.5,-1.0,2025-08-16 09:41:02
PIT,1982,6,3,0,9,0.6667,-1.3,2025-08-16 09:41:02
PIT,1983,10,6,0,16,0.625,-3.3,2025-08-16 09:41:02
PIT,1984,9,7,0,16,0.5625,-1.6,2025-08-16 09:41:02
PIT,1985,7,9,0,16,0.4375,-2.0,2025-08-16 09:41:02
PIT,1986,6,10,0,16,0.375,0.9,2025-08-16 09:41:02
PIT,1987,8,7,0,15,0.5333,1.6,2025-08-16 09:41:02
PIT,1988,5,11,0,16,0.3125,0.0,2025-08-16 09:41:02
PIT,1989,9,7,0,16,0.5625,0.1,2025-08-16 09:41:02
PIT,1990,9,7,0,16,0.5625,-1.6,2025-08-16 09:41:02
PIT,1991,7,9,0,16,0.4375,0.3,2025-08-16 09:41:02
PIT,1992,11,5,0,16,0.6875,-1.0,2025-08-16 09:41:02
PIT,1993,9,7,0,16,0.5625,-0.2,2025-08-16 09:41:02
PIT,1994,12,4,0,16,0.75,-0.4,2025-08-16 09:41:02
PIT,1995,11,5,0,16,0.6875,-0.4,2025-08-16 09:41:02
PIT,1996,10,6,0,16,0.625,-0.3,2025-08-16 09:41:02
PIT,1997,11,5,0,16,0.6875,1.3,2025-08-16 09:41:02
PIT,1998,7,9,0,16,0.4375,-1.3,2025-08-16 09:41:02
PIT,1999,6,10,0,16,0.375,-2.2,2025-08-16 09:41:02
PIT,2000,9,7,0,16,0.5625,-0.2,2025-08-16 09:41:02
PIT,2001,13,3,0,16,0.8125,-1.4,2025-08-16 09:41:02
PIT,2002,10,5,1,16,0.6562,-0.1,2025-08-16 09:41:02
PIT,2003,6,10,0,16,0.375,0.6,2025-08-16 09:41:02
PIT,2004,15,1,0,16,0.9375,1.4,2025-08-16 09:41:02
PIT,2005,11,5,0,16,0.6875,-0.4,2025-08-16 09:41:02
PIT,2006,8,8,0,16,0.5,1.0,2025-08-16 09:41:02
PIT,2007,10,6,0,16,0.625,-2.5,2025-08-16 09:41:02
PIT,2008,12,4,0,16,0.75,2.0,2025-08-16 09:41:02
PIT,2009,9,7,0,16,0.5625,-1.1,2025-08-16 09:41:02
PIT,2010,12,4,0,16,0.75,1.3,2025-08-16 09:41:02
PIT,2011,12,4,0,16,0.75,-0.8,2025-08-16 09:41:02
PIT,2012,8,8,0,16,0.5,-2.0,2025-08-16 09:41:02
PIT,2013,8,8,0,16,0.5,-2.5,2025-08-16 09:41:02
PIT,2014,11,5,0,16,0.6875,-2.0,2025-08-16 09:41:02
PIT,2015,10,6,0,16,0.625,2.2,2025-08-16 09:41:02
PIT,2016,11,5,0,16,0.6875,0.2,2025-08-16 09:41:02
PIT,2017,13,3,0,16,0.8125,-1.1,2025-08-16 09:41:02
PIT,2018,9,6,1,16,0.5938,1.3,2025-08-16 09:41:02
PIT,2019,8,8,0,16,0.5,1.2,2025-08-16 09:41:02
PIT,2020,12,4,0,16,0.75,-1.8,2025-08-16 09:41:02
PIT,2021,9,7,1,17,0.5588,0.8,2025-08-16 09:41:02
PIT,2022,9,8,0,17,0.5294,1.5,2025-08-16 09:41:02
PIT,2023,10,7,0,17,0.5882,1.9,2025-08-16 09:41:02
PIT,2024,10,7,0,17,0.5882,0.1,2025-08-16 09:41:02
PRV,1925,6,5,1,12,0.5417,-2.3,2025-08-16 09:41:02
PRV,1926,5,7,1,13,0.4231,0.7,2025-08-16 09:41:02
PRV,1927,8,5,1,14,0.6071,-2.9,2025-08-16 09:41:02
PRV,1928,8,1,2,11,0.8182,-2.9,2025-08-16 09:41:02
PRV,1929,4,6,2,12,0.4167,-1.2,2025-08-16 09:41:02
PRV,1930,6,4,1,11,0.5909,-3.3,2025-08-16 09:41:02
PRV,1931,4,4,3,11,0.5,-2.6,2025-08-16 09:41:02
PTB,1925,10,2,0,12,0.8333,-5.1,2025-08-16 09:41:02
PTB,1926,10,2,2,14,0.7857,-4.5,2025-08-16 09:41:02
PTB,1927,5,8,0,13,0.3846,-1.5,2025-08-16 09:41:02
PTB,1928,2,8,0,10,0.2,1.3,2025-08-16 09:41:02
PTB,1929,4,4,0,8,0.5,-6.0,2025-08-16 09:41:02
RAC,1922,6,4,1,11,0.5909,-10.7,2025-08-16 09:41:02
RAC,1923,4,4,2,10,0.5,-0.2,2025-08-16 09:41:02
RAC,1924,4,3,3,10,0.55,5.8,2025-08-16 09:41:02
RAC,1926,1,4,0,5,0.2,-1.5,2025-08-16 09:41:02
RAI,1960,6,8,0,14,0.4286,0.6,2025-08-16 09:41:02
RAI,1961,2,12,0,14,0.1429,2.0,2025-08-16 09:41:02
RAI,1962,1,13,0,14,0.0714,1.4,2025-08-16 09:41:02
RAI,1963,10,4,0,14,0.7143,-0.7,2025-08-16 09:41:02
RAI,1964,5,7,2,14,0.4286,0.4,2025-08-16 09:41:02
RAI,1965,8,5,1,14,0.6071,-0.5,2025-08-16 09:41:02
RAI,1966,8,5,1,14,0.6071,-0.8,2025-08-16 09:41:02
RAI,1967,13,1,0,14,0.9286,-1.5,2025-08-16 09:41:02
RAI,1968,12,2,0,14,0.8571,-1.4,2025-08-16 09:41:02
RAI,1969,12,1,1,14,0.8929,-0.6,2025-08-16 09:41:02
RAI,1970,8,4,2,14,0.6429,0.5,2025-08-16 09:41:02
RAI,1971,8,4,2,14,0.6429,-1.0,2025-08-16 09:41:02
RAI,1972,10,3,1,14,0.75,-0.3,2025-08-16 09:41:02
RAI,1973,9,4,1,14,0.6786,-1.7,2025-08-16 09:41:02
RAI,1974,12,2,0,14,0.8571,-0.1,2025-08-16 09:41:02
RAI,1975,11,3,0,14,0.7857,-1.8,2025-08-16 09:41:02
RAI,1976,13,1,0,14,0.9286,0.4,2025-08-16 09:41:02
RAI,1977,11,3,0,14,0.7857,1.7,2025-08-16 09:41:02
RAI,1978,9,7,0,16,0.5625,0.9,2025-08-16 09:41:02
RAI,1979,9,7,0,16,0.5625,2.0,2025-08-16 09:41:02
RAI,1980,11,5,0,16,0.6875,0.6,2025-08-16 09:41:02
RAI,1981,7,9,0,16,0.4375,0.7,2025-08-16 09:41:02
RAI,1982,8,1,0,9,0.8889,-1.5,2025-08-16 09:41:02
RAI,1983,12,4,0,16,0.75,0.3,2025-08-16 09:41:02
RAI,1984,11,5,0,16,0.6875,1.2,2025-08-16 09:41:02
RAI,1985,12,4,0,16,0.75,1.5,2025-08-16 09:41:02
RAI,1986,8,8,0,16,0.5,1.6,2025-08-16 09:41:02
RAI,1987,5,10,0,15,0.3333,-0.8,2025-08-16 09:41:02
RAI,1988,7,9,0,16,0.4375,-0.8,2025-08-16 09:41:02
RAI,1989,8,8,0,16,0.5,0.7,2025-08-16 09:41:02
RAI,1990,12,4,0,16,0.75,2.2,2025-08-16 09:41:02
RAI,1991,9,7,0,16,0.5625,1.3,2025-08-16 09:41:02
RAI,1992,7,9,0,16,0.4375,0.4,2025-08-16 09:41:02
RAI,1993,10,6,0,16,0.625,0.6,2025-08-16 09:41:02
RAI,1994,9,7,0,16,0.5625,-0.1,2025-08-16 09:41:02
RAI,1995,8,8,0,16,0.5,1.1,2025-08-16 09:41:02
RAI,1996,7,9,0,16,0.4375,-0.5,2025-08-16 09:41:02
RAI,1997,4,12,0,16,0.25,0.8,2025-08-16 09:41:02
RAI,1998,8,8,0,16,0.5,-1.4,2025-08-16 09:41:02
RAI,1999,8,8,0,16,0.5,2.9,2025-08-16 09:41:02
RAI,2000,12,4,0,16,0.75,-1.5,2025-08-16 09:41:02
RAI,2001,10,6,0,16,0.625,-0.9,2025-08-16 09:41:02
RAI,2002,11,5,0,16,0.6875,1.5,2025-08-16 09:41:02
RAI,2003,4,12,0,16,0.25,1.3,2025-08-16 09:41:02
RAI,2004,5,11,0,16,0.3125,3.4,2025-08-16 09:41:02
RAI,2005,4,12,0,16,0.25,3.0,2025-08-16 09:41:02
RAI,2006,2,14,0,16,0.125,0.6,2025-08-16 09:41:02
RAI,2007,4,12,0,16,0.25,1.2,2025-08-16 09:41:02
RAI,2008,5,11,0,16,0.3125,0.3,2025-08-16 09:41:02
RAI,2009,5,11,0,16,0.3125,1.1,2025-08-16 09:41:02
RAI,2010,8,8,0,16,0.5,-2.3,2025-08-16 09:41:02
RAI,2011,8,8,0,16,0.5,-0.3,2025-08-16 09:41:02
RAI,2012,4,12,0,16,0.25,-1.3,2025-08-16 09:41:02
RAI,2013,4,12,0,16,0.25,0.2,2025-08-16 09:41:02
RAI,2014,3,13,0,16,0.1875,3.4,2025-08-16 09:41:02
RAI,2015,7,9,0,16,0.4375,2.3,2025-08-16 09:41:02
RAI,2016,12,4,0,16,0.75,1.3,2025-08-16 09:41:02
RAI,2017,6,10,0,16,0.375,-0.2,2025-08-16 09:41:02
RAI,2018,4,12,0,16,0.25,1.8,2025-08-16 09:41:02
RAI,2019,7,9,0,16,0.4375,-0.3,2025-08-16 09:41:02
RAI,2020,8,8,0,16,0.5,0.8,2025-08-16 09:41:02
RAI,2021,10,7,0,17,0.5882,0.6,2025-08-16 09:41:02
RAI,2022,6,11,0,17,0.3529,-1.1,2025-08-16 09:41:02
RAI,2023,8,9,0,17,0.4706,-0.9,2025-08-16 09:41:02
RAI,2024,4,13,0,17,0.2353,1.0,2025-08-16 09:41:02
RAM,1937,1,10,0,11,0.0909,3.5,2025-08-16 09:41:02
RAM,1938,4,7,0,11,0.3636,2.5,2025-08-16 09:41:02
RAM,1939,5,5,1,11,0.5,-0.6,2025-08-16 09:41:02
RAM,1940,4,6,1,11,0.4091,1.5,2025-08-16 09:41:02
RAM,1941,2,9,0,11,0.1818,4.4,2025-08-16 09:41:02
RAM,1942,5,6,0,11,0.4545,0.3,2025-08-16 09:41:02
RAM,1944,4,6,0,10,0.4,1.9,2025-08-16 09:41:02
RAM,1945,9,1,0,10,0.9,0.6,2025-08-16 09:41:02
RAM,1946,6,4,1,11,0.5909,-0.1,2025-08-16 09:41:02
RAM,1947,6,6,0,12,0.5,2.1,2025-08-16 09:41:02
RAM,1948,6,5,1,12,0.5417,1.4,2025-08-16 09:41:02
RAM,1949,8,2,2,12,0.75,-0.8,2025-08-16 09:41:02
RAM,1950,9,3,0,12,0.75,-5.3,2025-08-16 09:41:02
RAM,1951,8,4,0,12,0.6667,-1.8,2025-08-16 09:41:02
RAM,1952,9,3,0,12,0.75,-0.8,2025-08-16 09:41:02
RAM,1953,8,3,1,12,0.7083,-3.3,2025-08-16 09:41:02
RAM,1954,6,5,1,12,0.5417,2.3,2025-08-16 09:41:02
RAM,1955,8,3,1,12,0.7083,-3.8,2025-08-16 09:41:02
RAM,1956,4,8,0,12,0.3333,0.7,2025-08-16 09:41:02
RAM,1957,6,6,0,12,0.5,0.3,2025-08-16 09:41:02
RAM,1958,8,4,0,12,0.6667,0.5,2025-08-16 09:41:02
RAM,1959,2,10,0,12,0.1667,3.0,2025-08-16 09:41:02
RAM,1960,4,7,1,12,0.375,-0.5,2025-08-16 09:41:02
RAM,1961,4,10,0,14,0.2857,3.5,2025-08-16 09:41:02
RAM,1962,1,12,1,14,0.1071,4.1,2025-08-16 09:41:02
RAM,1963,5,9,0,14,0.3571,1.0,2025-08-16 09:41:02
RAM,1964,5,7,2,14,0.4286,3.1,2025-08-16 09:41:02
RAM,1965,4,10,0,14,0.2857,7.1,2025-08-16 09:41:02
RAM,1966,8,6,0,14,0.5714,0.5,2025-08-16 09:41:02
RAM,1967,11,1,2,14,0.8571,-0.9,2025-08-16 09:41:02
RAM,1968,10,3,1,14,0.75,0.7,2025-08-16 09:41:02
RAM,1969,11,3,0,14,0.7857,1.6,2025-08-16 09:41:02
RAM,1970,9,4,1,14,0.6786,0.8,2025-08-16 09:41:02
RAM,1971,8,5,1,14,0.6071,2.8,2025-08-16 09:41:02
RAM,1972,6,7,1,14,0.4643,-0.9,2025-08-16 09:41:02
RAM,1973,12,2,0,14,0.8571,-1.6,2025-08-16 09:41:02
RAM,1974,10,4,0,14,0.7143,-1.9,2025-08-16 09:41:02
RAM,1975,12,2,0,14,0.8571,-3.5,2025-08-16 09:41:02
RAM,1976,10,3,1,14,0.75,-1.0,2025-08-16 09:41:02
RAM,1977,10,4,0,14,0.7143,-2.7,2025-08-16 09:41:02
RAM,1978,12,4,0,16,0.75,-1.2,2025-08-16 09:41:02
RAM,1979,9,7,0,16,0.5625,-1.5,2025-08-16 09:41:02
RAM,1980,11,5,0,16,0.6875,-1.9,2025-08-16 09:41:02
RAM,1981,6,10,0,16,0.375,0.6,2025-08-16 09:41:02
RAM,1982,2,7,0,9,0.2222,-1.4,2025-08-16 09:41:02
RAM,1983,9,7,0,16,0.5625,1.8,2025-08-16 09:41:02
RAM,1984,10,6,0,16,0.625,0.4,2025-08-16 09:41:02
RAM,1985,11,5,0,16,0.6875,-1.3,2025-08-16 09:41:02
RAM,1986,10,6,0,16,0.625,-0.8,2025-08-16 09:41:02
RAM,1987,6,9,0,15,0.4,1.1,2025-08-16 09:41:02
RAM,1988,10,6,0,16,0.625,-0.6,2025-08-16 09:41:02
RAM,1989,11,5,0,16,0.6875,-0.5,2025-08-16 09:41:02
RAM,1990,5,11,0,16,0.3125,-0.1,2025-08-16 09:41:02
RAM,1991,3,13,0,16,0.1875,3.7,2025-08-16 09:41:02
RAM,1992,6,10,0,16,0.375,1.5,2025-08-16 09:41:02
RAM,1993,5,11,0,16,0.3125,0.7,2025-08-16 09:41:02
RAM,1994,4,12,0,16,0.25,-0.3,2025-08-16 09:41:02
RAM,1995,7,9,0,16,0.4375,0.4,2025-08-16 09:41:02
RAM,1996,6,10,0,16,0.375,0.3,2025-08-16 09:41:02
RAM,1997,5,11,0,16,0.3125,-0.2,2025-08-16 09:41:02
RAM,1998,4,12,0,16,0.25,3.5,2025-08-16 09:41:02
RAM,1999,13,3,0,16,0.8125,-5.9,2025-08-16 09:41:02
RAM,2000,10,6,0,16,0.625,-1.2,2025-08-16 09:41:02
RAM,2001,14,2,0,16,0.875,-1.0,2025-08-16 09:41:02
RAM,2002,7,9,0,16,0.4375,0.0,2025-08-16 09:41:02
RAM,2003,12,4,0,16,0.75,-1.6,2025-08-16 09:41:02
RAM,2004,8,8,0,16,0.5,-1.4,2025-08-16 09:41:02
RAM,2005,6,10,0,16,0.375,-1.0,2025-08-16 09:41:02
RAM,2006,8,8,0,16,0.5,-3.1,2025-08-16 09:41:02
RAM,2007,3,13,0,16,0.1875,-2.0,2025-08-16 09:41:02
RAM,2008,2,14,0,16,0.125,-0.5,2025-08-16 09:41:02
RAM,2009,1,15,0,16,0.0625,-1.1,2025-08-16 09:41:02
RAM,2010,7,9,0,16,0.4375,-4.2,2025-08-16 09:41:02
RAM,2011,2,14,0,16,0.125,2.9,2025-08-16 09:41:02
RAM,2012,7,8,1,16,0.4688,3.4,2025-08-16 09:41:02
RAM,2013,7,9,0,16,0.4375,3.2,2025-08-16 09:41:02
RAM,2014,6,10,0,16,0.375,1.0,2025-08-16 09:41:02
RAM,2015,7,9,0,16,0.4375,3.0,2025-08-16 09:41:02
RAM,2016,4,12,0,16,0.25,-0.5,2025-08-16 09:41:02
RAM,2017,11,5,0,16,0.6875,-0.2,2025-08-16 09:41:02
RAM,2018,13,3,0,16,0.8125,-0.4,2025-08-16 09:41:02
RAM,2019,9,7,0,16,0.5625,2.0,2025-08-16 09:41:02
RAM,2020,10,6,0,16,0.625,0.7,2025-08-16 09:41:02
RAM,2021,12,5,0,17,0.7059,0.1,2025-08-16 09:41:02
RAM,2022,5,12,0,17,0.2941,0.5,2025-08-16 09:41:02
RAM,2023,10,7,0,17,0.5882,1.4,2025-08-16 09:41:02
RAM,2024,10,7,0,17,0.5882,1.1,2025-08-16 09:41:02
RAV,1996,4,12,0,16,0.25,1.4,2025-08-16 09:41:02
RAV,1997,6,9,1,16,0.4062,0.6,2025-08-16 09:41:02
RAV,1998,6,10,0,16,0.375,-1.3,2025-08-16 09:41:02
RAV,1999,8,8,0,16,0.5,-2.0,2025-08-16 09:41:02
RAV,2000,12,4,0,16,0.75,-2.5,2025-08-16 09:41:02
RAV,2001,10,6,0,16,0.625,0.8,2025-08-16 09:41:02
RAV,2002,7,9,0,16,0.4375,0.3,2025-08-16 09:41:02
RAV,2003,10,6,0,16,0.625,-0.6,2025-08-16 09:41:02
RAV,2004,9,7,0,16,0.5625,3.1,2025-08-16 09:41:02
RAV,2005,6,10,0,16,0.375,0.3,2025-08-16 09:41:02
RAV,2006,13,3,0,16,0.8125,-0.2,2025-08-16 09:41:02
RAV,2007,5,11,0,16,0.3125,0.1,2025-08-16 09:41:02
RAV,2008,11,5,0,16,0.6875,1.0,2025-08-16 09:41:02
RAV,2009,9,7,0,16,0.5625,-0.7,2025-08-16 09:41:02
RAV,2010,12,4,0,16,0.75,1.0,2025-08-16 09:41:02
RAV,2011,12,4,0,16,0.75,-0.9,2025-08-16 09:41:02
RAV,2012,10,6,0,16,0.625,-0.5,2025-08-16 09:41:02
RAV,2013,8,8,0,16,0.5,-1.5,2025-08-16 09:41:02
RAV,2014,10,6,0,16,0.625,-2.1,2025-08-16 09:41:02
RAV,2015,5,11,0,16,0.3125,2.6,2025-08-16 09:41:02
RAV,2016,8,8,0,16,0.5,0.2,2025-08-16 09:41:02
RAV,2017,9,7,0,16,0.5625,-2.4,2025-08-16 09:41:02
RAV,2018,10,6,0,16,0.625,0.6,2025-08-16 09:41:02
RAV,2019,14,2,0,16,0.875,0.1,2025-08-16 09:41:02
RAV,2020,11,5,0,16,0.6875,-2.0,2025-08-16 09:41:02
RAV,2021,8,9,0,17,0.4706,0.0,2025-08-16 09:41:02
RAV,2022,10,7,0,17,0.5882,1.1,2025-08-16 09:41:02
RAV,2023,13,4,0,17,0.7647,1.2,2025-08-16 09:41:02
RAV,2024,12,5,0,17,0.7059,0.6,2025-08-16 09:41:02
RCH,1920,6,3,2,11,0.6364,-19.3,2025-08-16 09:41:02
RCH,1921,2,3,0,5,0.4,-3.4,2025-08-16 09:41:02
RCH,1922,0,4,1,5,0.1,11.8,2025-08-16 09:41:02
RCH,1923,0,4,0,4,0.0,-0.3,2025-08-16 09:41:02
RCH,1924,0,7,0,7,0.0,0.1,2025-08-16 09:41:02
RCH,1925,0,6,1,7,0.0714,8.6,2025-08-16 09:41:02
RED,1933,3,6,1,10,0.35,-4.4,2025-08-16 09:41:02
RED,1934,0,8,0,8,0.0,4.5,2025-08-16 09:41:02
RII,1920,6,2,2,10,0.7,-20.2,2025-08-16 09:41:02
RII,1921,4,2,1,7,0.6429,3.0,2025-08-16 09:41:02
RII,1922,4,2,1,7,0.6429,-5.6,2025-08-16 09:41:02
RII,1923,2,3,3,8,0.4375,-4.7,2025-08-16 09:41:02
RII,1924,5,2,2,9,0.6667,0.2,2025-08-16 09:41:02
RII,1925,5,3,3,11,0.5909,-1.9,2025-08-16 09:41:02
SDG,1960,10,4,0,14,0.7143,-0.3,2025-08-16 09:41:02
SDG,1961,12,2,0,14,0.8571,-1.6,2025-08-16 09:41:02
SDG,1962,4,10,0,14,0.2857,0.7,2025-08-16 09:41:02
SDG,1963,11,3,0,14,0.7857,-1.3,2025-08-16 09:41:02
SDG,1964,8,5,1,14,0.6071,-0.4,2025-08-16 09:41:02
SDG,1965,9,2,3,14,0.75,-1.0,2025-08-16 09:41:02
SDG,1966,7,6,1,14,0.5357,0.5,2025-08-16 09:41:02
SDG,1967,8,5,1,14,0.6071,-0.2,2025-08-16 09:41:02
SDG,1968,9,5,0,14,0.6429,1.0,2025-08-16 09:41:02
SDG,1969,8,6,0,14,0.5714,0.7,2025-08-16 09:41:02
SDG,1970,5,6,3,14,0.4643,-1.0,2025-08-16 09:41:02
SDG,1971,6,8,0,14,0.4286,-1.9,2025-08-16 09:41:02
SDG,1972,4,9,1,14,0.3214,2.9,2025-08-16 09:41:02
SDG,1973,2,11,1,14,0.1786,2.1,2025-08-16 09:41:02
SDG,1974,5,9,0,14,0.3571,0.4,2025-08-16 09:41:02
SDG,1975,2,12,0,14,0.1429,1.7,2025-08-16 09:41:02
SDG,1976,6,8,0,14,0.4286,1.5,2025-08-16 09:41:02
SDG,1977,7,7,0,14,0.5,2.5,2025-08-16 09:41:02
SDG,1978,9,7,0,16,0.5625,0.7,2025-08-16 09:41:02
SDG,1979,12,4,0,16,0.75,1.5,2025-08-16 09:41:02
SDG,1980,11,5,0,16,0.6875,0.4,2025-08-16 09:41:02
SDG,1981,10,6,0,16,0.625,-1.1,2025-08-16 09:41:02
SDG,1982,6,3,0,9,0.6667,-2.1,2025-08-16 09:41:02
SDG,1983,6,10,0,16,0.375,1.9,2025-08-16 09:41:02
SDG,1984,7,9,0,16,0.4375,2.0,2025-08-16 09:41:02
SDG,1985,8,8,0,16,0.5,-0.9,2025-08-16 09:41:02
SDG,1986,4,12,0,16,0.25,1.9,2025-08-16 09:41:02
SDG,1987,8,7,0,15,0.5333,0.5,2025-08-16 09:41:02
SDG,1988,6,10,0,16,0.375,-1.1,2025-08-16 09:41:02
SDG,1989,6,10,0,16,0.375,0.8,2025-08-16 09:41:02
SDG,1990,6,10,0,16,0.375,0.2,2025-08-16 09:41:02
SDG,1991,4,12,0,16,0.25,2.0,2025-08-16 09:41:02
SDG,1992,11,5,0,16,0.6875,-2.8,2025-08-16 09:41:02
SDG,1993,8,8,0,16,0.5,0.3,2025-08-16 09:41:02
SDG,1994,11,5,0,16,0.6875,-1.1,2025-08-16 09:41:02
SDG,1995,9,7,0,16,0.5625,1.6,2025-08-16 09:41:02
SDG,1996,8,8,0,16,0.5,2.4,2025-08-16 09:41:02
SDG,1997,4,12,0,16,0.25,1.0,2025-08-16 09:41:02
SDG,1998,5,11,0,16,0.3125,-2.1,2025-08-16 09:41:02
SDG,1999,8,8,0,16,0.5,2.0,2025-08-16 09:41:02
SDG,2000,1,15,0,16,0.0625,2.6,2025-08-16 09:41:02
SDG,2001,5,11,0,16,0.3125,-1.0,2025-08-16 09:41:02
SDG,2002,8,8,0,16,0.5,1.4,2025-08-16 09:41:02
SDG,2003,4,12,0,16,0.25,1.2,2025-08-16 09:41:02
SDG,2004,12,4,0,16,0.75,0.8,2025-08-16 09:41:02
SDG,2005,9,7,0,16,0.5625,3.3,2025-08-16 09:41:02
SDG,2006,14,2,0,16,0.875,-1.6,2025-08-16 09:41:02
SDG,2007,11,5,0,16,0.6875,0.8,2025-08-16 09:41:02
SDG,2008,8,8,0,16,0.5,-0.8,2025-08-16 09:41:02
SDG,2009,13,3,0,16,0.8125,-1.7,2025-08-16 09:41:02
SDG,2010,9,7,0,16,0.5625,-2.6,2025-08-16 09:41:02
SDG,2011,8,8,0,16,0.5,-0.9,2025-08-16 09:41:02
SDG,2012,7,9,0,16,0.4375,-2.3,2025-08-16 09:41:02
SDG,2013,9,7,0,16,0.5625,-0.3,2025-08-16 09:41:02
SDG,2014,9,7,0,16,0.5625,1.9,2025-08-16 09:41:02
SDG,2015,4,12,0,16,0.25,2.2,2025-08-16 09:41:02
SDG,2016,5,11,0,16,0.3125,0.9,2025-08-16 09:41:02
SDG,2017,9,7,0,16,0.5625,-1.5,2025-08-16 09:41:02
SDG,2018,12,4,0,16,0.75,-0.2,2025-08-16 09:41:02
SDG,2019,5,11,0,16,0.3125,-0.8,2025-08-16 09:41:02
SDG,2020,7,9,0,16,0.4375,-0.3,2025-08-16 09:41:02
SDG,2021,9,8,0,17,0.5294,0.2,2025-08-16 09:41:02
SDG,2022,10,7,0,17,0.5882,-1.3,2025-08-16 09:41:02
SDG,2023,5,12,0,17,0.2941,0.9,2025-08-16 09:41:02
SDG,2024,11,6,0,17,0.6471,-0.6,2025-08-16 09:41:02
SEA,1976,2,12,0,14,0.1429,-0.8,2025-08-16 09:41:02
SEA,1977,5,9,0,14,0.3571,2.2,2025-08-16 09:41:02
SEA,1978,9,7,0,16,0.5625,0.5,2025-08-16 09:41:02
SEA,1979,9,7,0,16,0.5625,2.2,2025-08-16 09:41:02
SEA,1980,4,12,0,16,0.25,2.0,2025-08-16 09:41:02
SEA,1981,6,10,0,16,0.375,0.8,2025-08-16 09:41:02
SEA,1982,4,5,0,9,0.4444,-3.2,2025-08-16 09:41:02
SEA,1983,9,7,0,16,0.5625,1.1,2025-08-16 09:41:02
SEA,1984,12,4,0,16,0.75,0.5,2025-08-16 09:41:02
SEA,1985,8,8,0,16,0.5,1.5,2025-08-16 09:41:02
SEA,1986,10,6,0,16,0.625,1.8,2025-08-16 09:41:02
SEA,1987,9,6,0,15,0.6,-1.9,2025-08-16 09:41:02
SEA,1988,9,7,0,16,0.5625,-1.4,2025-08-16 09:41:02
SEA,1989,7,9,0,16,0.4375,2.6,2025-08-16 09:41:02
SEA,1990,9,7,0,16,0.5625,1.5,2025-08-16 09:41:02
SEA,1991,7,9,0,16,0.4375,0.2,2025-08-16 09:41:02
SEA,1992,2,14,0,16,0.125,0.8,2025-08-16 09:41:02
SEA,1993,6,10,0,16,0.375,0.9,2025-08-16 09:41:02
SEA,1994,6,10,0,16,0.375,-1.2,2025-08-16 09:41:02
SEA,1995,8,8,0,16,0.5,-0.4,2025-08-16 09:41:02
SEA,1996,7,9,0,16,0.4375,2.0,2025-08-16 09:41:02
SEA,1997,8,8,0,16,0.5,0.0,2025-08-16 09:41:02
SEA,1998,8,8,0,16,0.5,-2.4,2025-08-16 09:41:02
SEA,1999,9,7,0,16,0.5625,2.0,2025-08-16 09:41:02
SEA,2000,6,10,0,16,0.375,1.6,2025-08-16 09:41:02
SEA,2001,9,7,0,16,0.5625,-0.4,2025-08-16 09:41:02
SEA,2002,7,9,0,16,0.4375,-0.4,2025-08-16 09:41:02
SEA,2003,10,6,0,16,0.625,-0.7,2025-08-16 09:41:02
SEA,2004,9,7,0,16,0.5625,-2.8,2025-08-16 09:41:02
SEA,2005,13,3,0,16,0.8125,-2.2,2025-08-16 09:41:02
SEA,2006,9,7,0,16,0.5625,-3.2,2025-08-16 09:41:02
SEA,2007,10,6,0,16,0.625,-4.6,2025-08-16 09:41:02
SEA,2008,4,12,0,16,0.25,-1.5,2025-08-16 09:41:02
SEA,2009,5,11,0,16,0.3125,-2.4,2025-08-16 09:41:02
SEA,2010,7,9,0,16,0.4375,-3.4,2025-08-16 09:41:02
SEA,2011,7,9,0,16,0.4375,0.4,2025-08-16 09:41:02
SEA,2012,11,5,0,16,0.6875,1.8,2025-08-16 09:41:02
SEA,2013,13,3,0,16,0.8125,1.4,2025-08-16 09:41:02
SEA,2014,12,4,0,16,0.75,0.8,2025-08-16 09:41:02
SEA,2015,10,6,0,16,0.625,2.2,2025-08-16 09:41:02
SEA,2016,10,5,1,16,0.6562,-1.7,2025-08-16 09:41:02
SEA,2017,9,7,0,16,0.5625,-0.2,2025-08-16 09:41:02
SEA,2018,10,6,0,16,0.625,-0.6,2025-08-16 09:41:02
SEA,2019,11,5,0,16,0.6875,2.3,2025-08-16 09:41:02
SEA,2020,12,4,0,16,0.75,0.0,2025-08-16 09:41:02
SEA,2021,7,10,0,17,0.4118,0.2,2025-08-16 09:41:02
SEA,2022,9,8,0,17,0.5294,-0.8,2025-08-16 09:41:02
SEA,2023,9,8,0,17,0.5294,1.3,2025-08-16 09:41:02
SEA,2024,10,7,0,17,0.5882,0.8,2025-08-16 09:41:02
SEN,1921,1,2,0,3,0.3333,0.4,2025-08-16 09:41:02
SFO,1946,9,5,0,14,0.6429,-1.1,2025-08-16 09:41:02
SFO,1947,8,4,2,14,0.6429,-0.6,2025-08-16 09:41:02
SFO,1948,12,2,0,14,0.8571,-2.2,2025-08-16 09:41:02
SFO,1949,9,3,0,12,0.75,-2.3,2025-08-16 09:41:02
SFO,1950,3,9,0,12,0.25,-2.2,2025-08-16 09:41:02
SFO,1951,7,4,1,12,0.625,0.1,2025-08-16 09:41:02
SFO,1952,7,5,0,12,0.5833,-0.9,2025-08-16 09:41:02
SFO,1953,9,3,0,12,0.75,-0.5,2025-08-16 09:41:02
SFO,1954,7,4,1,12,0.625,0.9,2025-08-16 09:41:02
SFO,1955,4,8,0,12,0.3333,-1.4,2025-08-16 09:41:02
SFO,1956,5,6,1,12,0.4583,1.6,2025-08-16 09:41:02
SFO,1957,8,4,0,12,0.6667,0.1,2025-08-16 09:41:02
SFO,1958,6,6,0,12,0.5,1.8,2025-08-16 09:41:02
SFO,1959,7,5,0,12,0.5833,1.7,2025-08-16 09:41:02
SFO,1960,7,5,0,12,0.5833,-1.1,2025-08-16 09:41:02
SFO,1961,7,6,1,14,0.5357,0.8,2025-08-16 09:41:02
SFO,1962,6,8,0,14,0.4286,3.8,2025-08-16 09:41:02
SFO,1963,2,12,0,14,0.1429,2.0,2025-08-16 09:41:02
SFO,1964,4,10,0,14,0.2857,3.9,2025-08-16 09:41:02
SFO,1965,7,6,1,14,0.5357,5.8,2025-08-16 09:41:02
SFO,1966,6,6,2,14,0.5,2.1,2025-08-16 09:41:02
SFO,1967,7,7,0,14,0.5,1.5,2025-08-16 09:41:02
SFO,1968,7,6,1,14,0.5357,1.8,2025-08-16 09:41:02
SFO,1969,4,8,2,14,0.3571,2.7,2025-08-16 09:41:02
SFO,1970,10,3,1,14,0.75,0.4,2025-08-16 09:41:02
SFO,1971,9,5,0,14,0.6429,0.3,2025-08-16 09:41:02
SFO,1972,8,5,1,14,0.6071,-1.0,2025-08-16 09:41:02
SFO,1973,5,9,0,14,0.3571,3.9,2025-08-16 09:41:02
SFO,1974,6,8,0,14,0.4286,-1.8,2025-08-16 09:41:02
SFO,1975,5,9,0,14,0.3571,-2.5,2025-08-16 09:41:02
SFO,1976,8,6,0,14,0.5714,-1.9,2025-08-16 09:41:02
SFO,1977,5,9,0,14,0.3571,-0.9,2025-08-16 09:41:02
SFO,1978,2,14,0,16,0.125,-0.9,2025-08-16 09:41:02
SFO,1979,2,14,0,16,0.125,-0.7,2025-08-16 09:41:02
SFO,1980,6,10,0,16,0.375,-0.3,2025-08-16 09:41:02
SFO,1981,13,3,0,16,0.8125,-0.5,2025-08-16 09:41:02
SFO,1982,3,6,0,9,0.3333,-2.8,2025-08-16 09:41:02
SFO,1983,10,6,0,16,0.625,0.0,2025-08-16 09:41:02
SFO,1984,15,1,0,16,0.9375,-2.8,2025-08-16 09:41:02
SFO,1985,10,6,0,16,0.625,-0.5,2025-08-16 09:41:02
SFO,1986,10,5,1,16,0.6562,-0.9,2025-08-16 09:41:02
SFO,1987,13,2,0,15,0.8667,-0.4,2025-08-16 09:41:02
SFO,1988,10,6,0,16,0.625,0.1,2025-08-16 09:41:02
SFO,1989,14,2,0,16,0.875,-1.1,2025-08-16 09:41:02
SFO,1990,14,2,0,16,0.875,-1.4,2025-08-16 09:41:02
SFO,1991,10,6,0,16,0.625,1.2,2025-08-16 09:41:02
SFO,1992,14,2,0,16,0.875,-0.4,2025-08-16 09:41:02
SFO,1993,10,6,0,16,0.625,-1.5,2025-08-16 09:41:02
SFO,1994,13,3,0,16,0.8125,-1.4,2025-08-16 09:41:02
SFO,1995,11,5,0,16,0.6875,-0.7,2025-08-16 09:41:02
SFO,1996,12,4,0,16,0.75,-0.8,2025-08-16 09:41:02
SFO,1997,13,3,0,16,0.8125,-1.8,2025-08-16 09:41:02
SFO,1998,12,4,0,16,0.75,1.2,2025-08-16 09:41:02
SFO,1999,4,12,0,16,0.25,-1.5,2025-08-16 09:41:02
SFO,2000,6,10,0,16,0.375,-1.7,2025-08-16 09:41:02
SFO,2001,12,4,0,16,0.75,-1.1,2025-08-16 09:41:02
SFO,2002,10,6,0,16,0.625,-0.4,2025-08-16 09:41:02
SFO,2003,7,9,0,16,0.4375,0.1,2025-08-16 09:41:02
SFO,2004,2,14,0,16,0.125,-1.6,2025-08-16 09:41:02
SFO,2005,4,12,0,16,0.25,0.7,2025-08-16 09:41:02
SFO,2006,7,9,0,16,0.4375,-1.6,2025-08-16 09:41:02
SFO,2007,5,11,0,16,0.3125,-2.9,2025-08-16 09:41:02
SFO,2008,7,9,0,16,0.4375,-2.7,2025-08-16 09:41:02
SFO,2009,8,8,0,16,0.5,-3.0,2025-08-16 09:41:02
SFO,2010,6,10,0,16,0.375,-3.3,2025-08-16 09:41:02
SFO,2011,13,3,0,16,0.8125,-1.1,2025-08-16 09:41:02
SFO,2012,11,4,1,16,0.7188,2.5,2025-08-16 09:41:02
SFO,2013,12,4,0,16,0.75,1.8,2025-08-16 09:41:02
SFO,2014,8,8,0,16,0.5,1.2,2025-08-16 09:41:02
SFO,2015,5,11,0,16,0.3125,3.8,2025-08-16 09:41:02
SFO,2016,2,14,0,16,0.125,-0.5,2025-08-16 09:41:02
SFO,2017,6,10,0,16,0.375,0.4,2025-08-16 09:41:02
SFO,2018,4,12,0,16,0.25,0.3,2025-08-16 09:41:02
SFO,2019,13,3,0,16,0.8125,0.4,2025-08-16 09:41:02
SFO,2020,6,10,0,16,0.375,1.7,2025-08-16 09:41:02
SFO,2021,10,7,0,17,0.5882,0.1,2025-08-16 09:41:02
SFO,2022,13,4,0,17,0.7647,-2.3,2025-08-16 09:41:02
SFO,2023,12,5,0,17,0.7059,0.4,2025-08-16 09:41:02
SFO,2024,6,11,0,17,0.3529,1.6,2025-08-16 09:41:02
SIS,1929,3,4,3,10,0.45,-2.0,2025-08-16 09:41:02
SIS,1930,5,5,2,12,0.5,-1.4,2025-08-16 09:41:02
SIS,1931,4,6,1,11,0.4091,-1.9,2025-08-16 09:41:02
SIS,1932,2,7,3,12,0.2917,0.7,2025-08-16 09:41:02
SLA,1923,1,4,2,7,0.2857,-0.8,2025-08-16 09:41:02
TAM,1976,0,14,0,14,0.0,0.8,2025-08-16 09:41:02
TAM,1977,2,12,0,14,0.1429,-2.2,2025-08-16 09:41:02
TAM,1978,5,11,0,16,0.3125,-2.2,2025-08-16 09:41:02
TAM,1979,10,6,0,16,0.625,-5.1,2025-08-16 09:41:02
TAM,1980,5,10,1,16,0.3438,-0.7,2025-08-16 09:41:02
TAM,1981,9,7,0,16,0.5625,0.1,2025-08-16 09:41:02
TAM,1982,5,4,0,9,0.5556,3.1,2025-08-16 09:41:02
TAM,1983,2,14,0,16,0.125,-0.3,2025-08-16 09:41:02
TAM,1984,6,10,0,16,0.375,-0.7,2025-08-16 09:41:02
TAM,1985,2,14,0,16,0.125,2.2,2025-08-16 09:41:02
TAM,1986,2,14,0,16,0.125,-0.8,2025-08-16 09:41:02
TAM,1987,4,11,0,15,0.2667,-0.8,2025-08-16 09:41:02
TAM,1988,5,11,0,16,0.3125,1.5,2025-08-16 09:41:02
TAM,1989,5,11,0,16,0.3125,1.1,2025-08-16 09:41:02
TAM,1990,6,10,0,16,0.375,-0.7,2025-08-16 09:41:02
TAM,1991,3,13,0,16,0.1875,-0.8,2025-08-16 09:41:02
TAM,1992,5,11,0,16,0.3125,0.3,2025-08-16 09:41:02
TAM,1993,5,11,0,16,0.3125,1.1,2025-08-16 09:41:02
TAM,1994,6,10,0,16,0.375,0.0,2025-08-16 09:41:02
TAM,1995,7,9,0,16,0.4375,1.1,2025-08-16 09:41:02
TAM,1996,6,10,0,16,0.375,1.5,2025-08-16 09:41:02
TAM,1997,10,6,0,16,0.625,0.5,2025-08-16 09:41:02
TAM,1998,8,8,0,16,0.5,0.1,2025-08-16 09:41:02
TAM,1999,11,5,0,16,0.6875,0.4,2025-08-16 09:41:02
TAM,2000,10,6,0,16,0.625,-0.1,2025-08-16 09:41:02
TAM,2001,9,7,0,16,0.5625,1.3,2025-08-16 09:41:02
TAM,2002,12,4,0,16,0.75,-0.6,2025-08-16 09:41:02
TAM,2003,7,9,0,16,0.4375,-0.7,2025-08-16 09:41:02
TAM,2004,5,11,0,16,0.3125,-2.5,2025-08-16 09:41:02
TAM,2005,11,5,0,16,0.6875,-2.6,2025-08-16 09:41:02
TAM,2006,4,12,0,16,0.25,0.9,2025-08-16 09:41:02
TAM,2007,9,7,0,16,0.5625,-2.8,2025-08-16 09:41:02
TAM,2008,9,7,0,16,0.5625,-0.1,2025-08-16 09:41:02
TAM,2009,3,13,0,16,0.1875,4.1,2025-08-16 09:41:02
TAM,2010,10,6,0,16,0.625,-2.0,2025-08-16 09:41:02
TAM,2011,4,12,0,16,0.25,2.3,2025-08-16 09:41:02
TAM,2012,7,9,0,16,0.4375,0.3,2025-08-16 09:41:02
TAM,2013,4,12,0,16,0.25,3.6,2025-08-16 09:41:02
TAM,2014,2,14,0,16,0.125,-1.5,2025-08-16 09:41:02
TAM,2015,6,10,0,16,0.375,-3.0,2025-08-16 09:41:02
TAM,2016,9,7,0,16,0.5625,0.7,2025-08-16 09:41:02
TAM,2017,5,11,0,16,0.3125,1.7,2025-08-16 09:41:02
TAM,2018,5,11,0,16,0.3125,1.7,2025-08-16 09:41:02
TAM,2019,7,9,0,16,0.4375,-0.2,2025-08-16 09:41:02
TAM,2020,11,5,0,16,0.6875,0.8,2025-08-16 09:41:02
TAM,2021,13,4,0,17,0.7647,-0.7,2025-08-16 09:41:02
TAM,2022,8,9,0,17,0.4706,0.4,2025-08-16 09:41:02
TAM,2023,9,8,0,17,0.5294,-0.3,2025-08-16 09:41:02
TAM,2024,10,7,0,17,0.5882,-0.4,2025-08-16 09:41:02
TOL,1922,5,2,2,9,0.6667,-8.9,2025-08-16 09:41:02
TOL,1923,3,3,2,8,0.5,-0.7,2025-08-16 09:41:02
TON,1921,0,1,0,1,0.0,6.5,2025-08-16 09:41:02
TOR,1929,3,5,4,12,0.4167,2.5,2025-08-16 09:41:02
TOR,1930,1,10,1,12,0.125,0.0,2025-08-16 09:41:02
WAS,1932,4,4,2,10,0.5,-1.6,2025-08-16 09:41:02
WAS,1933,5,5,2,12,0.5,1.4,2025-08-16 09:41:02
WAS,1934,6,6,0,12,0.5,-0.8,2025-08-16 09:41:02
WAS,1935,2,8,1,11,0.2273,-0.8,2025-08-16 09:41:02
WAS,1936,7,5,0,12,0.5833,-3.0,2025-08-16 09:41:02
WAS,1937,8,3,0,11,0.7273,-3.8,2025-08-16 09:41:02
WAS,1938,6,3,2,11,0.6364,-0.5,2025-08-16 09:41:02
WAS,1939,8,2,1,11,0.7727,-4.5,2025-08-16 09:41:02
WAS,1940,9,2,0,11,0.8182,-2.9,2025-08-16 09:41:02
WAS,1941,6,5,0,11,0.5455,-1.5,2025-08-16 09:41:02
WAS,1942,10,1,0,11,0.9091,-3.8,2025-08-16 09:41:02
WAS,1943,6,3,1,10,0.65,-2.6,2025-08-16 09:41:02
WAS,1944,6,3,1,10,0.65,-1.7,2025-08-16 09:41:02
WAS,1945,8,2,0,10,0.8,-4.8,2025-08-16 09:41:02
WAS,1946,5,5,1,11,0.5,-0.3,2025-08-16 09:41:02
WAS,1947,4,8,0,12,0.3333,-1.7,2025-08-16 09:41:02
WAS,1948,7,5,0,12,0.5833,-2.0,2025-08-16 09:41:02
WAS,1949,4,7,1,12,0.375,0.4,2025-08-16 09:41:02
WAS,1950,3,9,0,12,0.25,2.8,2025-08-16 09:41:02
WAS,1951,5,7,0,12,0.4167,1.6,2025-08-16 09:41:02
WAS,1952,4,8,0,12,0.3333,1.1,2025-08-16 09:41:02
WAS,1953,6,5,1,12,0.5417,-0.4,2025-08-16 09:41:02
WAS,1954,3,9,0,12,0.25,-0.9,2025-08-16 09:41:02
WAS,1955,8,4,0,12,0.6667,2.3,2025-08-16 09:41:02
WAS,1956,6,6,0,12,0.5,-0.2,2025-08-16 09:41:02
WAS,1957,5,6,1,12,0.4583,-0.3,2025-08-16 09:41:02
WAS,1958,4,7,1,12,0.375,-0.7,2025-08-16 09:41:02
WAS,1959,3,9,0,12,0.25,0.9,2025-08-16 09:41:02
WAS,1960,1,9,2,12,0.1667,2.9,2025-08-16 09:41:02
WAS,1961,1,12,1,14,0.1071,-0.1,2025-08-16 09:41:02
WAS,1962,5,7,2,14,0.4286,-3.3,2025-08-16 09:41:02
WAS,1963,3,11,0,14,0.2143,0.7,2025-08-16 09:41:02
WAS,1964,6,8,0,14,0.4286,-2.6,2025-08-16 09:41:02
WAS,1965,6,8,0,14,0.4286,-5.8,2025-08-16 09:41:02
WAS,1966,7,7,0,14,0.5,-1.8,2025-08-16 09:41:02
WAS,1967,5,6,3,14,0.4643,-1.7,2025-08-16 09:41:02
WAS,1968,5,9,0,14,0.3571,-0.5,2025-08-16 09:41:02
WAS,1969,7,5,2,14,0.5714,-2.1,2025-08-16 09:41:02
WAS,1970,6,8,0,14,0.4286,4.2,2025-08-16 09:41:02
WAS,1971,9,4,1,14,0.6786,-1.0,2025-08-16 09:41:02
WAS,1972,11,3,0,14,0.7857,-2.1,2025-08-16 09:41:02
WAS,1973,10,4,0,14,0.7143,-1.7,2025-08-16 09:41:02
WAS,1974,10,4,0,14,0.7143,1.4,2025-08-16 09:41:02
WAS,1975,8,6,0,14,0.5714,-0.7,2025-08-16 09:41:02
WAS,1976,10,4,0,14,0.7143,-2.3,2025-08-16 09:41:02
WAS,1977,9,5,0,14,0.6429,-1.0,2025-08-16 09:41:02
WAS,1978,8,8,0,16,0.5,0.2,2025-08-16 09:41:02
WAS,1979,10,6,0,16,0.625,-0.8,2025-08-16 09:41:02
WAS,1980,6,10,0,16,0.375,0.9,2025-08-16 09:41:02
WAS,1981,8,8,0,16,0.5,1.1,2025-08-16 09:41:02
WAS,1982,8,1,0,9,0.8889,0.5,2025-08-16 09:41:02
WAS,1983,14,2,0,16,0.875,0.9,2025-08-16 09:41:02
WAS,1984,11,5,0,16,0.6875,-0.9,2025-08-16 09:41:02
WAS,1985,10,6,0,16,0.625,-1.0,2025-08-16 09:41:02
WAS,1986,12,4,0,16,0.75,1.0,2025-08-16 09:41:02
WAS,1987,11,4,0,15,0.7333,-2.5,2025-08-16 09:41:02
WAS,1988,7,9,0,16,0.4375,0.4,2025-08-16 09:41:02
WAS,1989,10,6,0,16,0.625,-0.9,2025-08-16 09:41:02
WAS,1990,10,6,0,16,0.625,0.4,2025-08-16 09:41:02
WAS,1991,14,2,0,16,0.875,0.3,2025-08-16 09:41:02
WAS,1992,9,7,0,16,0.5625,1.6,2025-08-16 09:41:02
WAS,1993,4,12,0,16,0.25,0.7,2025-08-16 09:41:02
WAS,1994,3,13,0,16,0.1875,-0.3,2025-08-16 09:41:02
WAS,1995,6,10,0,16,0.375,0.1,2025-08-16 09:41:02
WAS,1996,9,7,0,16,0.5625,-1.4,2025-08-16 09:41:02
WAS,1997,8,7,1,16,0.5312,-1.1,2025-08-16 09:41:02
WAS,1998,6,10,0,16,0.375,-1.1,2025-08-16 09:41:02
WAS,1999,10,6,0,16,0.625,-1.3,2025-08-16 09:41:02
WAS,2000,8,8,0,16,0.5,0.2,2025-08-16 09:41:02
WAS,2001,8,8,0,16,0.5,-0.7,2025-08-16 09:41:02
WAS,2002,7,9,0,16,0.4375,-0.8,2025-08-16 09:41:02
WAS,2003,5,11,0,16,0.3125,-0.4,2025-08-16 09:41:02
WAS,2004,6,10,0,16,0.375,-1.8,2025-08-16 09:41:02
WAS,2005,10,6,0,16,0.625,1.9,2025-08-16 09:41:02
WAS,2006,5,11,0,16,0.3125,0.3,2025-08-16 09:41:02
WAS,2007,9,7,0,16,0.5625,3.0,2025-08-16 09:41:02
WAS,2008,8,8,0,16,0.5,0.2,2025-08-16 09:41:02
WAS,2009,4,12,0,16,0.25,-0.2,2025-08-16 09:41:02
WAS,2010,6,10,0,16,0.375,0.9,2025-08-16 09:41:02
WAS,2011,5,11,0,16,0.3125,0.8,2025-08-16 09:41:02
WAS,2012,10,6,0,16,0.625,0.4,2025-08-16 09:41:02
WAS,2013,3,13,0,16,0.1875,-0.3,2025-08-16 09:41:02
WAS,2014,4,12,0,16,0.25,-0.2,2025-08-16 09:41:02
WAS,2015,9,7,0,16,0.5625,-2.5,2025-08-16 09:41:02
WAS,2016,8,7,1,16,0.5312,1.2,2025-08-16 09:41:02
WAS,2017,7,9,0,16,0.4375,1.6,2025-08-16 09:41:02
WAS,2018,7,9,0,16,0.4375,-0.1,2025-08-16 09:41:02
WAS,2019,3,13,0,16,0.1875,-0.2,2025-08-16 09:41:02
WAS,2020,7,9,0,16,0.4375,-1.2,2025-08-16 09:41:02
WAS,2021,7,10,0,17,0.4118,1.6,2025-08-16 09:41:02
WAS,2022,8,8,1,17,0.5,0.4,2025-08-16 09:41:02
WAS,2023,4,13,0,17,0.2353,0.0,2025-08-16 09:41:02
WAS,2024,12,5,0,17,0.7059,-1.8,2025-08-16 09:41:02
